data_somministrazione,area,totale,sesso_maschile,sesso_femminile,categoria_operatori_sanitari_sociosanitari,categoria_personale_non_sanitario,categoria_ospiti_rsa,categoria_over80,prima_dose,seconda_dose,codice_NUTS1,codice_NUTS2,codice_regione_ISTAT,nome_area
2021-01-12,PUG,4198,1761,2437,3623,356,218,1,4198,0,ITF,ITF4,16,Puglia
2021-01-26,MAR,2016,746,1270,1736,194,86,0,92,1924,ITI,ITI3,11,Marche
2021-02-07,MOL,66,32,34,49,1,16,0,19,47,ITF,ITF2,14,Molise
2021-01-11,CAL,2154,1040,1114,1759,392,3,0,2154,0,ITF,ITF6,18,Calabria
2021-02-06,VEN,4040,1343,2697,2985,700,355,0,704,3336,ITH,ITH3,5,Veneto
2021-01-04,SIC,8371,4171,4200,7593,772,6,0,8371,0,ITG,ITG1,19,Sicilia
2021-02-01,EMR,10157,3547,6610,7389,1591,1177,0,340,9817,ITH,ITH5,8,Emilia-Romagna
2021-02-06,PAT,572,296,276,172,96,0,304,432,140,ITH,ITH2,4,Provincia Autonoma Trento
2021-01-28,LIG,2742,935,1807,2127,310,305,0,34,2708,ITC,ITC3,7,Liguria
2021-01-27,VDA,151,71,80,53,27,18,53,79,72,ITC,ITC2,2,Valle d'Aosta / Vallée d'Aoste
2020-12-27,ABR,37,19,18,34,1,2,0,37,0,ITF,ITF1,13,Abruzzo
2021-01-18,SIC,1547,645,902,720,619,208,0,1431,116,ITG,ITG1,19,Sicilia
2021-01-02,LIG,686,245,441,590,96,0,0,686,0,ITC,ITC3,7,Liguria
2021-01-23,VEN,4061,1254,2807,3403,207,450,1,35,4026,ITH,ITH3,5,Veneto
2021-01-25,CAL,1064,512,552,1021,43,0,0,156,908,ITF,ITF6,18,Calabria
2021-01-04,LOM,5975,2058,3917,4597,1197,166,15,5975,0,ITC,ITC4,3,Lombardia
2021-01-30,FVG,2269,744,1525,1475,353,441,0,269,2000,ITH,ITH4,6,Friuli-Venezia Giulia
2021-01-18,CAM,942,399,543,576,193,173,0,698,244,ITF,ITF3,15,Campania
2021-01-15,BAS,812,349,463,449,190,173,0,812,0,ITF,ITF5,17,Basilicata
2021-01-23,LAZ,6883,2682,4201,6063,278,417,125,255,6628,ITI,ITI4,12,Lazio
2021-01-28,TOS,6266,1877,4389,5418,66,782,0,348,5918,ITI,ITI1,9,Toscana
2021-01-10,ABR,1139,409,730,1091,48,0,0,1139,0,ITF,ITF1,13,Abruzzo
2021-01-26,PAB,809,291,518,670,139,0,0,1,808,ITH,ITH1,4,Provincia Autonoma Bolzano / Bozen
2021-01-13,UMB,450,139,311,379,29,42,0,450,0,ITI,ITI2,10,Umbria
2021-01-06,LAZ,5095,1950,3145,4618,157,320,0,5095,0,ITI,ITI4,12,Lazio
2021-01-10,VDA,220,71,149,172,29,19,0,220,0,ITC,ITC2,2,Valle d'Aosta / Vallée d'Aoste
2020-12-30,PIE,730,322,408,685,45,0,0,730,0,ITC,ITC1,1,Piemonte
2021-01-30,CAM,10721,5079,5642,6930,3564,227,0,39,10682,ITF,ITF3,15,Campania
2021-01-16,PIE,7750,2631,5119,4794,1589,1367,0,7750,0,ITC,ITC1,1,Piemonte
2021-01-16,TOS,3248,1037,2211,2493,538,217,0,3248,0,ITI,ITI1,9,Toscana
2020-12-27,VDA,20,9,11,20,0,0,0,20,0,ITC,ITC2,2,Valle d'Aosta / Vallée d'Aoste
2021-01-11,VEN,7234,2100,5134,3503,1531,1953,247,7234,0,ITH,ITH3,5,Veneto
2021-01-30,SIC,7832,3568,4264,5445,1912,475,0,171,7661,ITG,ITG1,19,Sicilia
2021-02-07,PUG,1262,569,693,910,217,135,0,244,1018,ITF,ITF4,16,Puglia
2021-01-07,MOL,598,209,389,414,39,145,0,598,0,ITF,ITF2,14,Molise
2021-02-06,CAL,2908,1337,1571,2094,567,247,0,442,2466,ITF,ITF6,18,Calabria
2021-01-23,PAT,571,331,240,483,0,88,0,384,187,ITH,ITH2,4,Provincia Autonoma Trento
2021-02-05,VDA,294,102,192,159,82,0,53,101,193,ITC,ITC2,2,Valle d'Aosta / Vallée d'Aoste
2021-01-06,EMR,8257,2938,5319,6811,795,651,0,8257,0,ITH,ITH5,8,Emilia-Romagna
2021-01-21,PUG,2116,897,1219,1415,175,526,0,1264,852,ITF,ITF4,16,Puglia
2021-01-27,BAS,409,173,236,149,234,26,0,112,297,ITF,ITF5,17,Basilicata
2021-01-22,ABR,118,57,61,2,4,112,0,118,0,ITF,ITF1,13,Abruzzo
2021-01-30,UMB,1576,483,1093,841,18,716,1,43,1533,ITI,ITI2,10,Umbria
2021-01-18,FVG,1959,606,1353,1358,491,110,0,1865,94,ITH,ITH4,6,Friuli-Venezia Giulia
2021-02-05,ABR,1534,520,1014,1187,241,106,0,787,747,ITF,ITF1,13,Abruzzo
2020-12-31,PAB,864,496,368,437,427,0,0,864,0,ITH,ITH1,4,Provincia Autonoma Bolzano / Bozen
2021-01-23,EMR,2441,868,1573,1897,114,430,0,439,2002,ITH,ITH5,8,Emilia-Romagna
2021-01-04,FVG,1510,559,951,1392,118,0,0,1510,0,ITH,ITH4,6,Friuli-Venezia Giulia
2021-01-30,PIE,5976,2134,3842,4365,1116,495,0,217,5759,ITC,ITC1,1,Piemonte
2021-01-02,TOS,3497,1097,2400,2682,15,800,0,3497,0,ITI,ITI1,9,Toscana
2021-01-12,MAR,1226,413,813,912,264,50,0,1226,0,ITI,ITI3,11,Marche
2021-01-16,LIG,1252,544,708,686,268,298,0,1252,0,ITC,ITC3,7,Liguria
2021-02-01,LAZ,5660,2168,3492,4775,319,559,7,351,5309,ITI,ITI4,12,Lazio
2021-02-04,LOM,24713,7341,17372,14177,5580,4771,185,1177,23536,ITC,ITC4,3,Lombardia
2021-01-04,CAM,5823,2961,2862,4848,975,0,0,5823,0,ITF,ITF3,15,Campania
2021-01-16,SAR,1492,525,967,1282,210,0,0,1492,0,ITG,ITG2,20,Sardegna
2021-01-30,EMR,10032,3507,6525,7554,1714,764,0,143,9889,ITH,ITH5,8,Emilia-Romagna
2021-02-07,PAB,2160,972,1188,99,397,0,1664,10,2150,ITH,ITH1,4,Provincia Autonoma Bolzano / Bozen
2021-01-21,MAR,895,252,643,459,100,336,0,585,310,ITI,ITI3,11,Marche
2021-01-11,UMB,1271,336,935,878,20,373,0,1271,0,ITI,ITI2,10,Umbria
2021-02-09,TOS,1366,465,901,1028,57,281,0,1046,320,ITI,ITI1,9,Toscana
2021-01-16,CAM,3369,1674,1695,1355,1641,373,0,3369,0,ITF,ITF3,15,Campania
2021-01-06,CAL,926,500,426,822,104,0,0,926,0,ITF,ITF6,18,Calabria
2020-12-30,SIC,173,101,72,156,17,0,0,173,0,ITG,ITG1,19,Sicilia
2021-02-02,LIG,2498,942,1556,1820,261,417,0,188,2310,ITC,ITC3,7,Liguria
2020-12-27,BAS,106,41,65,104,2,0,0,106,0,ITF,ITF5,17,Basilicata
2021-01-26,MOL,450,184,266,444,6,0,0,8,442,ITF,ITF2,14,Molise
2021-01-22,VDA,56,21,35,36,0,20,0,20,36,ITC,ITC2,2,Valle d'Aosta / Vallée d'Aoste
2021-01-28,VEN,9171,2652,6519,6453,1294,1424,0,166,9005,ITH,ITH3,5,Veneto
2021-02-09,PUG,941,389,552,605,198,138,0,316,625,ITF,ITF4,16,Puglia
2021-02-04,FVG,2724,802,1922,1716,543,465,0,36,2688,ITH,ITH4,6,Friuli-Venezia Giulia
2021-01-23,TOS,3948,1354,2594,2935,172,841,0,639,3309,ITI,ITI1,9,Toscana
2021-02-07,MAR,1867,734,1133,1155,666,46,0,344,1523,ITI,ITI3,11,Marche
2021-01-30,SAR,3862,1392,2470,2987,874,0,1,362,3500,ITG,ITG2,20,Sardegna
2020-12-31,PUG,1633,783,850,1545,44,44,0,1633,0,ITF,ITF4,16,Puglia
2021-01-08,VDA,299,130,169,240,43,16,0,299,0,ITC,ITC2,2,Valle d'Aosta / Vallée d'Aoste
2021-01-15,ABR,379,149,230,223,121,35,0,379,0,ITF,ITF1,13,Abruzzo
2021-01-10,BAS,77,24,53,9,68,0,0,77,0,ITF,ITF5,17,Basilicata
2021-01-11,LAZ,5525,2103,3422,4553,403,569,0,5525,0,ITI,ITI4,12,Lazio
2021-01-04,EMR,7254,2509,4745,6148,529,577,0,7254,0,ITH,ITH5,8,Emilia-Romagna
2021-01-04,PIE,5559,1676,3883,4587,737,235,0,5559,0,ITC,ITC1,1,Piemonte
2021-01-16,SIC,2698,1153,1545,1251,1149,298,0,2698,0,ITG,ITG1,19,Sicilia
2021-01-23,CAL,400,186,214,325,52,23,0,358,42,ITF,ITF6,18,Calabria
2020-12-30,PAT,6,2,4,4,1,1,0,6,0,ITH,ITH2,4,Provincia Autonoma Trento
2021-01-25,CAM,5744,2926,2818,4743,945,56,0,164,5580,ITF,ITF3,15,Campania
2021-01-11,TOS,5092,1688,3404,4360,210,522,0,5092,0,ITI,ITI1,9,Toscana
2021-01-25,SIC,7506,3692,3814,6630,806,70,0,320,7186,ITG,ITG1,19,Sicilia
2021-01-16,LOM,15133,5666,9467,8075,5640,1239,179,15133,0,ITC,ITC4,3,Lombardia
2021-01-16,VEN,4510,1519,2991,3128,738,644,0,4510,0,ITH,ITH3,5,Veneto
2021-01-28,PAT,529,147,382,327,95,107,0,48,481,ITH,ITH2,4,Provincia Autonoma Trento
2021-02-01,CAL,2495,1191,1304,2044,408,43,0,247,2248,ITF,ITF6,18,Calabria
2021-01-12,MOL,336,114,222,132,75,129,0,336,0,ITF,ITF2,14,Molise
2021-01-11,PAT,722,218,504,514,58,150,0,722,0,ITH,ITH2,4,Provincia Autonoma Trento
2021-01-26,PUG,5348,2395,2953,4837,281,230,0,568,4780,ITF,ITF4,16,Puglia
2021-01-22,BAS,66,24,42,6,60,0,0,66,0,ITF,ITF5,17,Basilicata
2021-01-25,UMB,647,322,325,645,2,0,0,5,642,ITI,ITI2,10,Umbria
2021-01-23,FVG,816,324,492,768,48,0,0,4,812,ITH,ITH4,6,Friuli-Venezia Giulia
2021-01-04,SAR,591,217,374,565,26,0,0,591,0,ITG,ITG2,20,Sardegna
2021-02-05,BAS,980,440,540,508,282,190,0,61,919,ITF,ITF5,17,Basilicata
2021-02-03,VDA,348,114,234,157,141,49,1,13,335,ITC,ITC2,2,Valle d'Aosta / Vallée d'Aoste
2021-01-18,EMR,3125,879,2246,1667,330,1128,0,2448,677,ITH,ITH5,8,Emilia-Romagna
2021-02-08,UMB,607,194,413,367,115,125,0,88,519,ITI,ITI2,10,Umbria
2021-01-18,PIE,6088,2035,4053,3218,1401,1469,0,5840,248,ITC,ITC1,1,Piemonte
2021-02-04,PIE,10186,3334,6852,6232,2199,1755,0,581,9605,ITC,ITC1,1,Piemonte
2021-01-07,MAR,1802,633,1169,1480,322,0,0,1802,0,ITI,ITI3,11,Marche
2021-01-21,LIG,831,308,523,440,193,197,1,460,371,ITC,ITC3,7,Liguria
2021-01-06,FVG,709,264,445,514,195,0,0,709,0,ITH,ITH4,6,Friuli-Venezia Giulia
2021-01-12,PAB,1519,397,1122,298,673,475,73,1519,0,ITH,ITH1,4,Provincia Autonoma Bolzano / Bozen
2021-02-06,LAZ,4973,1992,2981,3260,621,583,509,707,4266,ITI,ITI4,12,Lazio
2021-01-30,LOM,12029,4433,7596,9629,2233,159,8,191,11838,ITC,ITC4,3,Lombardia
2021-01-24,ABR,50,22,28,49,1,0,0,6,44,ITF,ITF1,13,Abruzzo
2021-02-04,LIG,2491,869,1622,1730,423,338,0,174,2317,ITC,ITC3,7,Liguria
2021-01-08,BAS,557,220,337,262,234,61,0,557,0,ITF,ITF5,17,Basilicata
2021-01-25,EMR,6411,2127,4284,5209,524,678,0,221,6190,ITH,ITH5,8,Emilia-Romagna
2021-01-02,PUG,2943,1295,1648,2807,113,23,0,2943,0,ITF,ITF4,16,Puglia
2021-01-03,ABR,471,185,286,464,7,0,0,471,0,ITF,ITF1,13,Abruzzo
2021-01-06,UMB,843,323,520,840,3,0,0,843,0,ITI,ITI2,10,Umbria
2021-02-06,FVG,1151,336,815,754,207,190,0,21,1130,ITH,ITH4,6,Friuli-Venezia Giulia
2021-01-11,CAM,4069,1869,2200,2382,1435,252,0,4069,0,ITF,ITF3,15,Campania
2021-02-04,TOS,4245,1590,2655,3166,624,455,0,955,3290,ITI,ITI1,9,Toscana
2021-01-18,SAR,904,326,578,714,190,0,0,780,124,ITG,ITG2,20,Sardegna
2020-12-30,LAZ,1601,621,980,1575,0,26,0,1601,0,ITI,ITI4,12,Lazio
2021-01-19,MAR,225,81,144,120,20,85,0,141,84,ITI,ITI3,11,Marche
2020-12-28,LOM,103,44,59,102,1,0,0,103,0,ITC,ITC4,3,Lombardia
2021-01-17,VDA,131,56,75,49,3,20,59,131,0,ITC,ITC2,2,Valle d'Aosta / Vallée d'Aoste
2021-01-31,MOL,268,70,198,85,19,164,0,6,262,ITF,ITF2,14,Molise
2021-02-02,MAR,1193,397,796,804,296,93,0,73,1120,ITI,ITI3,11,Marche
2021-01-13,LAZ,5497,2031,3466,4111,402,981,3,5497,0,ITI,ITI4,12,Lazio
2021-02-04,SAR,2267,814,1453,1736,361,169,1,912,1355,ITG,ITG2,20,Sardegna
2021-01-11,SIC,5903,2590,3313,3923,1598,382,0,5903,0,ITG,ITG1,19,Sicilia
2021-01-04,PAT,852,223,629,481,49,322,0,852,0,ITH,ITH2,4,Provincia Autonoma Trento
2021-01-18,CAL,1230,550,680,982,237,11,0,1040,190,ITF,ITF6,18,Calabria
2021-01-30,VEN,8651,2638,6013,6191,1312,1145,3,675,7976,ITH,ITH3,5,Veneto
2021-02-06,UMB,396,138,258,333,47,16,0,34,362,ITI,ITI2,10,Umbria
2021-01-25,LAZ,7761,3041,4720,7006,270,363,122,421,7340,ITI,ITI4,12,Lazio
2021-01-11,LOM,15932,5298,10634,10130,5158,544,100,15932,0,ITC,ITC4,3,Lombardia
2021-01-09,LIG,1306,464,842,948,172,186,0,1306,0,ITC,ITC3,7,Liguria
2021-01-17,MOL,78,38,40,78,0,0,0,48,30,ITF,ITF2,14,Molise
2021-01-31,PUG,1792,816,976,1486,106,198,2,66,1726,ITF,ITF4,16,Puglia
2021-01-16,PAT,318,147,171,299,5,14,0,318,0,ITH,ITH2,4,Provincia Autonoma Trento
2021-01-28,LOM,11792,3587,8205,8750,2282,730,30,632,11160,ITC,ITC4,3,Lombardia
2021-01-17,BAS,326,131,195,95,177,54,0,325,1,ITF,ITF5,17,Basilicata
2021-01-24,PAB,12,10,2,1,11,0,0,0,12,ITH,ITH1,4,Provincia Autonoma Bolzano / Bozen
2021-02-06,CAM,5310,2651,2659,1987,2875,433,15,2099,3211,ITF,ITF3,15,Campania
2021-01-20,UMB,613,222,391,583,16,14,0,613,0,ITI,ITI2,10,Umbria
2021-01-09,TOS,4483,1596,2887,3779,144,560,0,4483,0,ITI,ITI1,9,Toscana
2021-01-30,PAT,383,130,253,344,8,31,0,151,232,ITH,ITH2,4,Provincia Autonoma Trento
2021-01-29,VDA,316,138,178,259,41,16,0,2,314,ITC,ITC2,2,Valle d'Aosta / Vallée d'Aoste
2021-01-13,EMR,9062,2939,6123,5856,1464,1742,0,9062,0,ITH,ITH5,8,Emilia-Romagna
2021-01-23,PIE,4216,1321,2895,3189,522,505,0,876,3340,ITC,ITC1,1,Piemonte
2020-12-28,SIC,207,124,83,205,2,0,0,207,0,ITG,ITG1,19,Sicilia
2021-01-04,CAL,996,492,504,969,27,0,0,996,0,ITF,ITF6,18,Calabria
2021-01-04,VEN,6724,2029,4695,5235,575,913,1,6724,0,ITH,ITH3,5,Veneto
2021-02-06,SIC,4918,2146,2772,2469,1879,570,0,1461,3457,ITG,ITG1,19,Sicilia
2021-01-02,MAR,453,139,314,444,9,0,0,453,0,ITI,ITI3,11,Marche
2021-01-11,FVG,1881,609,1272,1499,336,46,0,1881,0,ITH,ITH4,6,Friuli-Venezia Giulia
2021-01-07,PAB,885,311,574,607,227,0,51,885,0,ITH,ITH1,4,Provincia Autonoma Bolzano / Bozen
2021-01-14,PUG,4047,1579,2468,3151,401,495,0,4047,0,ITF,ITF4,16,Puglia
2021-02-03,BAS,666,300,366,305,189,172,0,32,634,ITF,ITF5,17,Basilicata
2021-01-29,ABR,1386,449,937,1290,96,0,0,74,1312,ITF,ITF1,13,Abruzzo
2021-01-03,BAS,899,344,555,788,111,0,0,899,0,ITF,ITF5,17,Basilicata
2021-01-07,PUG,5705,2447,3258,5145,341,219,0,5705,0,ITF,ITF4,16,Puglia
2021-01-31,MAR,1919,769,1150,1527,392,0,0,105,1814,ITI,ITI3,11,Marche
2021-02-09,LIG,132,55,77,93,39,0,0,43,89,ITC,ITC3,7,Liguria
2021-01-01,UMB,269,102,167,268,1,0,0,269,0,ITI,ITI2,10,Umbria
2021-01-06,CAM,7652,3748,3904,5780,1572,300,0,7652,0,ITF,ITF3,15,Campania
2021-01-30,TOS,4549,1600,2949,3750,199,600,0,173,4376,ITI,ITI1,9,Toscana
2021-01-23,SAR,60,22,38,60,0,0,0,0,60,ITG,ITG2,20,Sardegna
2021-02-06,PIE,7977,2663,5314,5097,1628,1252,0,400,7577,ITC,ITC1,1,Piemonte
2021-01-14,MAR,2010,692,1318,1112,600,298,0,2010,0,ITI,ITI3,11,Marche
2021-01-04,LAZ,7477,2907,4570,7074,87,316,0,7477,0,ITI,ITI4,12,Lazio
2021-02-05,MOL,593,269,324,460,70,63,0,55,538,ITF,ITF2,14,Molise
2021-02-06,EMR,7323,2326,4997,5239,1021,1044,19,2077,5246,ITH,ITH5,8,Emilia-Romagna
2021-01-23,LIG,799,289,510,630,126,43,0,145,654,ITC,ITC3,7,Liguria
2021-01-23,SIC,4129,2137,1992,3892,221,16,0,225,3904,ITG,ITG1,19,Sicilia
2021-01-30,CAL,2173,1147,1026,1974,199,0,0,358,1815,ITF,ITF6,18,Calabria
2021-01-18,VEN,2687,764,1923,1210,536,933,8,2487,200,ITH,ITH3,5,Veneto
2020-12-28,LIG,75,26,49,72,3,0,0,75,0,ITC,ITC3,7,Liguria
2021-01-25,FVG,1581,567,1014,1368,141,72,0,193,1388,ITH,ITH4,6,Friuli-Venezia Giulia
2021-01-09,LOM,12374,4557,7817,8132,4040,192,10,12374,0,ITC,ITC4,3,Lombardia
2021-01-18,LAZ,5344,2069,3275,3410,756,725,453,4855,489,ITI,ITI4,12,Lazio
2021-01-23,CAM,3838,2029,1809,3161,609,68,0,272,3566,ITF,ITF3,15,Campania
2021-01-05,ABR,1614,604,1010,1604,10,0,0,1614,0,ITF,ITF1,13,Abruzzo
2021-01-19,MOL,173,63,110,90,61,22,0,162,11,ITF,ITF2,14,Molise
2021-01-18,UMB,588,215,373,315,149,124,0,504,84,ITI,ITI2,10,Umbria
2021-01-15,VDA,218,82,136,116,68,28,6,218,0,ITC,ITC2,2,Valle d'Aosta / Vallée d'Aoste
2021-01-06,SIC,6470,3402,3068,5716,752,2,0,6470,0,ITG,ITG1,19,Sicilia
2021-02-04,VEN,7010,1923,5087,3340,1437,2221,12,536,6474,ITH,ITH3,5,Veneto
2021-01-13,CAL,2028,1022,1006,1800,194,34,0,2028,0,ITF,ITF6,18,Calabria
2021-01-09,PAT,183,40,143,139,14,30,0,183,0,ITH,ITH2,4,Provincia Autonoma Trento
2021-01-30,LAZ,6637,2726,3911,5286,574,651,126,436,6201,ITI,ITI4,12,Lazio
2021-02-04,CAM,7941,3427,4514,3964,3684,292,1,1308,6633,ITF,ITF3,15,Campania
2021-02-01,UMB,1239,324,915,876,32,331,0,45,1194,ITI,ITI2,10,Umbria
2021-01-21,TOS,1570,686,884,574,220,776,0,850,720,ITI,ITI1,9,Toscana
2021-01-11,PIE,8738,2979,5759,6051,1561,1126,0,8738,0,ITC,ITC1,1,Piemonte
2021-02-06,SAR,1967,696,1271,1541,287,139,0,567,1400,ITG,ITG2,20,Sardegna
2021-02-04,SIC,6870,3157,3713,4412,1918,540,0,1458,5412,ITG,ITG1,19,Sicilia
2021-01-14,LIG,2610,926,1684,1609,573,428,0,2610,0,ITC,ITC3,7,Liguria
2021-02-02,PUG,4225,1796,2429,3544,382,299,0,548,3677,ITF,ITF4,16,Puglia
2021-01-18,PAT,634,151,483,519,42,73,0,581,53,ITH,ITH2,4,Provincia Autonoma Trento
2020-12-31,MAR,383,178,205,370,13,0,0,383,0,ITI,ITI3,11,Marche
2020-12-28,SAR,65,25,40,65,0,0,0,65,0,ITG,ITG2,20,Sardegna
2021-01-11,EMR,9290,3254,6036,6520,1535,1235,0,9290,0,ITH,ITH5,8,Emilia-Romagna
2021-02-09,MAR,50,21,29,24,3,23,0,18,32,ITI,ITI3,11,Marche
2021-01-17,ABR,187,59,128,136,51,0,0,180,7,ITF,ITF1,13,Abruzzo
2021-01-23,LOM,1065,339,726,475,571,19,0,867,198,ITC,ITC4,3,Lombardia
2021-01-19,PAB,807,348,459,170,64,0,573,677,130,ITH,ITH1,4,Provincia Autonoma Bolzano / Bozen
2021-01-04,TOS,5063,1893,3170,4099,32,932,0,5063,0,ITI,ITI1,9,Toscana
2021-02-04,PAT,960,299,661,528,38,81,313,417,543,ITH,ITH2,4,Provincia Autonoma Trento
2021-01-05,PAB,820,283,537,718,102,0,0,820,0,ITH,ITH1,4,Provincia Autonoma Bolzano / Bozen
2021-01-05,MOL,449,180,269,441,8,0,0,449,0,ITF,ITF2,14,Molise
2020-12-30,FVG,630,246,384,601,29,0,0,630,0,ITH,ITH4,6,Friuli-Venezia Giulia
2021-01-09,VEN,7923,2535,5388,5163,1184,1573,3,7923,0,ITH,ITH3,5,Veneto
2021-01-16,FVG,1231,360,871,771,212,248,0,1231,0,ITH,ITH4,6,Friuli-Venezia Giulia
2021-02-03,ABR,2061,717,1344,1541,402,118,0,419,1642,ITF,ITF1,13,Abruzzo
2021-01-11,SAR,1180,504,676,654,526,0,0,1180,0,ITG,ITG2,20,Sardegna
2021-01-19,PUG,1219,451,768,526,117,576,0,1209,10,ITF,ITF4,16,Puglia
2021-01-29,BAS,611,228,383,274,267,70,0,62,549,ITF,ITF5,17,Basilicata
2021-01-23,PAB,195,115,80,183,12,0,0,0,195,ITH,ITH1,4,Provincia Autonoma Bolzano / Bozen
2021-01-15,EMR,7699,2392,5307,5249,1133,1317,0,7699,0,ITH,ITH5,8,Emilia-Romagna
2021-01-27,LOM,7953,2653,5300,6048,1701,202,2,815,7138,ITC,ITC4,3,Lombardia
2021-01-25,LIG,2572,835,1737,2069,220,283,0,462,2110,ITC,ITC3,7,Liguria
2021-02-02,ABR,1778,672,1106,1235,404,139,0,241,1537,ITF,ITF1,13,Abruzzo
2021-01-27,FVG,1269,425,844,849,356,64,0,447,822,ITH,ITH4,6,Friuli-Venezia Giulia
2021-02-07,BAS,372,158,214,257,75,40,0,49,323,ITF,ITF5,17,Basilicata
2020-12-27,UMB,85,45,40,67,2,16,0,85,0,ITI,ITI2,10,Umbria
2021-01-25,TOS,5117,1895,3222,4153,56,908,0,247,4870,ITI,ITI1,9,Toscana
2021-01-29,LAZ,7413,2804,4609,6202,419,702,90,472,6941,ITI,ITI4,12,Lazio
2021-01-08,SAR,3251,1182,2069,2923,328,0,0,3251,0,ITG,ITG2,20,Sardegna
2021-01-01,CAM,919,506,413,831,88,0,0,919,0,ITF,ITF3,15,Campania
2021-01-09,MAR,1709,605,1104,1406,303,0,0,1709,0,ITI,ITI3,11,Marche
2021-01-07,VDA,275,111,164,224,46,5,0,275,0,ITC,ITC2,2,Valle d'Aosta / Vallée d'Aoste
2021-01-21,MOL,6,2,4,0,6,0,0,6,0,ITF,ITF2,14,Molise
2021-02-08,PIE,6751,2313,4438,3729,1535,1487,0,565,6186,ITC,ITC1,1,Piemonte
2021-02-04,PUG,5598,2231,3367,4316,742,540,0,1122,4476,ITF,ITF4,16,Puglia
2021-01-25,SAR,588,212,376,553,35,0,0,22,566,ITG,ITG2,20,Sardegna
2021-01-03,LAZ,5250,1972,3278,5125,60,65,0,5250,0,ITI,ITI4,12,Lazio
2021-01-23,MAR,557,190,367,440,54,63,0,123,434,ITI,ITI3,11,Marche
2021-01-29,EMR,10281,3470,6811,8061,1242,978,0,285,9996,ITH,ITH5,8,Emilia-Romagna
2021-01-04,MOL,314,131,183,301,13,0,0,314,0,ITF,ITF2,14,Molise
2021-01-08,CAL,2109,1014,1095,1898,211,0,0,2109,0,ITF,ITF6,18,Calabria
2021-01-20,VEN,1039,368,671,693,133,213,0,387,652,ITH,ITH3,5,Veneto
2021-01-01,SIC,814,436,378,739,75,0,0,814,0,ITG,ITG1,19,Sicilia
2021-01-27,UMB,838,329,509,837,1,0,0,13,825,ITI,ITI2,10,Umbria
2021-01-15,LAZ,6222,2465,3757,4475,604,988,155,6222,0,ITI,ITI4,12,Lazio
2020-12-27,PIE,912,368,544,760,76,76,0,912,0,ITC,ITC1,1,Piemonte
2021-01-01,LOM,24,7,17,21,3,0,0,24,0,ITC,ITC4,3,Lombardia
2020-12-30,LIG,9,3,6,9,0,0,0,9,0,ITC,ITC3,7,Liguria
2021-02-04,MAR,2337,806,1531,1405,657,275,0,112,2225,ITI,ITI3,11,Marche
2021-01-07,BAS,640,319,321,306,305,29,0,640,0,ITF,ITF5,17,Basilicata
2021-01-02,ABR,548,218,330,540,8,0,0,548,0,ITF,ITF1,13,Abruzzo
2021-01-14,PAB,1803,539,1264,475,758,285,285,1803,0,ITH,ITH1,4,Provincia Autonoma Bolzano / Bozen
2021-01-18,LOM,8886,2903,5983,4068,3277,1425,116,7904,982,ITC,ITC4,3,Lombardia
2021-02-02,VDA,270,70,200,225,43,2,0,2,268,ITC,ITC2,2,Valle d'Aosta / Vallée d'Aoste
2021-01-06,PAT,42,13,29,42,0,0,0,42,0,ITH,ITH2,4,Provincia Autonoma Trento
2020-12-30,TOS,325,104,221,34,10,281,0,325,0,ITI,ITI1,9,Toscana
2021-01-27,CAM,7731,3816,3915,5832,1629,270,0,161,7570,ITF,ITF3,15,Campania
2021-01-10,UMB,1056,275,781,740,9,307,0,1056,0,ITI,ITI2,10,Umbria
2021-02-08,SAR,1465,531,934,993,345,126,1,852,613,ITG,ITG2,20,Sardegna
2021-02-08,TOS,4094,1358,2736,3372,345,377,0,3635,459,ITI,ITI1,9,Toscana
2021-01-19,VDA,256,77,179,160,24,15,57,256,0,ITC,ITC2,2,Valle d'Aosta / Vallée d'Aoste
2021-01-20,PAT,288,71,217,224,16,48,0,276,12,ITH,ITH2,4,Provincia Autonoma Trento
2021-01-13,PIE,10040,3214,6826,6457,2256,1327,0,10040,0,ITC,ITC1,1,Piemonte
2021-01-03,EMR,2730,934,1796,2473,87,170,0,2730,0,ITH,ITH5,8,Emilia-Romagna
2021-01-27,SIC,7523,3831,3692,6322,1049,152,0,188,7335,ITG,ITG1,19,Sicilia
2021-02-03,CAL,2518,1313,1205,2054,361,103,0,577,1941,ITF,ITF6,18,Calabria
2021-01-04,PUG,4502,2012,2490,4346,145,11,0,4502,0,ITF,ITF4,16,Puglia
2021-01-24,BAS,834,299,535,602,231,1,0,58,776,ITF,ITF5,17,Basilicata
2021-01-19,ABR,111,55,56,27,34,50,0,91,20,ITF,ITF1,13,Abruzzo
2020-12-27,SAR,65,34,31,65,0,0,0,65,0,ITG,ITG2,20,Sardegna
2021-01-10,EMR,7121,2660,4461,5507,1116,498,0,7121,0,ITH,ITH5,8,Emilia-Romagna
2021-01-30,LIG,1625,548,1077,1209,166,250,0,21,1604,ITC,ITC3,7,Liguria
2021-02-01,FVG,2251,741,1510,1669,409,173,0,169,2082,ITH,ITH4,6,Friuli-Venezia Giulia
2021-01-13,SAR,573,178,395,494,79,0,0,573,0,ITG,ITG2,20,Sardegna
2021-02-03,LAZ,6273,2345,3928,4617,549,1072,35,887,5386,ITI,ITI4,12,Lazio
2020-12-27,CAM,720,422,298,703,17,0,0,720,0,ITF,ITF3,15,Campania
2021-01-20,TOS,1331,637,694,434,256,641,0,1083,248,ITI,ITI1,9,Toscana
2021-01-04,MAR,1500,563,937,1290,199,11,0,1500,0,ITI,ITI3,11,Marche
2021-01-27,EMR,8311,2931,5380,6848,813,650,0,459,7852,ITH,ITH5,8,Emilia-Romagna
2021-02-08,SIC,4081,1756,2325,2341,1343,397,0,2127,1954,ITG,ITG1,19,Sicilia
2021-02-04,PAB,1805,550,1255,606,593,392,214,8,1797,ITH,ITH1,4,Provincia Autonoma Bolzano / Bozen
2021-01-27,PIE,4193,1452,2741,2981,655,557,0,999,3194,ITC,ITC1,1,Piemonte
2021-01-13,LIG,2633,964,1669,1809,372,452,0,2633,0,ITC,ITC3,7,Liguria
2021-01-08,VEN,9399,2831,6568,5974,1614,1808,3,9399,0,ITH,ITH3,5,Veneto
2021-01-13,SIC,5203,2462,2741,3033,1729,441,0,5203,0,ITG,ITG1,19,Sicilia
2021-01-15,FVG,2028,606,1422,1283,370,375,0,2028,0,ITH,ITH4,6,Friuli-Venezia Giulia
2021-01-20,CAL,1395,622,773,864,352,179,0,1394,1,ITF,ITF6,18,Calabria
2020-12-30,LOM,113,42,71,105,8,0,0,113,0,ITC,ITC4,3,Lombardia
2021-01-08,LAZ,7704,2885,4819,6514,392,798,0,7704,0,ITI,ITI4,12,Lazio
2021-01-13,CAM,8012,3662,4350,4346,3082,584,0,8012,0,ITF,ITF3,15,Campania
2021-01-21,PAB,914,426,488,719,100,68,27,138,776,ITH,ITH1,4,Provincia Autonoma Bolzano / Bozen
2021-02-08,LOM,8124,2492,5632,4664,1994,1417,49,1319,6805,ITC,ITC4,3,Lombardia
2021-01-18,MAR,673,230,443,370,171,132,0,547,126,ITI,ITI3,11,Marche
2021-01-08,UMB,1172,337,835,926,9,237,0,1172,0,ITI,ITI2,10,Umbria
2021-01-09,MOL,450,152,298,221,51,178,0,450,0,ITF,ITF2,14,Molise
2021-02-08,PAT,1141,317,824,542,73,235,291,338,803,ITH,ITH2,4,Provincia Autonoma Trento
2021-01-05,VDA,150,54,96,127,12,11,0,150,0,ITC,ITC2,2,Valle d'Aosta / Vallée d'Aoste
2021-01-25,VEN,6465,2074,4391,5059,502,903,1,169,6296,ITH,ITH3,5,Veneto
2020-12-27,SIC,89,54,35,62,2,25,0,89,0,ITG,ITG1,19,Sicilia
2021-01-03,CAL,6,3,3,4,2,0,0,6,0,ITF,ITF6,18,Calabria
2021-01-20,LAZ,4328,1639,2689,3239,397,407,285,2816,1512,ITI,ITI4,12,Lazio
2021-01-27,SAR,1392,489,903,1287,105,0,0,79,1313,ITG,ITG2,20,Sardegna
2021-01-22,UMB,276,105,171,273,1,2,0,32,244,ITI,ITI2,10,Umbria
2021-01-01,PIE,1038,395,643,922,116,0,0,1038,0,ITC,ITC1,1,Piemonte
2021-01-08,PAT,1440,312,1128,762,152,526,0,1440,0,ITH,ITH2,4,Provincia Autonoma Trento
2021-01-04,LIG,2370,782,1588,2053,226,91,0,2370,0,ITC,ITC3,7,Liguria
2021-01-23,PUG,3022,1284,1738,2514,201,307,0,879,2143,ITF,ITF4,16,Puglia
2021-01-31,VDA,290,90,200,231,41,18,0,58,232,ITC,ITC2,2,Valle d'Aosta / Vallée d'Aoste
2021-01-30,MAR,1905,668,1237,1566,339,0,0,29,1876,ITI,ITI3,11,Marche
2021-01-09,PAB,596,314,282,72,438,74,12,596,0,ITH,ITH1,4,Provincia Autonoma Bolzano / Bozen
2021-01-07,ABR,1603,552,1051,1566,37,0,0,1603,0,ITF,ITF1,13,Abruzzo
2021-01-13,LOM,25321,7799,17522,11832,9656,3526,307,25321,0,ITC,ITC4,3,Lombardia
2021-01-22,CAM,1522,774,748,970,344,208,0,672,850,ITF,ITF3,15,Campania
2021-01-03,FVG,312,122,190,285,26,1,0,312,0,ITH,ITH4,6,Friuli-Venezia Giulia
2021-01-21,ABR,157,47,110,10,6,141,0,157,0,ITF,ITF1,13,Abruzzo
2021-01-25,PAT,772,205,567,481,30,261,0,23,749,ITH,ITH2,4,Provincia Autonoma Trento
2021-01-14,VDA,237,69,168,151,84,0,2,237,0,ITC,ITC2,2,Valle d'Aosta / Vallée d'Aoste
2021-02-08,VEN,4649,1466,3183,2640,948,1050,11,1799,2850,ITH,ITH3,5,Veneto
2021-02-04,MOL,757,295,462,501,115,141,0,76,681,ITF,ITF2,14,Molise
2021-01-15,PIE,8958,2951,6007,5492,1925,1541,0,8958,0,ITC,ITC1,1,Piemonte
2021-01-29,CAL,2046,984,1062,1751,247,48,0,233,1813,ITF,ITF6,18,Calabria
2021-02-08,CAM,5110,2447,2663,1387,2120,226,1377,4307,803,ITF,ITF3,15,Campania
2021-01-22,SIC,1235,625,610,1035,82,118,0,242,993,ITG,ITG1,19,Sicilia
2020-12-30,VEN,699,245,454,598,62,39,0,699,0,ITH,ITH3,5,Veneto
2021-01-09,PUG,4854,2242,2612,4301,302,247,4,4854,0,ITF,ITF4,16,Puglia
2021-02-06,TOS,4486,1536,2950,3723,575,188,0,1294,3192,ITI,ITI1,9,Toscana
2021-01-19,BAS,200,84,116,81,74,45,0,200,0,ITF,ITF5,17,Basilicata
2021-01-01,SAR,30,16,14,30,0,0,0,30,0,ITG,ITG2,20,Sardegna
2021-02-02,PAB,1656,456,1200,546,496,605,9,7,1649,ITH,ITH1,4,Provincia Autonoma Bolzano / Bozen
2021-01-28,MOL,613,217,396,430,29,154,0,17,596,ITF,ITF2,14,Molise
2021-01-16,MAR,2006,723,1283,1059,662,285,0,2006,0,ITI,ITI3,11,Marche
2021-02-06,LOM,13929,5193,8736,8915,3394,1558,62,579,13350,ITC,ITC4,3,Lombardia
2021-02-08,LAZ,9254,3839,5415,3762,860,880,3752,4475,4779,ITI,ITI4,12,Lazio
2021-01-27,VEN,7131,2065,5066,5200,1060,871,0,240,6891,ITH,ITH3,5,Veneto
2021-02-03,FVG,2642,788,1854,1698,558,386,0,20,2622,ITH,ITH4,6,Friuli-Venezia Giulia
2021-01-22,EMR,1827,477,1350,940,166,721,0,1089,738,ITH,ITH5,8,Emilia-Romagna
2021-02-03,SIC,6098,2855,3243,3354,2120,624,0,755,5343,ITG,ITG1,19,Sicilia
2021-02-01,PIE,8637,3051,5586,6161,1402,1074,0,577,8060,ITC,ITC1,1,Piemonte
2021-01-27,PAT,731,257,474,394,34,303,0,72,659,ITH,ITH2,4,Provincia Autonoma Trento
2021-01-18,LIG,1632,624,1008,1004,410,218,0,1483,149,ITC,ITC3,7,Liguria
2020-12-30,MAR,17,5,12,14,3,0,0,17,0,ITI,ITI3,11,Marche
2021-01-08,SIC,8328,3864,4464,6591,1524,213,0,8328,0,ITG,ITG1,19,Sicilia
2021-01-13,VEN,5973,1599,4374,2790,1302,1878,3,5973,0,ITH,ITH3,5,Veneto
2021-01-15,CAL,2793,1258,1535,1690,691,412,0,2793,0,ITF,ITF6,18,Calabria
2021-01-20,FVG,749,323,426,718,31,0,0,11,738,ITH,ITH4,6,Friuli-Venezia Giulia
2021-01-08,CAM,10453,4968,5485,6713,3528,212,0,10453,0,ITF,ITF3,15,Campania
2021-01-05,BAS,945,409,536,709,236,0,0,945,0,ITF,ITF5,17,Basilicata
2021-01-15,SAR,1562,572,990,1169,393,0,0,1562,0,ITG,ITG2,20,Sardegna
2021-01-18,TOS,1119,636,483,430,314,375,0,1021,98,ITI,ITI1,9,Toscana
2021-02-01,LIG,2308,835,1473,1796,209,303,0,68,2240,ITC,ITC3,7,Liguria
2021-01-16,PAB,2740,1226,1514,450,352,77,1861,2740,0,ITH,ITH1,4,Provincia Autonoma Bolzano / Bozen
2021-01-14,MOL,646,239,407,418,113,115,0,646,0,ITF,ITF2,14,Molise
2021-02-08,EMR,4665,1393,3272,2639,663,1238,125,2108,2557,ITH,ITH5,8,Emilia-Romagna
2021-02-09,ABR,442,151,291,241,108,93,0,171,271,ITF,ITF1,13,Abruzzo
2020-12-31,VDA,18,4,14,16,2,0,0,18,0,ITC,ITC2,2,Valle d'Aosta / Vallée d'Aoste
2021-01-03,UMB,267,111,156,267,0,0,0,267,0,ITI,ITI2,10,Umbria
2020-12-27,LAZ,139,66,73,139,0,0,0,139,0,ITI,ITI4,12,Lazio
2021-01-06,PIE,3114,1110,2004,2368,433,313,0,3114,0,ITC,ITC1,1,Piemonte
2021-01-20,CAM,1257,650,607,395,761,101,0,1257,0,ITF,ITF3,15,Campania
2021-02-01,SAR,1519,602,917,891,551,77,0,221,1298,ITG,ITG2,20,Sardegna
2021-01-06,TOS,4516,1459,3057,3981,10,525,0,4516,0,ITI,ITI1,9,Toscana
2021-01-13,PAT,415,123,292,381,16,18,0,415,0,ITH,ITH2,4,Provincia Autonoma Trento
2021-01-28,PUG,5458,2269,3189,4754,377,327,0,474,4984,ITF,ITF4,16,Puglia
2021-01-27,CAL,1456,733,723,1225,208,23,0,396,1060,ITF,ITF6,18,Calabria
2021-01-20,SIC,807,410,397,421,194,192,0,573,234,ITG,ITG1,19,Sicilia
2021-01-01,VEN,1525,470,1055,1494,30,1,0,1525,0,ITH,ITH3,5,Veneto
2021-01-26,VDA,139,48,91,115,12,12,0,0,139,ITC,ITC2,2,Valle d'Aosta / Vallée d'Aoste
2020-12-27,EMR,968,372,596,811,131,26,0,968,0,ITH,ITH5,8,Emilia-Romagna
2021-01-11,PUG,3742,1581,2161,3203,364,175,0,3742,0,ITF,ITF4,16,Puglia
2021-01-08,LOM,12586,3892,8694,8633,3703,218,32,12586,0,ITC,ITC4,3,Lombardia
2021-01-12,ABR,1804,666,1138,1470,334,0,0,1804,0,ITF,ITF1,13,Abruzzo
2021-01-04,PAB,469,191,278,397,72,0,0,469,0,ITH,ITH1,4,Provincia Autonoma Bolzano / Bozen
2021-01-08,FVG,2321,746,1575,1679,246,396,0,2321,0,ITH,ITH4,6,Friuli-Venezia Giulia
2021-01-26,ABR,1542,567,975,1513,29,0,0,29,1513,ITF,ITF1,13,Abruzzo
2021-01-31,BAS,77,24,53,75,2,0,0,0,77,ITF,ITF5,17,Basilicata
2021-02-03,UMB,725,174,551,560,37,128,0,67,658,ITI,ITI2,10,Umbria
2021-02-09,MOL,227,88,139,137,74,16,0,87,140,ITF,ITF2,14,Molise
2021-01-20,PIE,6363,2030,4333,3558,1152,1653,0,5637,726,ITC,ITC1,1,Piemonte
2021-02-03,CAM,8894,3997,4897,4733,3446,714,1,878,8016,ITF,ITF3,15,Campania
2021-01-06,LIG,1627,600,1027,1196,254,113,64,1627,0,ITC,ITC3,7,Liguria
2021-02-01,TOS,5465,1942,3523,4441,407,617,0,521,4944,ITI,ITI1,9,Toscana
2021-01-06,SAR,1598,544,1054,1493,105,0,0,1598,0,ITG,ITG2,20,Sardegna
2021-01-22,LAZ,3661,1442,2219,3379,90,70,122,147,3514,ITI,ITI4,12,Lazio
2021-01-25,LOM,6837,2304,4533,5370,1277,180,10,474,6363,ITC,ITC4,3,Lombardia
2021-01-11,MAR,1176,411,765,1021,155,0,0,1176,0,ITI,ITI3,11,Marche
2021-01-20,EMR,1306,266,1040,410,136,760,0,1305,1,ITH,ITH5,8,Emilia-Romagna
2021-01-28,PAB,867,307,560,584,214,69,0,10,857,ITH,ITH1,4,Provincia Autonoma Bolzano / Bozen
2021-02-01,LOM,15315,5052,10263,11084,3367,843,21,280,15035,ITC,ITC4,3,Lombardia
2021-02-02,MOL,486,155,331,295,63,128,0,163,323,ITF,ITF2,14,Molise
2021-01-22,FVG,90,30,60,89,1,0,0,0,90,ITH,ITH4,6,Friuli-Venezia Giulia
2021-02-08,FVG,2348,692,1656,1393,521,434,0,90,2258,ITH,ITH4,6,Friuli-Venezia Giulia
2021-02-01,VEN,7932,2379,5553,4206,1769,1712,245,161,7771,ITH,ITH3,5,Veneto
2020-12-27,CAL,275,150,125,274,1,0,0,275,0,ITF,ITF6,18,Calabria
2021-02-01,PAT,1180,320,860,759,85,336,0,91,1089,ITH,ITH2,4,Provincia Autonoma Trento
2021-01-16,MOL,420,166,254,270,23,127,0,420,0,ITF,ITF2,14,Molise
2021-01-12,VDA,302,72,230,242,49,11,0,302,0,ITC,ITC2,2,Valle d'Aosta / Vallée d'Aoste
2021-01-03,SIC,4692,2454,2238,4360,332,0,0,4692,0,ITG,ITG1,19,Sicilia
2021-01-30,PUG,5311,2418,2893,4571,321,416,3,361,4950,ITF,ITF4,16,Puglia
2021-02-03,PIE,10145,3292,6853,6613,2299,1233,0,609,9536,ITC,ITC1,1,Piemonte
2021-01-10,CAL,929,524,405,830,99,0,0,929,0,ITF,ITF6,18,Calabria
2021-01-03,CAM,3836,2009,1827,3191,645,0,0,3836,0,ITF,ITF3,15,Campania
2021-02-06,LIG,1791,731,1060,1231,238,322,0,145,1646,ITC,ITC3,7,Liguria
2021-01-28,MAR,1972,659,1313,1581,290,101,0,167,1805,ITI,ITI3,11,Marche
2021-01-20,SAR,209,77,132,153,56,0,0,207,2,ITG,ITG2,20,Sardegna
2021-01-13,TOS,4062,1398,2664,3308,349,405,0,4062,0,ITI,ITI1,9,Toscana
2021-02-03,EMR,9080,2934,6146,6049,1441,1531,59,938,8142,ITH,ITH5,8,Emilia-Romagna
2021-01-01,LAZ,3553,1381,2172,3483,2,68,0,3553,0,ITI,ITI4,12,Lazio
2021-01-15,CAM,4977,2380,2597,2739,2048,190,0,4977,0,ITF,ITF3,15,Campania
2021-01-10,LAZ,4034,1698,2336,3419,363,252,0,4034,0,ITI,ITI4,12,Lazio
2021-01-01,TOS,2368,786,1582,1716,2,650,0,2368,0,ITI,ITI1,9,Toscana
2021-01-06,VEN,8123,2379,5744,6299,1016,807,1,8123,0,ITH,ITH3,5,Veneto
2021-01-06,LOM,7038,2483,4555,5260,1740,35,3,7038,0,ITC,ITC4,3,Lombardia
2021-01-15,SIC,5092,2239,2853,2838,1775,479,0,5092,0,ITG,ITG1,19,Sicilia
2021-01-22,CAL,656,274,382,298,248,110,0,654,2,ITF,ITF6,18,Calabria
2021-01-16,PUG,2501,1032,1469,1677,310,514,0,2501,0,ITF,ITF4,16,Puglia
2021-01-01,PAT,206,48,158,109,11,86,0,206,0,ITH,ITH2,4,Provincia Autonoma Trento
2021-02-07,VDA,292,120,172,110,77,0,105,190,102,ITC,ITC2,2,Valle d'Aosta / Vallée d'Aoste
2021-01-12,BAS,216,87,129,39,79,98,0,216,0,ITF,ITF5,17,Basilicata
2021-02-01,CAM,3985,1813,2172,2504,1329,152,0,110,3875,ITF,ITF3,15,Campania
2021-01-13,FVG,2651,834,1817,1822,599,230,0,2651,0,ITH,ITH4,6,Friuli-Venezia Giulia
2021-02-03,SAR,1116,416,700,918,179,19,0,424,692,ITG,ITG2,20,Sardegna
2021-01-15,UMB,692,212,480,588,44,60,0,692,0,ITI,ITI2,10,Umbria
2021-01-31,ABR,1502,488,1014,1154,245,103,0,287,1215,ITF,ITF1,13,Abruzzo
2021-01-26,BAS,794,350,444,479,280,35,0,101,693,ITF,ITF5,17,Basilicata
2021-01-08,EMR,10802,3554,7248,8327,1398,1077,0,10802,0,ITH,ITH5,8,Emilia-Romagna
2021-01-08,PIE,5526,1759,3767,4076,1029,421,0,5526,0,ITC,ITC1,1,Piemonte
2021-01-29,UMB,1220,343,877,934,16,270,0,79,1141,ITI,ITI2,10,Umbria
2021-02-08,CAL,1641,650,991,1040,480,121,0,459,1182,ITF,ITF6,18,Calabria
2021-01-11,LIG,2460,909,1551,1866,325,269,0,2460,0,ITC,ITC3,7,Liguria
2021-01-25,PIE,6208,1938,4270,4781,865,562,0,980,5228,ITC,ITC1,1,Piemonte
2021-02-01,SIC,6074,2682,3392,4165,1591,318,0,301,5773,ITG,ITG1,19,Sicilia
2020-12-27,FVG,262,149,113,259,3,0,0,262,0,ITH,ITH4,6,Friuli-Venezia Giulia
2021-01-20,LOM,5302,1308,3994,1937,2168,1107,90,5188,114,ITC,ITC4,3,Lombardia
2021-01-14,ABR,530,189,341,364,166,0,0,530,0,ITF,ITF1,13,Abruzzo
2021-01-27,LAZ,5767,2169,3598,4796,385,457,129,651,5116,ITI,ITI4,12,Lazio
2021-02-06,MAR,2431,889,1542,1396,639,396,0,521,1910,ITI,ITI3,11,Marche
2021-01-02,PAB,91,48,43,69,22,0,0,91,0,ITH,ITH1,4,Provincia Autonoma Bolzano / Bozen
2021-01-06,MAR,2181,792,1389,1738,296,147,0,2181,0,ITI,ITI3,11,Marche
2021-01-18,MOL,114,48,66,97,17,0,0,114,0,ITF,ITF2,14,Molise
2021-01-17,VEN,1930,780,1150,1582,225,120,3,1581,349,ITH,ITH3,5,Veneto
2021-02-05,UMB,780,234,546,645,51,84,0,18,762,ITI,ITI2,10,Umbria
2021-01-24,FVG,305,119,186,277,27,1,0,1,304,ITH,ITH4,6,Friuli-Venezia Giulia
2021-01-24,SIC,4304,2250,2054,3960,341,3,0,147,4157,ITG,ITG1,19,Sicilia
2021-01-22,PIE,3795,1228,2567,2252,649,894,0,2451,1344,ITC,ITC1,1,Piemonte
2021-02-01,PUG,3944,1649,2295,3428,308,208,0,374,3570,ITF,ITF4,16,Puglia
2021-01-08,LIG,2685,927,1758,1912,428,345,0,2685,0,ITC,ITC3,7,Liguria
2021-01-31,CAL,1107,554,553,764,285,58,0,155,952,ITF,ITF6,18,Calabria
2021-01-12,EMR,9301,3083,6218,6300,1377,1624,0,9301,0,ITH,ITH5,8,Emilia-Romagna
2021-01-20,PAB,608,247,361,282,76,0,250,401,207,ITH,ITH1,4,Provincia Autonoma Bolzano / Bozen
2021-01-17,PAT,251,195,56,248,3,0,0,251,0,ITH,ITH2,4,Provincia Autonoma Trento
2021-01-03,VEN,5156,1562,3594,4595,312,249,0,5156,0,ITH,ITH3,5,Veneto
2021-01-05,CAL,1350,618,732,1256,94,0,0,1350,0,ITF,ITF6,18,Calabria
2021-02-07,CAM,2934,1385,1549,710,1708,226,290,2156,778,ITF,ITF3,15,Campania
2021-01-10,FVG,2940,919,2021,1745,950,245,0,2940,0,ITH,ITH4,6,Friuli-Venezia Giulia
2020-12-29,SIC,235,146,89,235,0,0,0,235,0,ITG,ITG1,19,Sicilia
2021-01-22,LIG,1623,545,1078,862,269,492,0,1150,473,ITC,ITC3,7,Liguria
2021-02-07,SIC,2226,927,1299,1490,581,155,0,671,1555,ITG,ITG1,19,Sicilia
2021-01-08,TOS,5944,1641,4303,5360,39,545,0,5944,0,ITI,ITI1,9,Toscana
2021-01-05,SAR,1327,446,881,1283,44,0,0,1327,0,ITG,ITG2,20,Sardegna
2021-01-24,LOM,1170,452,718,791,354,24,1,508,662,ITC,ITC4,3,Lombardia
2021-01-06,PAB,59,18,41,59,0,0,0,59,0,ITH,ITH1,4,Provincia Autonoma Bolzano / Bozen
2021-02-03,PAT,840,311,529,309,87,71,373,414,426,ITH,ITH2,4,Provincia Autonoma Trento
2021-02-04,BAS,1088,438,650,550,259,279,0,63,1025,ITF,ITF5,17,Basilicata
2021-01-30,ABR,1509,566,943,1348,114,47,0,69,1440,ITF,ITF1,13,Abruzzo
2021-01-07,UMB,1291,383,908,883,4,404,0,1291,0,ITI,ITI2,10,Umbria
2021-01-10,CAM,8166,3739,4427,5180,2889,97,0,8166,0,ITF,ITF3,15,Campania
2021-02-07,FVG,1558,483,1075,863,693,2,0,384,1174,ITH,ITH4,6,Friuli-Venezia Giulia
2020-12-27,TOS,619,267,352,460,146,13,0,619,0,ITI,ITI1,9,Toscana
2021-01-22,SAR,82,46,36,45,37,0,0,54,28,ITG,ITG2,20,Sardegna
2021-02-05,PIE,9353,3056,6297,5717,2021,1615,0,606,8747,ITC,ITC1,1,Piemonte
2021-01-26,EMR,8324,3000,5324,6593,699,1032,0,218,8106,ITH,ITH5,8,Emilia-Romagna
2021-02-05,TOS,5742,2242,3500,4117,1183,442,0,1921,3821,ITI,ITI1,9,Toscana
2021-01-10,SIC,3618,1615,2003,2126,1028,464,0,3618,0,ITG,ITG1,19,Sicilia
2021-01-03,PAT,483,158,325,409,12,62,0,483,0,ITH,ITH2,4,Provincia Autonoma Trento
2021-01-17,CAL,867,418,449,527,292,48,0,801,66,ITF,ITF6,18,Calabria
2021-01-18,PUG,1844,770,1074,1181,217,446,0,1495,349,ITF,ITF4,16,Puglia
2021-01-16,VDA,236,80,156,127,36,22,51,236,0,ITC,ITC2,2,Valle d'Aosta / Vallée d'Aoste
2021-01-15,MAR,1771,500,1271,985,420,366,0,1771,0,ITI,ITI3,11,Marche
2021-02-08,LIG,1636,657,979,1111,376,149,0,278,1358,ITC,ITC3,7,Liguria
2021-01-01,PUG,146,60,86,145,1,0,0,146,0,ITF,ITF4,16,Puglia
2020-12-29,LOM,100,43,57,100,0,0,0,100,0,ITC,ITC4,3,Lombardia
2021-01-16,ABR,927,428,499,710,202,15,0,927,0,ITF,ITF1,13,Abruzzo
2021-01-21,BAS,30,10,20,0,30,0,0,30,0,ITF,ITF5,17,Basilicata
2021-01-30,MOL,458,158,300,189,90,179,0,10,448,ITF,ITF2,14,Molise
2021-01-24,UMB,254,104,150,254,0,0,0,1,253,ITI,ITI2,10,Umbria
2021-02-03,VEN,5881,1654,4227,2807,1339,1734,1,475,5406,ITH,ITH3,5,Veneto
2021-01-24,CAM,4128,2123,2005,3140,822,166,0,383,3745,ITF,ITF3,15,Campania
2021-01-10,PIE,5207,2273,2934,3904,784,519,0,5207,0,ITC,ITC1,1,Piemonte
2021-02-05,SAR,1896,749,1147,1214,518,163,1,432,1464,ITG,ITG2,20,Sardegna
2021-02-06,PAB,2276,1018,1258,435,371,0,1470,18,2258,ITH,ITH1,4,Provincia Autonoma Bolzano / Bozen
2020-12-27,LIG,132,54,78,85,2,45,0,132,0,ITC,ITC3,7,Liguria
2021-01-22,TOS,2864,1063,1801,2027,81,756,0,525,2339,ITI,ITI1,9,Toscana
2021-01-12,LAZ,5391,1974,3417,4343,464,584,0,5391,0,ITI,ITI4,12,Lazio
2021-01-15,LOM,24249,7140,17109,10140,9901,3803,405,24249,0,ITC,ITC4,3,Lombardia
2021-02-01,MAR,1360,479,881,1053,226,81,0,98,1262,ITI,ITI3,11,Marche
2021-01-04,BAS,607,271,336,527,80,0,0,607,0,ITF,ITF5,17,Basilicata
2021-02-05,SIC,7098,3155,3943,3527,2719,852,0,2125,4973,ITG,ITG1,19,Sicilia
2021-01-22,LOM,2784,790,1994,1004,1658,122,0,2732,52,ITC,ITC4,3,Lombardia
2021-01-18,PAB,1546,576,970,291,269,7,979,1541,5,ITH,ITH1,4,Provincia Autonoma Bolzano / Bozen
2021-01-10,LIG,572,239,333,304,126,142,0,572,0,ITC,ITC3,7,Liguria
2021-01-31,LAZ,4279,1783,2496,3572,339,244,124,296,3983,ITI,ITI4,12,Lazio
2021-02-05,CAM,7253,3459,3794,3444,3496,304,9,2129,5124,ITF,ITF3,15,Campania
2021-01-18,ABR,122,48,74,106,14,2,0,46,76,ITF,ITF1,13,Abruzzo
2021-01-12,FVG,2256,712,1544,1522,373,361,0,2256,0,ITH,ITH4,6,Friuli-Venezia Giulia
2021-02-02,BAS,363,141,222,132,130,101,0,175,188,ITF,ITF5,17,Basilicata
2021-01-22,VEN,1081,332,749,946,77,58,0,27,1054,ITH,ITH3,5,Veneto
2021-01-29,FVG,2409,813,1596,1853,321,235,0,262,2147,ITH,ITH4,6,Friuli-Venezia Giulia
2021-01-31,UMB,1056,276,780,765,10,281,0,25,1031,ITI,ITI2,10,Umbria
2021-01-19,SIC,1270,521,749,520,512,238,0,1092,178,ITG,ITG1,19,Sicilia
2021-01-07,EMR,10204,3381,6823,8162,975,1067,0,10204,0,ITH,ITH5,8,Emilia-Romagna
2021-02-06,PUG,3913,1661,2252,2994,480,439,0,1148,2765,ITF,ITF4,16,Puglia
2021-01-22,PAT,1615,419,1196,869,127,619,0,313,1302,ITH,ITH2,4,Provincia Autonoma Trento
2021-01-26,CAL,1803,859,944,1569,164,70,0,283,1520,ITF,ITF6,18,Calabria
2021-01-06,MOL,689,260,429,456,62,171,0,689,0,ITF,ITF2,14,Molise
2021-01-02,VDA,6,5,1,0,0,6,0,6,0,ITC,ITC2,2,Valle d'Aosta / Vallée d'Aoste
2021-01-20,PUG,1539,539,1000,787,160,592,0,1531,8,ITF,ITF4,16,Puglia
2021-01-24,PIE,3148,956,2192,2630,372,146,0,432,2716,ITC,ITC1,1,Piemonte
2021-01-03,TOS,3336,1052,2284,2565,9,762,0,3336,0,ITI,ITI1,9,Toscana
2021-01-27,LIG,1613,576,1037,1265,173,175,0,180,1433,ITC,ITC3,7,Liguria
2021-01-10,SAR,2183,750,1433,1632,551,0,0,2183,0,ITG,ITG2,20,Sardegna
2021-02-05,PAT,764,258,506,463,27,47,227,265,499,ITH,ITH2,4,Provincia Autonoma Trento
2021-01-01,PAB,1,1,0,1,0,0,0,1,0,ITH,ITH1,4,Provincia Autonoma Bolzano / Bozen
2021-01-24,EMR,2441,882,1559,2071,120,250,0,300,2141,ITH,ITH5,8,Emilia-Romagna
2021-02-04,ABR,1680,615,1065,1168,455,57,0,609,1071,ITF,ITF1,13,Abruzzo
2021-02-05,LOM,22979,6804,16175,13156,6106,3467,250,1435,21544,ITC,ITC4,3,Lombardia
2021-01-05,VEN,7328,2182,5146,5408,797,1123,0,7328,0,ITH,ITH3,5,Veneto
2021-02-05,VEN,7786,2381,5405,3940,1904,1938,4,1378,6408,ITH,ITH3,5,Veneto
2020-12-31,LAZ,5217,2094,3123,4926,12,279,0,5217,0,ITI,ITI4,12,Lazio
2021-01-05,CAM,7240,3641,3599,5813,1321,106,0,7240,0,ITF,ITF3,15,Campania
2021-01-05,SIC,10526,5159,5367,9073,1246,207,0,10526,0,ITG,ITG1,19,Sicilia
2020-12-27,VEN,880,395,485,875,5,0,0,880,0,ITH,ITH3,5,Veneto
2020-12-27,LOM,701,407,294,550,137,13,1,701,0,ITC,ITC4,3,Lombardia
2021-01-12,CAL,2058,1017,1041,1706,323,29,0,2058,0,ITF,ITF6,18,Calabria
2021-01-02,BAS,948,379,569,848,100,0,0,948,0,ITF,ITF5,17,Basilicata
2021-01-06,PUG,3940,1663,2277,3179,384,377,0,3940,0,ITF,ITF4,16,Puglia
2021-02-01,MOL,562,201,361,301,150,111,0,14,548,ITF,ITF2,14,Molise
2021-01-28,VDA,290,123,167,194,88,6,2,56,234,ITC,ITC2,2,Valle d'Aosta / Vallée d'Aoste
2021-01-05,UMB,850,428,422,845,5,0,0,850,0,ITI,ITI2,10,Umbria
2021-01-24,SAR,90,34,56,89,1,0,0,5,85,ITG,ITG2,20,Sardegna
2021-02-07,EMR,4727,1523,3204,3634,694,389,10,1726,3001,ITH,ITH5,8,Emilia-Romagna
2021-02-03,TOS,4220,1453,2767,3475,240,505,0,240,3980,ITI,ITI1,9,Toscana
2021-01-05,PAT,704,231,473,492,52,160,0,704,0,ITH,ITH2,4,Provincia Autonoma Trento
2021-01-16,BAS,722,304,418,266,295,161,0,722,0,ITF,ITF5,17,Basilicata
2021-01-19,UMB,103,23,80,21,2,80,0,103,0,ITI,ITI2,10,Umbria
2021-01-19,CAM,1095,474,621,534,390,171,0,1092,3,ITF,ITF3,15,Campania
2021-02-01,PAB,1306,350,956,650,362,294,0,10,1296,ITH,ITH1,4,Provincia Autonoma Bolzano / Bozen
2021-01-01,LIG,144,55,89,139,5,0,0,144,0,ITC,ITC3,7,Liguria
2021-01-17,LAZ,4443,1784,2659,3120,335,177,811,4337,106,ITI,ITI4,12,Lazio
2021-01-04,ABR,1401,575,826,1396,5,0,0,1401,0,ITF,ITF1,13,Abruzzo
2021-01-27,MAR,2117,780,1337,1751,226,140,0,122,1995,ITI,ITI3,11,Marche
2021-01-10,LOM,10510,3955,6555,6864,3621,8,17,10510,0,ITC,ITC4,3,Lombardia
2021-01-17,TOS,2485,836,1649,2002,293,190,0,1972,513,ITI,ITI1,9,Toscana
2021-01-15,LIG,2140,725,1415,1214,414,512,0,2140,0,ITC,ITC3,7,Liguria
2021-01-05,EMR,9327,3164,6163,7861,701,765,0,9327,0,ITH,ITH5,8,Emilia-Romagna
2021-01-31,SIC,4108,1958,2150,2599,1215,294,0,112,3996,ITG,ITG1,19,Sicilia
2021-02-07,CAL,858,427,431,565,212,81,0,146,712,ITF,ITF6,18,Calabria
2021-01-17,LOM,8041,3258,4783,5099,2775,122,45,7843,198,ITC,ITC4,3,Lombardia
2021-01-13,PAB,1310,406,904,366,586,252,106,1310,0,ITH,ITH1,4,Provincia Autonoma Bolzano / Bozen
2021-01-17,FVG,1719,523,1196,674,560,485,0,1719,0,ITH,ITH4,6,Friuli-Venezia Giulia
2021-02-05,LAZ,6905,2721,4184,5092,630,994,189,1128,5777,ITI,ITI4,12,Lazio
2021-01-31,CAM,8066,3710,4356,5106,2893,67,0,24,8042,ITF,ITF3,15,Campania
2021-01-28,BAS,903,401,502,434,391,78,0,119,784,ITF,ITF5,17,Basilicata
2021-01-23,ABR,263,114,149,223,14,26,0,57,206,ITF,ITF1,13,Abruzzo
2021-01-19,LAZ,4354,1665,2689,2965,557,424,408,3901,453,ITI,ITI4,12,Lazio
2021-01-26,UMB,814,390,424,813,1,0,0,18,796,ITI,ITI2,10,Umbria
2021-01-15,TOS,3878,1347,2531,2758,676,444,0,3878,0,ITI,ITI1,9,Toscana
2020-12-29,SAR,56,31,25,55,1,0,0,56,0,ITG,ITG2,20,Sardegna
2021-01-12,PIE,9988,3387,6601,6820,1996,1172,0,9988,0,ITC,ITC1,1,Piemonte
2021-01-11,MOL,557,194,363,196,250,111,0,557,0,ITF,ITF2,14,Molise
2021-01-30,PAB,296,133,163,59,136,101,0,4,292,ITH,ITH1,4,Provincia Autonoma Bolzano / Bozen
2021-01-29,PIE,5844,1850,3994,4115,1057,672,0,453,5391,ITC,ITC1,1,Piemonte
2021-01-25,PUG,3814,1675,2139,3466,180,168,0,421,3393,ITF,ITF4,16,Puglia
2021-01-13,MAR,2105,746,1359,1408,621,76,0,2105,0,ITI,ITI3,11,Marche
2021-02-03,LOM,23848,7462,16386,14470,5614,3635,129,721,23127,ITC,ITC4,3,Lombardia
2021-01-19,EMR,2032,500,1532,739,142,1151,0,2014,18,ITH,ITH5,8,Emilia-Romagna
2021-01-24,PAT,545,274,271,533,12,0,0,222,323,ITH,ITH2,4,Provincia Autonoma Trento
2021-01-10,VEN,5019,1661,3358,3837,718,462,2,5019,0,ITH,ITH3,5,Veneto
2020-12-31,CAM,1490,811,679,1273,216,1,0,1490,0,ITF,ITF3,15,Campania
2021-01-05,LAZ,7370,2802,4568,6690,103,577,0,7370,0,ITI,ITI4,12,Lazio
2021-01-12,SAR,865,408,457,504,361,0,0,865,0,ITG,ITG2,20,Sardegna
2021-01-17,UMB,54,17,37,47,7,0,0,54,0,ITI,ITI2,10,Umbria
2021-01-08,PUG,5562,2332,3230,4762,475,325,0,5562,0,ITF,ITF4,16,Puglia
2021-01-07,CAL,2179,1061,1118,1882,297,0,0,2179,0,ITF,ITF6,18,Calabria
2021-02-05,EMR,9142,2914,6228,6124,1359,1520,139,1587,7555,ITH,ITH5,8,Emilia-Romagna
2021-01-29,LIG,2730,959,1771,2093,326,311,0,38,2692,ITC,ITC3,7,Liguria
2020-12-27,PAT,103,40,63,76,6,21,0,103,0,ITH,ITH2,4,Provincia Autonoma Trento
2021-01-25,MAR,1595,558,1037,1425,114,56,0,97,1498,ITI,ITI3,11,Marche
2021-02-06,MOL,428,178,250,275,23,130,0,28,400,ITF,ITF2,14,Molise
2020-12-31,UMB,322,127,195,310,12,0,0,322,0,ITI,ITI2,10,Umbria
2021-01-29,SAR,2943,1065,1878,2572,368,3,0,48,2895,ITG,ITG2,20,Sardegna
2021-01-17,CAM,1155,551,604,718,286,151,0,702,453,ITF,ITF3,15,Campania
2021-01-29,TOS,6132,1698,4434,5373,139,620,0,299,5833,ITI,ITI1,9,Toscana
2021-01-10,PAT,84,19,65,53,19,12,0,84,0,ITH,ITH2,4,Provincia Autonoma Trento
2021-02-08,MAR,833,258,575,408,163,262,0,371,462,ITI,ITI3,11,Marche
2021-01-09,VDA,443,199,244,225,196,22,0,443,0,ITC,ITC2,2,Valle d'Aosta / Vallée d'Aoste
2021-01-24,VEN,4115,1218,2897,3750,143,222,0,27,4088,ITH,ITH3,5,Veneto
2021-01-03,PIE,3061,966,2095,2714,295,52,0,3061,0,ITC,ITC1,1,Piemonte
2021-01-20,MOL,18,8,10,14,4,0,0,18,0,ITF,ITF2,14,Molise
2021-01-17,SIC,1295,584,711,619,516,160,0,1245,50,ITG,ITG1,19,Sicilia
2021-01-24,CAL,44,18,26,15,3,26,0,39,5,ITF,ITF6,18,Calabria
2021-01-31,FVG,2712,836,1876,1692,1002,18,0,385,2327,ITH,ITH4,6,Friuli-Venezia Giulia
2021-01-09,ABR,1483,565,918,1430,53,0,0,1483,0,ITF,ITF1,13,Abruzzo
2021-01-14,BAS,969,413,556,402,244,323,0,969,0,ITF,ITF5,17,Basilicata
2021-01-05,LOM,7671,2513,5158,5710,1786,167,8,7671,0,ITC,ITC4,3,Lombardia
2020-12-31,EMR,2202,775,1427,1662,214,326,0,2202,0,ITH,ITH5,8,Emilia-Romagna
2021-01-20,LIG,1183,448,735,534,330,319,0,1172,11,ITC,ITC3,7,Liguria
2021-01-13,MOL,474,160,314,256,74,144,0,474,0,ITF,ITF2,14,Molise
2021-01-23,BAS,705,298,407,480,224,1,0,33,672,ITF,ITF5,17,Basilicata
2021-01-28,ABR,1432,494,938,1369,62,1,0,12,1420,ITF,ITF1,13,Abruzzo
2021-01-24,LAZ,5467,2109,3358,4945,262,134,126,385,5082,ITI,ITI4,12,Lazio
2021-01-10,TOS,2999,1103,1896,2433,138,428,0,2999,0,ITI,ITI1,9,Toscana
2021-01-03,SAR,90,36,54,89,1,0,0,90,0,ITG,ITG2,20,Sardegna
2021-01-17,PIE,3514,1168,2346,2080,595,839,0,2867,647,ITC,ITC1,1,Piemonte
2021-01-27,PUG,4558,1924,2634,3900,262,396,0,600,3958,ITF,ITF4,16,Puglia
2021-01-29,SIC,9354,4317,5037,7145,1904,305,0,431,8923,ITG,ITG1,19,Sicilia
2021-02-05,CAL,2009,895,1114,1205,434,370,0,337,1672,ITF,ITF6,18,Calabria
2021-01-03,LIG,727,226,501,651,76,0,0,727,0,ITC,ITC3,7,Liguria
2021-01-17,EMR,2888,887,2001,1918,431,539,0,2642,246,ITH,ITH5,8,Emilia-Romagna
2021-01-25,PAB,429,166,263,354,74,0,1,3,426,ITH,ITH1,4,Provincia Autonoma Bolzano / Bozen
2021-02-07,LAZ,4665,1864,2801,3250,385,218,812,381,4284,ITI,ITI4,12,Lazio
2021-01-05,FVG,1679,550,1129,1349,133,197,0,1679,0,ITH,ITH4,6,Friuli-Venezia Giulia
2020-12-29,LAZ,418,150,268,418,0,0,0,418,0,ITI,ITI4,12,Lazio
2021-01-11,PAB,1495,474,1021,532,641,173,149,1495,0,ITH,ITH1,4,Provincia Autonoma Bolzano / Bozen
2021-01-29,LOM,13197,4051,9146,10268,2366,556,7,589,12608,ITC,ITC4,3,Lombardia
2021-01-08,MAR,1574,588,986,1226,348,0,0,1574,0,ITI,ITI3,11,Marche
2021-01-29,PAT,1347,331,1016,710,97,540,0,54,1293,ITH,ITH2,4,Provincia Autonoma Trento
2021-02-09,BAS,233,97,136,139,87,7,0,161,72,ITF,ITF5,17,Basilicata
2021-01-15,VEN,5791,1777,4014,2986,1305,1491,9,5791,0,ITH,ITH3,5,Veneto
2021-02-08,MOL,334,141,193,206,43,85,0,216,118,ITF,ITF2,14,Molise
2021-02-04,VDA,293,85,208,167,91,34,1,7,286,ITC,ITC2,2,Valle d'Aosta / Vallée d'Aoste
2021-02-07,UMB,54,17,37,46,8,0,0,1,53,ITI,ITI2,10,Umbria
2021-01-17,SAR,860,277,583,747,113,0,0,859,1,ITG,ITG2,20,Sardegna
2021-01-12,UMB,784,247,537,665,14,105,0,784,0,ITI,ITI2,10,Umbria
2021-01-31,PIE,4099,1746,2353,3076,654,369,0,112,3987,ITC,ITC1,1,Piemonte
2021-01-13,PUG,4521,1720,2801,3954,337,230,0,4521,0,ITF,ITF4,16,Puglia
2021-01-31,EMR,7692,2758,4934,6163,1268,261,0,242,7450,ITH,ITH5,8,Emilia-Romagna
2021-02-08,PAB,1,1,0,0,1,0,0,1,0,ITH,ITH1,4,Provincia Autonoma Bolzano / Bozen
2021-01-21,VDA,33,12,21,0,0,33,0,33,0,ITC,ITC2,2,Valle d'Aosta / Vallée d'Aoste
2020-12-30,PAB,362,168,194,321,41,0,0,362,0,ITH,ITH1,4,Provincia Autonoma Bolzano / Bozen
2021-01-03,LOM,852,316,536,710,137,4,1,852,0,ITC,ITC4,3,Lombardia
2021-02-03,LIG,2010,710,1300,1452,261,297,0,109,1901,ITC,ITC3,7,Liguria
2021-01-20,MAR,398,99,299,146,62,190,0,386,12,ITI,ITI3,11,Marche
2021-01-12,CAM,5214,2563,2651,3439,1435,340,0,5214,0,ITF,ITF3,15,Campania
2021-02-06,ABR,1611,742,869,1168,371,72,0,602,1009,ITF,ITF1,13,Abruzzo
2021-01-11,ABR,1551,557,994,1337,166,48,0,1551,0,ITF,ITF1,13,Abruzzo
2021-02-03,MAR,2124,741,1383,1344,614,166,0,119,2005,ITI,ITI3,11,Marche
2021-01-15,PAT,572,124,448,448,32,92,0,572,0,ITH,ITH2,4,Provincia Autonoma Trento
2021-01-04,VDA,142,59,83,126,16,0,0,142,0,ITC,ITC2,2,Valle d'Aosta / Vallée d'Aoste
2021-01-29,VEN,8983,2778,6205,6021,1528,1431,3,363,8620,ITH,ITH3,5,Veneto
2021-01-25,MOL,319,130,189,317,2,0,0,3,316,ITF,ITF2,14,Molise
2021-01-29,CAM,10049,4811,5238,6403,3387,259,0,47,10002,ITF,ITF3,15,Campania
2021-01-31,SAR,2121,750,1371,1544,576,0,1,48,2073,ITG,ITG2,20,Sardegna
2021-02-08,PUG,3572,1455,2117,2611,573,388,0,1334,2238,ITF,ITF4,16,Puglia
2021-01-12,SIC,4542,2234,2308,2863,1484,195,0,4542,0,ITG,ITG1,19,Sicilia
2021-01-05,PIE,5376,1602,3774,4362,729,285,0,5376,0,ITC,ITC1,1,Piemonte
2021-01-19,CAL,1108,488,620,852,180,76,0,1098,10,ITF,ITF6,18,Calabria
2021-02-05,FVG,2613,784,1829,1613,510,490,0,90,2523,ITH,ITH4,6,Friuli-Venezia Giulia
2021-01-27,TOS,4799,1552,3247,4001,74,724,0,196,4603,ITI,ITI1,9,Toscana
2021-01-09,BAS,559,161,398,281,211,67,0,559,0,ITF,ITF5,17,Basilicata
2020-12-30,PUG,1,0,1,1,0,0,0,1,0,ITF,ITF4,16,Puglia
2021-01-28,CAL,2232,1107,1125,1920,312,0,0,84,2148,ITF,ITF6,18,Calabria
2021-01-21,SIC,1327,646,681,1000,190,137,0,498,829,ITG,ITG1,19,Sicilia
2021-01-05,LIG,2753,860,1893,2216,306,231,0,2753,0,ITC,ITC3,7,Liguria
2021-01-07,LOM,11553,3593,7960,8083,2804,594,72,11553,0,ITC,ITC4,3,Lombardia
2021-01-21,CAM,2091,1114,977,1378,638,75,0,676,1415,ITF,ITF3,15,Campania
2021-01-28,SAR,2952,1039,1913,2538,414,0,0,69,2883,ITG,ITG2,20,Sardegna
2021-01-26,LAZ,7601,2906,4695,6589,256,631,125,371,7230,ITI,ITI4,12,Lazio
2021-01-13,ABR,1253,440,813,1103,150,0,0,1253,0,ITF,ITF1,13,Abruzzo
2021-01-18,BAS,459,156,303,360,57,42,0,360,99,ITF,ITF5,17,Basilicata
2021-01-07,FVG,2089,718,1371,1758,221,110,0,2089,0,ITH,ITH4,6,Friuli-Venezia Giulia
2021-01-09,LAZ,6286,2556,3730,5108,558,620,0,6286,0,ITI,ITI4,12,Lazio
2021-01-05,TOS,5244,1755,3489,4354,11,879,0,5244,0,ITI,ITI1,9,Toscana
2021-01-16,UMB,221,73,148,146,32,43,0,221,0,ITI,ITI2,10,Umbria
2021-01-02,PIE,3539,1134,2405,3072,414,53,0,3539,0,ITC,ITC1,1,Piemonte
2021-01-15,PUG,4475,1826,2649,3546,398,531,0,4475,0,ITF,ITF4,16,Puglia
2021-01-19,PIE,6387,2097,4290,3635,1312,1440,0,6285,102,ITC,ITC1,1,Piemonte
2021-01-03,MAR,896,348,548,759,137,0,0,896,0,ITI,ITI3,11,Marche
2021-01-31,PAT,74,15,59,55,13,6,0,0,74,ITH,ITH2,4,Provincia Autonoma Trento
2021-01-09,EMR,9872,3425,6447,7636,1337,899,0,9872,0,ITH,ITH5,8,Emilia-Romagna
2021-02-09,VEN,2186,758,1428,1357,482,347,0,1292,894,ITH,ITH3,5,Veneto
2021-01-14,PAT,690,199,491,469,19,202,0,690,0,ITH,ITH2,4,Provincia Autonoma Trento
2021-01-21,LOM,5122,1510,3612,1777,3158,187,0,4436,686,ITC,ITC4,3,Lombardia
2020-12-31,VEN,3219,1044,2175,2699,268,252,0,3219,0,ITH,ITH3,5,Veneto
2021-02-02,UMB,942,274,668,713,17,212,0,32,910,ITI,ITI2,10,Umbria
2021-01-30,VDA,436,202,234,232,192,12,0,13,423,ITC,ITC2,2,Valle d'Aosta / Vallée d'Aoste
2021-01-31,VEN,4679,1540,3139,3645,670,360,4,385,4294,ITH,ITH3,5,Veneto
2021-02-08,ABR,1197,396,801,710,223,264,0,491,706,ITF,ITF1,13,Abruzzo
2021-01-02,SAR,60,21,39,60,0,0,0,60,0,ITG,ITG2,20,Sardegna
2021-02-03,PAB,1445,457,988,615,441,321,68,5,1440,ITH,ITH1,4,Provincia Autonoma Bolzano / Bozen
2020-12-28,CAL,6,2,4,6,0,0,0,6,0,ITF,ITF6,18,Calabria
2021-02-02,PIE,10125,3479,6646,6800,2025,1300,0,764,9361,ITC,ITC1,1,Piemonte
2021-01-19,LIG,1174,397,777,572,349,253,0,1089,85,ITC,ITC3,7,Liguria
2021-01-13,VDA,337,110,227,166,143,28,0,337,0,ITC,ITC2,2,Valle d'Aosta / Vallée d'Aoste
2021-01-27,MOL,674,251,423,436,29,209,0,8,666,ITF,ITF2,14,Molise
2021-02-07,LOM,6804,2689,4115,4856,1720,213,15,119,6685,ITC,ITC4,3,Lombardia
2021-02-04,LAZ,6043,2280,3763,4460,619,892,72,940,5103,ITI,ITI4,12,Lazio
2021-01-07,CAM,8904,4162,4742,6309,2263,332,0,8904,0,ITF,ITF3,15,Campania
2021-01-19,SAR,747,270,477,423,165,159,0,692,55,ITG,ITG2,20,Sardegna
2020-12-31,PAT,1588,438,1150,815,107,666,0,1588,0,ITH,ITH2,4,Provincia Autonoma Trento
2021-01-19,TOS,1103,529,574,392,221,490,0,1103,0,ITI,ITI1,9,Toscana
2021-01-29,MAR,1991,730,1261,1479,438,74,0,168,1823,ITI,ITI3,11,Marche
2021-01-14,VEN,6978,1883,5095,3217,1336,2408,17,6978,0,ITH,ITH3,5,Veneto
2021-01-10,MOL,270,72,198,82,19,169,0,270,0,ITF,ITF2,14,Molise
2021-01-04,UMB,809,397,412,808,1,0,0,809,0,ITI,ITI2,10,Umbria
2021-02-08,VDA,220,82,138,28,128,0,64,22,198,ITC,ITC2,2,Valle d'Aosta / Vallée d'Aoste
2021-01-14,CAL,2556,1214,1342,1962,591,3,0,2556,0,ITF,ITF6,18,Calabria
2021-01-07,SIC,9172,4239,4933,7694,1268,210,0,9172,0,ITG,ITG1,19,Sicilia
2021-01-24,PUG,1660,744,916,1279,233,148,0,146,1514,ITF,ITF4,16,Puglia
2021-01-17,PAB,2268,1024,1244,54,235,19,1960,2256,12,ITH,ITH1,4,Provincia Autonoma Bolzano / Bozen
2021-01-21,FVG,891,345,546,860,31,0,0,0,891,ITH,ITH4,6,Friuli-Venezia Giulia
2021-02-09,EMR,1711,482,1229,920,203,573,15,799,912,ITH,ITH5,8,Emilia-Romagna
2021-02-05,LIG,2132,802,1330,1431,394,307,0,143,1989,ITC,ITC3,7,Liguria
2021-02-09,PAT,251,101,150,100,34,0,117,150,101,ITH,ITH2,4,Provincia Autonoma Trento
2021-01-02,LOM,199,72,127,177,22,0,0,199,0,ITC,ITC4,3,Lombardia
2021-02-02,SAR,1479,653,826,985,494,0,0,241,1238,ITG,ITG2,20,Sardegna
2021-01-13,BAS,915,386,529,573,194,148,0,915,0,ITF,ITF5,17,Basilicata
2021-01-02,VEN,5740,1765,3975,4796,398,544,2,5740,0,ITH,ITH3,5,Veneto
2021-01-14,LAZ,5217,1960,3257,3872,450,811,84,5217,0,ITI,ITI4,12,Lazio
2021-01-09,FVG,2516,841,1675,1518,405,593,0,2516,0,ITH,ITH4,6,Friuli-Venezia Giulia
2020-12-31,TOS,786,196,590,97,7,682,0,786,0,ITI,ITI1,9,Toscana
2021-01-07,PIE,5370,1731,3639,4145,884,341,0,5370,0,ITC,ITC1,1,Piemonte
2021-01-02,PAT,497,142,355,333,25,139,0,497,0,ITH,ITH2,4,Provincia Autonoma Trento
2021-01-17,PUG,1293,585,708,816,148,329,0,1224,69,ITF,ITF4,16,Puglia
2021-01-15,PAB,3013,1113,1900,525,893,335,1260,3013,0,ITH,ITH1,4,Provincia Autonoma Bolzano / Bozen
2021-01-28,LAZ,7954,2998,4956,6810,496,514,134,459,7495,ITI,ITI4,12,Lazio
2021-02-02,CAM,5722,2804,2918,3640,1728,354,0,443,5279,ITF,ITF3,15,Campania
2021-02-02,SIC,5536,2621,2915,3151,1956,429,0,632,4904,ITG,ITG1,19,Sicilia
2021-01-07,LIG,2936,1015,1921,2144,434,358,0,2936,0,ITC,ITC3,7,Liguria
2021-02-09,CAL,600,281,319,430,137,33,0,218,382,ITF,ITF6,18,Calabria
2021-01-19,LOM,7747,2261,5486,3011,2913,1710,113,7271,476,ITC,ITC4,3,Lombardia
2021-01-30,BAS,698,225,473,298,275,125,0,126,572,ITF,ITF5,17,Basilicata
2021-01-19,PAT,402,77,325,324,42,36,0,402,0,ITH,ITH2,4,Provincia Autonoma Trento
2021-01-29,MOL,421,136,285,227,85,109,0,6,415,ITF,ITF2,14,Molise
2021-01-28,UMB,1240,392,848,891,4,345,0,19,1221,ITI,ITI2,10,Umbria
2021-01-25,VDA,147,65,82,125,16,6,0,0,147,ITC,ITC2,2,Valle d'Aosta / Vallée d'Aoste
2021-01-07,SAR,3098,1073,2025,2707,391,0,0,3098,0,ITG,ITG2,20,Sardegna
2021-02-08,BAS,502,175,327,422,71,9,0,148,354,ITF,ITF5,17,Basilicata
2021-01-02,UMB,301,110,191,301,0,0,0,301,0,ITI,ITI2,10,Umbria
2021-01-21,PIE,6693,2254,4439,4673,852,1168,0,3207,3486,ITC,ITC1,1,Piemonte
2021-01-31,TOS,3048,1129,1919,2465,135,448,0,105,2943,ITI,ITI1,9,Toscana
2021-01-03,PUG,2003,941,1062,1791,69,143,0,2003,0,ITF,ITF4,16,Puglia
2021-01-21,EMR,2140,724,1416,1274,219,647,0,799,1341,ITH,ITH5,8,Emilia-Romagna
2021-01-29,PAB,1405,449,956,774,334,295,2,23,1382,ITH,ITH1,4,Provincia Autonoma Bolzano / Bozen
2021-01-11,VDA,325,112,213,238,57,30,0,325,0,ITC,ITC2,2,Valle d'Aosta / Vallée d'Aoste
2021-02-07,PIE,3083,972,2111,1647,661,775,0,445,2638,ITC,ITC1,1,Piemonte
2021-01-10,MAR,1737,699,1038,1462,275,0,0,1737,0,ITI,ITI3,11,Marche
2021-01-24,LIG,750,233,517,626,64,60,0,113,637,ITC,ITC3,7,Liguria
2021-01-02,CAM,3674,1963,1711,3167,507,0,0,3674,0,ITF,ITF3,15,Campania
2021-02-02,VEN,6367,1836,4531,2965,1281,1970,151,384,5983,ITH,ITH3,5,Veneto
2021-02-09,LAZ,4956,2079,2877,1876,266,358,2456,2677,2279,ITI,ITI4,12,Lazio
2021-02-02,LOM,19075,6334,12741,12912,4528,1557,78,427,18648,ITC,ITC4,3,Lombardia
2021-01-27,ABR,1364,515,849,1301,63,0,0,39,1325,ITF,ITF1,13,Abruzzo
2021-02-07,LIG,374,142,232,146,64,164,0,3,371,ITC,ITC3,7,Liguria
2021-01-24,MAR,879,338,541,762,117,0,0,17,862,ITI,ITI3,11,Marche
2021-01-14,TOS,3254,1179,2075,2459,475,320,0,3254,0,ITI,ITI1,9,Toscana
2021-01-19,VEN,1309,472,837,724,255,324,6,1160,149,ITH,ITH3,5,Veneto
2021-01-15,MOL,538,242,296,398,59,81,0,538,0,ITF,ITF2,14,Molise
2021-01-02,SIC,4871,2532,2339,4311,560,0,0,4871,0,ITG,ITG1,19,Sicilia
2021-01-29,PUG,6062,2593,3469,5350,424,288,0,431,5631,ITF,ITF4,16,Puglia
2021-01-09,CAL,1916,1036,880,1529,387,0,0,1916,0,ITF,ITF6,18,Calabria
2021-01-21,SAR,126,60,66,60,66,0,0,94,32,ITG,ITG2,20,Sardegna
2021-02-04,EMR,9480,3084,6396,6203,1744,1426,107,1174,8306,ITH,ITH5,8,Emilia-Romagna
2021-01-26,FVG,1970,647,1323,1438,152,380,0,212,1758,ITH,ITH4,6,Friuli-Venezia Giulia
2020-12-28,LAZ,516,228,288,515,1,0,0,516,0,ITI,ITI4,12,Lazio
2021-01-08,MOL,429,141,288,244,65,120,0,429,0,ITF,ITF2,14,Molise
2021-02-06,VDA,288,103,185,169,45,0,74,91,197,ITC,ITC2,2,Valle d'Aosta / Vallée d'Aoste
2020-12-27,MAR,200,97,103,184,12,4,0,200,0,ITI,ITI3,11,Marche
2021-02-05,MAR,2133,650,1483,1309,418,406,0,440,1693,ITI,ITI3,11,Marche
2021-01-16,LAZ,5339,2069,3270,3347,460,1062,470,5339,0,ITI,ITI4,12,Lazio
2021-02-07,SAR,1115,394,721,975,140,0,0,226,889,ITG,ITG2,20,Sardegna
2021-01-07,VEN,8354,2320,6034,5461,1089,1804,0,8354,0,ITH,ITH3,5,Veneto
2021-01-14,FVG,2581,783,1798,1601,550,430,0,2581,0,ITH,ITH4,6,Friuli-Venezia Giulia
2021-01-14,SIC,5302,2535,2767,3098,1945,259,0,5302,0,ITG,ITG1,19,Sicilia
2021-01-07,PAT,1267,310,957,648,64,555,0,1267,0,ITH,ITH2,4,Provincia Autonoma Trento
2021-01-22,PUG,1408,577,831,877,158,373,0,992,416,ITF,ITF4,16,Puglia
2021-01-02,EMR,2347,903,1444,2071,79,197,0,2347,0,ITH,ITH5,8,Emilia-Romagna
2020-12-29,LIG,118,32,86,87,10,21,0,118,0,ITC,ITC3,7,Liguria
2021-01-21,CAL,958,444,514,735,108,115,0,929,29,ITF,ITF6,18,Calabria
2021-01-10,PAB,2,2,0,1,1,0,0,2,0,ITH,ITH1,4,Provincia Autonoma Bolzano / Bozen
2021-01-09,PIE,6181,2184,3997,4486,1127,568,0,6181,0,ITC,ITC1,1,Piemonte
2021-01-05,PUG,5095,2244,2851,4703,290,97,5,5095,0,ITF,ITF4,16,Puglia
2021-02-05,PAB,2601,947,1654,639,508,377,1077,6,2595,ITH,ITH1,4,Provincia Autonoma Bolzano / Bozen
2021-02-02,LAZ,5772,2133,3639,4712,486,571,3,501,5271,ITI,ITI4,12,Lazio
2021-01-28,CAM,8829,4122,4707,6213,2269,347,0,134,8695,ITF,ITF3,15,Campania
2020-12-31,FVG,1053,384,669,1011,42,0,0,1053,0,ITH,ITH4,6,Friuli-Venezia Giulia
2021-01-28,SIC,9309,4391,4918,7449,1565,295,0,412,8897,ITG,ITG1,19,Sicilia
2021-02-04,CAL,3108,1506,1602,2407,479,222,0,644,2464,ITF,ITF6,18,Calabria
2021-01-12,LIG,2152,801,1351,1559,270,323,0,2152,0,ITC,ITC3,7,Liguria
2021-02-09,FVG,289,107,182,95,121,73,0,228,61,ITH,ITH4,6,Friuli-Venezia Giulia
2021-01-14,LOM,25826,7557,18269,11252,9509,4606,459,25826,0,ITC,ITC4,3,Lombardia
2020-12-27,PAB,143,65,78,136,6,0,1,143,0,ITH,ITH1,4,Provincia Autonoma Bolzano / Bozen
2021-01-21,PAT,349,93,256,289,44,16,0,227,122,ITH,ITH2,4,Provincia Autonoma Trento
2021-02-07,TOS,2805,953,1852,2348,300,157,0,884,1921,ITI,ITI1,9,Toscana
2021-01-20,ABR,447,156,291,147,96,204,0,445,2,ITF,ITF1,13,Abruzzo
2021-01-25,BAS,1019,426,593,660,358,1,0,74,945,ITF,ITF5,17,Basilicata
2021-01-31,LOM,9508,3641,5867,7273,2141,87,7,32,9476,ITC,ITC4,3,Lombardia
2021-02-03,MOL,731,249,482,391,160,180,0,338,393,ITF,ITF2,14,Molise
2021-01-20,VDA,23,8,15,0,0,6,17,23,0,ITC,ITC2,2,Valle d'Aosta / Vallée d'Aoste
2021-01-23,UMB,277,100,177,276,1,0,0,2,275,ITI,ITI2,10,Umbria
2021-02-02,PAT,880,237,643,460,95,165,160,188,692,ITH,ITH2,4,Provincia Autonoma Trento
2021-01-28,FVG,2231,791,1440,1752,287,192,0,351,1880,ITH,ITH4,6,Friuli-Venezia Giulia
2021-01-21,VEN,2292,720,1572,1986,165,141,0,23,2269,ITH,ITH3,5,Veneto
2021-01-26,PIE,6323,1875,4448,4720,875,728,0,734,5589,ITC,ITC1,1,Piemonte
2021-01-26,TOS,5391,1791,3600,4356,84,951,0,218,5173,ITI,ITI1,9,Toscana
2021-01-16,EMR,5587,1716,3871,3651,840,1096,0,5587,0,ITH,ITH5,8,Emilia-Romagna
2020-12-31,SIC,877,469,408,827,50,0,0,877,0,ITG,ITG1,19,Sicilia
2021-01-06,VDA,65,33,32,29,18,18,0,65,0,ITC,ITC2,2,Valle d'Aosta / Vallée d'Aoste
2021-02-09,SIC,1870,809,1061,1106,608,156,0,1523,347,ITG,ITG1,19,Sicilia
2021-01-05,MAR,1562,586,976,1436,126,0,0,1562,0,ITI,ITI3,11,Marche
2021-01-09,SAR,4025,1416,2609,3180,845,0,0,4025,0,ITG,ITG2,20,Sardegna
2021-02-01,ABR,1632,573,1059,1384,247,1,0,271,1361,ITF,ITF1,13,Abruzzo
2021-02-07,VEN,2129,772,1357,1742,335,50,2,711,1418,ITH,ITH3,5,Veneto
2021-02-06,BAS,880,365,515,532,186,162,0,144,736,ITF,ITF5,17,Basilicata
2021-02-02,EMR,9293,2983,6310,6146,1550,1548,49,482,8811,ITH,ITH5,8,Emilia-Romagna
2021-01-06,ABR,1830,664,1166,1546,151,133,0,1830,0,ITF,ITF1,13,Abruzzo
2021-01-11,BAS,183,66,117,78,64,41,0,183,0,ITF,ITF5,17,Basilicata
2021-01-14,UMB,749,200,549,696,36,17,0,749,0,ITI,ITI2,10,Umbria
2021-01-14,CAM,7073,2977,4096,3707,3022,344,0,7073,0,ITF,ITF3,15,Campania
2020-12-31,PIE,3879,1318,2561,3387,358,134,0,3879,0,ITC,ITC1,1,Piemonte
2021-02-03,PUG,5018,1994,3024,4355,479,184,0,726,4292,ITF,ITF4,16,Puglia
2021-01-26,SAR,1335,453,882,1295,40,0,0,27,1308,ITG,ITG2,20,Sardegna
2021-01-27,PAB,84,28,56,54,30,0,0,1,83,ITH,ITH1,4,Provincia Autonoma Bolzano / Bozen
2021-02-09,PIE,2843,966,1877,1744,541,558,0,336,2507,ITC,ITC1,1,Piemonte
2021-01-26,LIG,2392,775,1617,1879,262,251,0,153,2239,ITC,ITC3,7,Liguria
2021-01-12,TOS,3581,1398,2183,2944,283,354,0,3581,0,ITI,ITI1,9,Toscana
2021-01-02,LAZ,6703,2629,4074,6267,78,358,0,6703,0,ITI,ITI4,12,Lazio
2021-01-22,MAR,487,167,320,315,85,87,0,194,293,ITI,ITI3,11,Marche
2021-01-26,SIC,9474,4663,4811,8346,874,254,0,234,9240,ITG,ITG1,19,Sicilia
2021-02-02,CAL,2005,993,1012,1623,307,75,0,170,1835,ITF,ITF6,18,Calabria
2020-12-31,LIG,948,334,614,714,53,153,28,948,0,ITC,ITC3,7,Liguria
2021-01-12,LOM,19488,6500,12988,10796,7198,1336,158,19488,0,ITC,ITC4,3,Lombardia
2021-02-01,VDA,397,124,273,268,60,69,0,81,316,ITC,ITC2,2,Valle d'Aosta / Vallée d'Aoste
2021-01-08,PAB,1472,467,1005,744,466,166,96,1472,0,ITH,ITH1,4,Provincia Autonoma Bolzano / Bozen
2021-01-21,LAZ,5220,2098,3122,4755,108,232,125,196,5024,ITI,ITI4,12,Lazio
2021-01-08,ABR,1525,507,1018,1487,38,0,0,1525,0,ITF,ITF1,13,Abruzzo
2021-01-26,CAM,7294,3701,3593,5739,1333,222,0,352,6942,ITF,ITF3,15,Campania
2021-01-02,FVG,1217,471,746,1150,67,0,0,1217,0,ITH,ITH4,6,Friuli-Venezia Giulia
2021-01-12,VEN,5204,1516,3688,2247,1054,1736,167,5204,0,ITH,ITH3,5,Veneto
2021-01-21,UMB,607,200,407,426,13,168,0,338,269,ITI,ITI2,10,Umbria
2021-01-19,FVG,1,1,0,1,0,0,0,1,0,ITH,ITH4,6,Friuli-Venezia Giulia
2021-01-09,SIC,7325,3424,3901,5034,1835,456,0,7325,0,ITG,ITG1,19,Sicilia
2021-01-16,CAL,2394,1120,1274,1664,489,241,0,2394,0,ITF,ITF6,18,Calabria
2021-01-12,PAT,494,158,336,397,43,54,0,494,0,ITH,ITH2,4,Provincia Autonoma Trento
2020-12-27,MOL,50,20,30,29,4,17,0,50,0,ITF,ITF2,14,Molise
2021-01-14,PIE,9756,3149,6607,6173,2101,1482,0,9756,0,ITC,ITC1,1,Piemonte
2021-02-09,SAR,987,383,604,569,326,92,0,636,351,ITG,ITG2,20,Sardegna
2021-01-10,PUG,2340,1057,1283,2027,112,201,0,2340,0,ITF,ITF4,16,Puglia
2021-02-04,UMB,732,226,506,692,20,20,0,25,707,ITI,ITI2,10,Umbria
2021-01-17,LIG,626,269,357,384,126,116,0,626,0,ITC,ITC3,7,Liguria
2021-01-26,PAT,498,138,360,398,16,84,0,26,472,ITH,ITH2,4,Provincia Autonoma Trento
2020-12-31,SAR,32,16,16,28,4,0,0,32,0,ITG,ITG2,20,Sardegna
2021-01-14,EMR,8085,2572,5513,5327,1156,1602,0,8085,0,ITH,ITH5,8,Emilia-Romagna
2021-01-26,LOM,8134,2650,5484,6433,1491,203,7,320,7814,ITC,ITC4,3,Lombardia
2021-01-25,ABR,1603,632,971,1583,20,0,0,20,1583,ITF,ITF1,13,Abruzzo
2021-02-02,TOS,3720,1464,2256,3020,279,421,0,174,3546,ITI,ITI1,9,Toscana
2021-01-20,BAS,84,22,62,0,84,0,0,84,0,ITF,ITF5,17,Basilicata
2021-02-09,CAM,1908,911,997,527,774,1,606,1732,176,ITF,ITF3,15,Campania
2021-02-02,FVG,2460,806,1654,1650,394,416,0,216,2244,ITH,ITH4,6,Friuli-Venezia Giulia
2021-01-26,VEN,6899,2080,4819,5306,632,961,0,153,6746,ITH,ITH3,5,Veneto
2021-01-02,CAL,165,94,71,165,0,0,0,165,0,ITF,ITF6,18,Calabria
2021-01-28,PIE,5442,1770,3672,4019,852,571,0,349,5093,ITC,ITC1,1,Piemonte
2020-12-27,PUG,506,249,257,401,42,63,0,506,0,ITF,ITF4,16,Puglia
2021-01-22,MOL,126,35,91,21,32,73,0,126,0,ITF,ITF2,14,Molise
2021-01-18,VDA,213,74,139,29,111,27,46,213,0,ITC,ITC2,2,Valle d'Aosta / Vallée d'Aoste
2021-01-14,SAR,1105,426,679,885,220,0,0,1105,0,ITG,ITG2,20,Sardegna
2021-02-01,BAS,242,91,151,89,105,48,0,46,196,ITF,ITF5,17,Basilicata
2021-01-24,TOS,3347,1072,2275,2601,37,709,0,199,3148,ITI,ITI1,9,Toscana
2021-01-28,EMR,10212,3332,6880,8052,1046,1114,0,353,9859,ITH,ITH5,8,Emilia-Romagna
2021-02-09,LOM,2480,708,1772,1214,613,631,22,420,2060,ITC,ITC4,3,Lombardia
2021-01-06,BAS,294,129,165,143,115,36,0,294,0,ITF,ITF5,17,Basilicata
2021-02-05,PUG,5312,2135,3177,4325,507,480,0,1183,4129,ITF,ITF4,16,Puglia
2021-01-09,UMB,1719,492,1227,888,10,821,0,1719,0,ITI,ITI2,10,Umbria
2021-01-09,CAM,10563,5023,5540,6758,3536,269,0,10563,0,ITF,ITF3,15,Campania
2021-01-22,PAB,242,138,104,130,24,85,3,124,118,ITH,ITH1,4,Provincia Autonoma Bolzano / Bozen
2021-01-17,MAR,1598,682,916,964,588,46,0,1549,49,ITI,ITI3,11,Marche
2021-01-07,LAZ,7718,2890,4828,6876,276,566,0,7718,0,ITI,ITI4,12,Lazio
2020-12-31,LOM,713,300,413,656,57,0,0,713,0,ITC,ITC4,3,Lombardia
2021-01-07,TOS,6013,1750,4263,5308,30,675,0,6013,0,ITI,ITI1,9,Toscana
2021-01-31,LIG,617,264,353,382,101,134,0,7,610,ITC,ITC3,7,Liguria
