data_somministrazione,area,totale,sesso_maschile,sesso_femminile,prima_dose,seconda_dose,codice_NUTS1,codice_NUTS2,codice_regione_ISTAT,nome_area
2021-04-11,CAM,17523,8606,8917,15441,2082,ITF,ITF3,15,Campania
2021-05-24,FVG,11391,5513,5878,7780,3611,ITH,ITH4,6,Friuli-Venezia Giulia
2021-06-04,BAS,4829,2286,2543,3783,1046,ITF,ITF5,17,Basilicata
2021-02-22,ABR,2642,1173,1469,2612,30,ITF,ITF1,13,Abruzzo
2021-06-02,UMB,3944,1895,2049,3904,40,ITI,ITI2,10,Umbria
2021-02-13,FVG,566,179,387,560,6,ITH,ITH4,6,Friuli-Venezia Giulia
2021-02-18,LAZ,10017,4975,5042,9208,809,ITI,ITI4,12,Lazio
2021-02-21,PUG,2176,474,1702,2114,62,ITF,ITF4,16,Puglia
2021-04-28,CAM,36436,17643,18793,26686,9750,ITF,ITF3,15,Campania
2021-01-18,CAM,957,399,558,713,244,ITF,ITF3,15,Campania
2021-06-01,PUG,34665,17336,17329,21852,12813,ITF,ITF4,16,Puglia
2021-02-24,BAS,1803,743,1060,1734,69,ITF,ITF5,17,Basilicata
2021-05-15,PUG,43437,18911,24526,23481,19956,ITF,ITF4,16,Puglia
2021-05-26,EMR,33197,14720,18477,10296,22901,ITH,ITH5,8,Emilia-Romagna
2021-04-26,LIG,10544,4980,5564,7908,2636,ITC,ITC3,7,Liguria
2021-05-12,LAZ,47482,21540,25942,30886,16596,ITI,ITI4,12,Lazio
2021-06-17,VEN,50285,25230,25055,25775,24510,ITH,ITH3,5,Veneto
2021-06-12,EMR,40273,21298,18975,35383,4890,ITH,ITH5,8,Emilia-Romagna
2021-06-12,PAT,5353,2688,2665,471,4882,ITH,ITH2,4,Provincia Autonoma Trento
2021-03-09,VEN,16541,7446,9095,10218,6323,ITH,ITH3,5,Veneto
2021-04-05,MAR,5688,2355,3333,4419,1269,ITI,ITI3,11,Marche
2021-02-05,ABR,1534,521,1013,788,746,ITF,ITF1,13,Abruzzo
2021-03-04,EMR,16452,5350,11102,13435,3017,ITH,ITH5,8,Emilia-Romagna
2021-02-19,MOL,169,93,76,167,2,ITF,ITF2,14,Molise
2021-01-16,LIG,1278,557,721,1278,0,ITC,ITC3,7,Liguria
2021-05-16,ABR,9577,4138,5439,5764,3813,ITF,ITF1,13,Abruzzo
2021-05-31,VEN,31559,16191,15368,21665,9894,ITH,ITH3,5,Veneto
2021-02-01,LAZ,5675,2177,3498,354,5321,ITI,ITI4,12,Lazio
2021-03-02,FVG,4219,1519,2700,2720,1499,ITH,ITH4,6,Friuli-Venezia Giulia
2021-03-21,PAT,129,69,60,129,0,ITH,ITH2,4,Provincia Autonoma Trento
2021-06-03,PUG,50070,24287,25783,30952,19118,ITF,ITF4,16,Puglia
2021-06-04,ABR,15588,7366,8222,10901,4687,ITF,ITF1,13,Abruzzo
2021-02-22,BAS,1790,773,1017,1737,53,ITF,ITF5,17,Basilicata
2021-02-20,UMB,282,100,182,258,24,ITI,ITI2,10,Umbria
2021-05-24,PIE,28969,13419,15550,17019,11950,ITC,ITC1,1,Piemonte
2021-06-19,SAR,15349,7511,7838,9210,6139,ITG,ITG2,20,Sardegna
2021-02-02,LIG,2669,1005,1664,134,2535,ITC,ITC3,7,Liguria
2021-05-18,ABR,12115,5662,6453,7732,4383,ITF,ITF1,13,Abruzzo
2021-03-22,PAB,1144,523,621,1139,5,ITH,ITH1,4,Provincia Autonoma Bolzano / Bozen
2021-04-15,VDA,810,377,433,671,139,ITC,ITC2,2,Valle d'Aosta / Vallée d'Aoste
2021-05-24,EMR,29887,13684,16203,18430,11457,ITH,ITH5,8,Emilia-Romagna
2021-06-05,LOM,102088,52782,49306,92339,9749,ITC,ITC4,3,Lombardia
2021-02-13,EMR,3628,1085,2543,3030,598,ITH,ITH5,8,Emilia-Romagna
2021-02-24,ABR,3305,1441,1864,3129,176,ITF,ITF1,13,Abruzzo
2021-03-19,MAR,3835,1597,2238,339,3496,ITI,ITI3,11,Marche
2021-03-26,VEN,29573,13138,16435,24108,5465,ITH,ITH3,5,Veneto
2021-04-30,CAL,14941,7330,7611,10605,4336,ITF,ITF6,18,Calabria
2021-03-09,UMB,4092,2003,2089,2801,1291,ITI,ITI2,10,Umbria
2021-03-10,MOL,1737,720,1017,1687,50,ITF,ITF2,14,Molise
2021-03-28,SAR,4644,1838,2806,4565,79,ITG,ITG2,20,Sardegna
2021-03-04,FVG,3450,1596,1854,2791,659,ITH,ITH4,6,Friuli-Venezia Giulia
2021-03-02,PIE,11202,4506,6696,10386,816,ITC,ITC1,1,Piemonte
2021-03-14,LOM,14872,5348,9524,11589,3283,ITC,ITC4,3,Lombardia
2021-01-04,SAR,592,217,375,592,0,ITG,ITG2,20,Sardegna
2021-06-01,MOL,2597,1322,1275,2489,108,ITF,ITF2,14,Molise
2021-04-28,LIG,14443,6519,7924,6459,7984,ITC,ITC3,7,Liguria
2021-03-10,PUG,14802,6608,8194,11681,3121,ITF,ITF4,16,Puglia
2021-06-12,FVG,8050,4617,3433,6911,1139,ITH,ITH4,6,Friuli-Venezia Giulia
2021-02-04,LIG,2817,986,1831,179,2638,ITC,ITC3,7,Liguria
2021-04-02,TOS,31969,13559,18410,23944,8025,ITI,ITI1,9,Toscana
2021-05-24,PAT,4383,2012,2371,1360,3023,ITH,ITH2,4,Provincia Autonoma Trento
2021-03-17,MAR,3428,1494,1934,107,3321,ITI,ITI3,11,Marche
2021-03-28,VEN,31265,13593,17672,27650,3615,ITH,ITH3,5,Veneto
2021-05-15,LIG,7252,3234,4018,4298,2954,ITC,ITC3,7,Liguria
2021-05-31,SIC,37849,17020,20829,21567,16282,ITG,ITG1,19,Sicilia
2021-06-19,VEN,48241,24553,23688,25909,22332,ITH,ITH3,5,Veneto
2021-01-13,LAZ,5694,2151,3543,5694,0,ITI,ITI4,12,Lazio
2021-02-21,LIG,869,491,378,865,4,ITC,ITC3,7,Liguria
2021-02-23,LOM,11812,4801,7011,11481,331,ITC,ITC4,3,Lombardia
2021-03-02,PAT,1304,440,864,928,376,ITH,ITH2,4,Provincia Autonoma Trento
2021-03-21,FVG,2672,1000,1672,2263,409,ITH,ITH4,6,Friuli-Venezia Giulia
2021-01-18,CAL,1281,579,702,1050,231,ITF,ITF6,18,Calabria
2021-04-23,LAZ,37680,18091,19589,22411,15269,ITI,ITI4,12,Lazio
2021-06-10,PAT,6108,2976,3132,1915,4193,ITH,ITH2,4,Provincia Autonoma Trento
2021-03-29,PUG,13430,6497,6933,6690,6740,ITF,ITF4,16,Puglia
2021-06-12,PIE,42362,22326,20036,39746,2616,ITC,ITC1,1,Piemonte
2021-03-05,PAB,1839,625,1214,1397,442,ITH,ITH1,4,Provincia Autonoma Bolzano / Bozen
2021-05-17,CAM,49298,21657,27641,24102,25196,ITF,ITF3,15,Campania
2021-01-09,TOS,4485,1596,2889,4485,0,ITI,ITI1,9,Toscana
2021-02-06,CAM,5340,2665,2675,2102,3238,ITF,ITF3,15,Campania
2021-04-13,VDA,373,171,202,329,44,ITC,ITC2,2,Valle d'Aosta / Vallée d'Aoste
2021-02-28,MAR,2836,1251,1585,2830,6,ITI,ITI3,11,Marche
2021-04-11,CAL,4174,1898,2276,2233,1941,ITF,ITF6,18,Calabria
2021-04-14,VEN,15903,6892,9011,9276,6627,ITH,ITH3,5,Veneto
2021-05-27,PAB,6085,3200,2885,4075,2010,ITH,ITH1,4,Provincia Autonoma Bolzano / Bozen
2021-05-31,UMB,5803,2837,2966,4920,883,ITI,ITI2,10,Umbria
2021-03-12,PUG,14273,6432,7841,10345,3928,ITF,ITF4,16,Puglia
2021-04-16,SAR,14441,6488,7953,9098,5343,ITG,ITG2,20,Sardegna
2021-01-04,VEN,6735,2033,4702,6735,0,ITH,ITH3,5,Veneto
2021-03-27,VDA,333,164,169,302,31,ITC,ITC2,2,Valle d'Aosta / Vallée d'Aoste
2021-06-08,MAR,13914,7013,6901,11303,2611,ITI,ITI3,11,Marche
2021-05-14,UMB,5323,2502,2821,3508,1815,ITI,ITI2,10,Umbria
2021-06-13,PAB,3617,2017,1600,427,3190,ITH,ITH1,4,Provincia Autonoma Bolzano / Bozen
2021-06-20,PUG,13555,6863,6692,8813,4742,ITF,ITF4,16,Puglia
2021-05-25,PAB,3835,1988,1847,2950,885,ITH,ITH1,4,Provincia Autonoma Bolzano / Bozen
2021-01-23,SAR,60,22,38,0,60,ITG,ITG2,20,Sardegna
2021-05-13,MOL,3038,1410,1628,2581,457,ITF,ITF2,14,Molise
2021-02-07,MOL,66,32,34,19,47,ITF,ITF2,14,Molise
2021-05-18,MOL,1645,877,768,990,655,ITF,ITF2,14,Molise
2021-05-19,PIE,33094,15271,17823,22009,11085,ITC,ITC1,1,Piemonte
2021-02-13,SIC,2976,1122,1854,2721,255,ITG,ITG1,19,Sicilia
2021-05-24,LOM,89390,43420,45970,49490,39900,ITC,ITC4,3,Lombardia
2021-03-22,MOL,1148,440,708,905,243,ITF,ITF2,14,Molise
2021-02-18,EMR,7039,2892,4147,6456,583,ITH,ITH5,8,Emilia-Romagna
2021-05-04,BAS,4137,1991,2146,3614,523,ITF,ITF5,17,Basilicata
2021-03-14,PIE,8205,3336,4869,5308,2897,ITC,ITC1,1,Piemonte
2021-04-09,SAR,12302,5469,6833,7950,4352,ITG,ITG2,20,Sardegna
2021-03-08,BAS,1458,711,747,845,613,ITF,ITF5,17,Basilicata
2021-05-10,PIE,28911,13947,14964,15812,13099,ITC,ITC1,1,Piemonte
2021-06-06,PAB,4529,2175,2354,854,3675,ITH,ITH1,4,Provincia Autonoma Bolzano / Bozen
2021-05-24,SIC,35643,17261,18382,15702,19941,ITG,ITG1,19,Sicilia
2021-01-30,PIE,5980,2136,3844,218,5762,ITC,ITC1,1,Piemonte
2021-02-26,PAB,1526,551,975,1496,30,ITH,ITH1,4,Provincia Autonoma Bolzano / Bozen
2021-03-05,PUG,17682,7166,10516,15378,2304,ITF,ITF4,16,Puglia
2021-02-11,LOM,17053,5006,12047,9698,7355,ITC,ITC4,3,Lombardia
2021-04-07,TOS,35815,15455,20360,28567,7248,ITI,ITI1,9,Toscana
2021-01-06,CAL,930,502,428,930,0,ITF,ITF6,18,Calabria
2021-02-26,PUG,13762,5054,8708,12728,1034,ITF,ITF4,16,Puglia
2020-12-31,PUG,1634,782,852,1634,0,ITF,ITF4,16,Puglia
2021-02-16,LIG,2426,956,1470,2004,422,ITC,ITC3,7,Liguria
2021-03-16,FVG,3154,1288,1866,1073,2081,ITH,ITH4,6,Friuli-Venezia Giulia
2021-06-16,BAS,4564,2074,2490,2127,2437,ITF,ITF5,17,Basilicata
2021-05-12,FVG,10846,5022,5824,9445,1401,ITH,ITH4,6,Friuli-Venezia Giulia
2021-05-27,LIG,16833,8622,8211,12714,4119,ITC,ITC3,7,Liguria
2021-02-25,VEN,7898,3339,4559,7293,605,ITH,ITH3,5,Veneto
2021-03-09,PAT,1582,590,992,938,644,ITH,ITH2,4,Provincia Autonoma Trento
2021-03-23,UMB,3797,1685,2112,2168,1629,ITI,ITI2,10,Umbria
2021-05-04,ABR,10748,5049,5699,7132,3616,ITF,ITF1,13,Abruzzo
2021-05-17,LAZ,44178,20219,23959,35648,8530,ITI,ITI4,12,Lazio
2021-05-27,MAR,13730,6816,6914,9429,4301,ITI,ITI3,11,Marche
2021-06-07,EMR,40317,20695,19622,34107,6210,ITH,ITH5,8,Emilia-Romagna
2021-06-17,PAT,6560,3444,3116,2104,4456,ITH,ITH2,4,Provincia Autonoma Trento
2021-02-11,CAM,6279,2704,3575,6213,66,ITF,ITF3,15,Campania
2021-03-08,ABR,5147,1693,3454,4177,970,ITF,ITF1,13,Abruzzo
2021-03-31,MAR,7373,3085,4288,4349,3024,ITI,ITI3,11,Marche
2021-04-14,LIG,13068,5666,7402,10865,2203,ITC,ITC3,7,Liguria
2021-02-03,VDA,351,114,237,14,337,ITC,ITC2,2,Valle d'Aosta / Vallée d'Aoste
2021-04-09,VEN,31179,13753,17426,22839,8340,ITH,ITH3,5,Veneto
2021-04-16,CAL,10206,4974,5232,8624,1582,ITF,ITF6,18,Calabria
2021-06-01,PAB,3556,2315,1241,2085,1471,ITH,ITH1,4,Provincia Autonoma Bolzano / Bozen
2021-02-08,UMB,637,203,434,88,549,ITI,ITI2,10,Umbria
2021-04-11,SAR,5394,2443,2951,4274,1120,ITG,ITG2,20,Sardegna
2021-02-18,CAL,1830,831,999,1604,226,ITF,ITF6,18,Calabria
2021-04-01,VDA,776,394,382,764,12,ITC,ITC2,2,Valle d'Aosta / Vallée d'Aoste
2021-06-05,VEN,46644,24027,22617,38637,8007,ITH,ITH3,5,Veneto
2021-01-24,ABR,50,22,28,6,44,ITF,ITF1,13,Abruzzo
2021-02-06,LAZ,6137,2475,3662,817,5320,ITI,ITI4,12,Lazio
2021-03-16,PIE,10523,4269,6254,4463,6060,ITC,ITC1,1,Piemonte
2021-05-19,UMB,9419,4211,5208,5672,3747,ITI,ITI2,10,Umbria
2021-06-07,SAR,12553,6139,6414,9554,2999,ITG,ITG2,20,Sardegna
2021-06-15,PUG,41786,20442,21344,22372,19414,ITF,ITF4,16,Puglia
2021-06-08,PUG,38832,18872,19960,21167,17665,ITF,ITF4,16,Puglia
2021-05-12,PIE,31889,15195,16694,18995,12894,ITC,ITC1,1,Piemonte
2021-02-19,PAB,2252,512,1740,2241,11,ITH,ITH1,4,Provincia Autonoma Bolzano / Bozen
2021-05-29,LIG,6844,3237,3607,3974,2870,ITC,ITC3,7,Liguria
2021-05-31,LOM,95594,47379,48215,79430,16164,ITC,ITC4,3,Lombardia
2021-02-04,SAR,2271,816,1455,916,1355,ITG,ITG2,20,Sardegna
2021-03-01,ABR,3478,1385,2093,2727,751,ITF,ITF1,13,Abruzzo
2021-04-02,SAR,8991,3548,5443,5750,3241,ITG,ITG2,20,Sardegna
2021-02-06,UMB,396,138,258,34,362,ITI,ITI2,10,Umbria
2021-03-14,PAT,108,65,43,21,87,ITH,ITH2,4,Provincia Autonoma Trento
2021-05-17,SIC,31900,15377,16523,19227,12673,ITG,ITG1,19,Sicilia
2021-06-12,TOS,29376,15144,14232,24990,4386,ITI,ITI1,9,Toscana
2021-03-21,SIC,15218,7341,7877,11248,3970,ITG,ITG1,19,Sicilia
2021-04-16,TOS,28954,12888,16066,22047,6907,ITI,ITI1,9,Toscana
2021-06-18,ABR,10155,4991,5164,6704,3451,ITF,ITF1,13,Abruzzo
2021-03-26,LOM,41274,15688,25586,28143,13131,ITC,ITC4,3,Lombardia
2021-01-04,CAL,1065,527,538,1065,0,ITF,ITF6,18,Calabria
2021-02-06,SIC,4688,2089,2599,1464,3224,ITG,ITG1,19,Sicilia
2021-05-22,LOM,70551,33823,36728,32419,38132,ITC,ITC4,3,Lombardia
2021-02-11,LAZ,7001,3013,3988,6467,534,ITI,ITI4,12,Lazio
2021-05-20,MOL,2660,1370,1290,2474,186,ITF,ITF2,14,Molise
2021-02-09,LIG,1936,689,1247,256,1680,ITC,ITC3,7,Liguria
2021-04-11,LAZ,19154,8469,10685,13273,5881,ITI,ITI4,12,Lazio
2021-04-16,CAM,34316,16559,17757,23651,10665,ITF,ITF3,15,Campania
2021-05-19,FVG,11954,5879,6075,9615,2339,ITH,ITH4,6,Friuli-Venezia Giulia
2021-06-09,BAS,4423,2072,2351,3999,424,ITF,ITF5,17,Basilicata
2021-06-13,PUG,21325,10666,10659,16170,5155,ITF,ITF4,16,Puglia
2021-04-23,CAL,12984,6368,6616,9448,3536,ITF,ITF6,18,Calabria
2021-01-06,CAM,7652,3749,3903,7652,0,ITF,ITF3,15,Campania
2021-02-13,LAZ,6609,2626,3983,6194,415,ITI,ITI4,12,Lazio
2021-04-13,BAS,2113,1051,1062,1295,818,ITF,ITF5,17,Basilicata
2021-05-29,LOM,88255,42391,45864,42236,46019,ITC,ITC4,3,Lombardia
2021-02-18,LOM,14048,4924,9124,13012,1036,ITC,ITC4,3,Lombardia
2021-03-07,PAT,22,6,16,22,0,ITH,ITH2,4,Provincia Autonoma Trento
2021-03-01,BAS,548,284,264,382,166,ITF,ITF5,17,Basilicata
2021-03-29,MAR,5860,2567,3293,3435,2425,ITI,ITI3,11,Marche
2021-01-09,PAT,190,40,150,190,0,ITH,ITH2,4,Provincia Autonoma Trento
2021-01-13,CAL,2040,1027,1013,2040,0,ITF,ITF6,18,Calabria
2021-02-24,VDA,183,82,101,164,19,ITC,ITC2,2,Valle d'Aosta / Vallée d'Aoste
2021-05-31,EMR,29693,13721,15972,18246,11447,ITH,ITH5,8,Emilia-Romagna
2021-03-14,FVG,1397,549,848,1145,252,ITH,ITH4,6,Friuli-Venezia Giulia
2021-02-04,SIC,6728,3053,3675,1453,5275,ITG,ITG1,19,Sicilia
2021-02-20,EMR,5318,2094,3224,5055,263,ITH,ITH5,8,Emilia-Romagna
2021-04-16,LAZ,34424,15689,18735,22339,12085,ITI,ITI4,12,Lazio
2021-04-18,CAL,5841,2791,3050,4929,912,ITF,ITF6,18,Calabria
2021-04-08,BAS,764,348,416,754,10,ITF,ITF5,17,Basilicata
2021-01-27,VDA,151,71,80,79,72,ITC,ITC2,2,Valle d'Aosta / Vallée d'Aoste
2021-02-06,PAT,574,298,276,433,141,ITH,ITH2,4,Provincia Autonoma Trento
2021-03-26,TOS,20667,9383,11284,14900,5767,ITI,ITI1,9,Toscana
2021-04-20,VDA,933,430,503,739,194,ITC,ITC2,2,Valle d'Aosta / Vallée d'Aoste
2021-04-22,BAS,5036,2346,2690,3433,1603,ITF,ITF5,17,Basilicata
2021-01-23,LAZ,7213,2869,4344,584,6629,ITI,ITI4,12,Lazio
2021-03-30,EMR,23353,10342,13011,18313,5040,ITH,ITH5,8,Emilia-Romagna
2021-01-06,LAZ,5123,1961,3162,5123,0,ITI,ITI4,12,Lazio
2021-01-10,VDA,220,71,149,220,0,ITC,ITC2,2,Valle d'Aosta / Vallée d'Aoste
2021-02-23,PAT,1110,395,715,897,213,ITH,ITH2,4,Provincia Autonoma Trento
2021-03-09,TOS,11128,4566,6562,5576,5552,ITI,ITI1,9,Toscana
2021-03-24,MAR,7032,2983,4049,3364,3668,ITI,ITI3,11,Marche
2021-03-28,FVG,4936,2353,2583,4778,158,ITH,ITH4,6,Friuli-Venezia Giulia
2021-04-05,PUG,12717,6177,6540,12184,533,ITF,ITF4,16,Puglia
2020-12-27,VDA,20,9,11,20,0,ITC,ITC2,2,Valle d'Aosta / Vallée d'Aoste
2021-03-19,PUG,7961,3653,4308,3415,4546,ITF,ITF4,16,Puglia
2021-01-07,MOL,598,209,389,598,0,ITF,ITF2,14,Molise
2021-01-11,VEN,7240,2102,5138,7240,0,ITH,ITH3,5,Veneto
2021-06-01,MAR,12063,6158,5905,9968,2095,ITI,ITI3,11,Marche
2021-02-28,LIG,1058,580,478,1049,9,ITC,ITC3,7,Liguria
2021-05-07,UMB,10126,4706,5420,6914,3212,ITI,ITI2,10,Umbria
2021-06-20,PAB,4169,2274,1895,278,3891,ITH,ITH1,4,Provincia Autonoma Bolzano / Bozen
2021-01-18,FVG,1961,606,1355,1867,94,ITH,ITH4,6,Friuli-Venezia Giulia
2021-03-03,ABR,4623,1881,2742,3717,906,ITF,ITF1,13,Abruzzo
2021-03-10,MAR,5666,2400,3266,4529,1137,ITI,ITI3,11,Marche
2021-05-24,CAM,31308,15107,16201,16199,15109,ITF,ITF3,15,Campania
2021-01-04,FVG,1507,558,949,1507,0,ITH,ITH4,6,Friuli-Venezia Giulia
2021-04-09,TOS,24594,10579,14015,21184,3410,ITI,ITI1,9,Toscana
2021-05-17,PAT,4293,2122,2171,3942,351,ITH,ITH2,4,Provincia Autonoma Trento
2021-02-13,CAM,5508,2550,2958,5291,217,ITF,ITF3,15,Campania
2021-02-21,MAR,376,141,235,375,1,ITI,ITI3,11,Marche
2021-04-04,CAL,1760,885,875,1261,499,ITF,ITF6,18,Calabria
2021-04-21,VEN,32315,13175,19140,16255,16060,ITH,ITH3,5,Veneto
2021-02-07,PAB,2362,1058,1304,14,2348,ITH,ITH1,4,Provincia Autonoma Bolzano / Bozen
2021-02-12,MOL,332,150,182,208,124,ITF,ITF2,14,Molise
2021-02-25,SIC,9866,5155,4711,8703,1163,ITG,ITG1,19,Sicilia
2021-03-28,PIE,16062,6901,9161,8440,7622,ITC,ITC1,1,Piemonte
2021-04-23,SAR,12861,5741,7120,7386,5475,ITG,ITG2,20,Sardegna
2021-05-22,VEN,34732,16662,18070,13338,21394,ITH,ITH3,5,Veneto
2021-02-11,VEN,4012,1238,2774,3384,628,ITH,ITH3,5,Veneto
2021-04-08,ABR,7394,3336,4058,5065,2329,ITF,ITF1,13,Abruzzo
2021-06-05,SIC,59900,28491,31409,49329,10571,ITG,ITG1,19,Sicilia
2021-04-23,CAM,32308,15513,16795,23161,9147,ITF,ITF3,15,Campania
2021-05-10,SAR,9736,4339,5397,7199,2537,ITG,ITG2,20,Sardegna
2021-01-28,VEN,9209,2662,6547,173,9036,ITH,ITH3,5,Veneto
2021-04-22,ABR,6728,3249,3479,4999,1729,ITF,ITF1,13,Abruzzo
2021-01-30,SAR,3863,1392,2471,362,3501,ITG,ITG2,20,Sardegna
2021-03-14,SIC,8773,3927,4846,4937,3836,ITG,ITG1,19,Sicilia
2021-04-11,PIE,20824,9317,11507,18663,2161,ITC,ITC1,1,Piemonte
2021-05-18,PAB,3342,1753,1589,2156,1186,ITH,ITH1,4,Provincia Autonoma Bolzano / Bozen
2021-01-04,EMR,7315,2527,4788,7315,0,ITH,ITH5,8,Emilia-Romagna
2021-01-04,PIE,5564,1679,3885,5564,0,ITC,ITC1,1,Piemonte
2021-04-23,LOM,73428,33285,40143,56900,16528,ITC,ITC4,3,Lombardia
2021-06-17,TOS,32335,16522,15813,26904,5431,ITI,ITI1,9,Toscana
2021-04-28,PIE,26046,11739,14307,16012,10034,ITC,ITC1,1,Piemonte
2021-01-18,PIE,6166,2048,4118,5917,249,ITC,ITC1,1,Piemonte
2021-03-22,ABR,4343,1907,2436,2373,1970,ITF,ITF1,13,Abruzzo
2021-05-10,LOM,85224,40862,44362,63682,21542,ITC,ITC4,3,Lombardia
2021-02-11,SIC,5235,2060,3175,4774,461,ITG,ITG1,19,Sicilia
2021-01-30,LOM,12307,4563,7744,154,12153,ITC,ITC4,3,Lombardia
2021-02-06,FVG,1154,338,816,22,1132,ITH,ITH4,6,Friuli-Venezia Giulia
2021-02-17,BAS,1135,493,642,1059,76,ITF,ITF5,17,Basilicata
2021-02-25,LAZ,12653,5518,7135,11603,1050,ITI,ITI4,12,Lazio
2021-04-14,PAT,3115,1464,1651,2379,736,ITH,ITH2,4,Provincia Autonoma Trento
2021-02-04,TOS,4253,1594,2659,961,3292,ITI,ITI1,9,Toscana
2021-02-23,FVG,2643,1277,1366,2463,180,ITH,ITH4,6,Friuli-Venezia Giulia
2021-03-28,PAT,751,294,457,749,2,ITH,ITH2,4,Provincia Autonoma Trento
2021-06-07,CAL,17005,7903,9102,13796,3209,ITF,ITF6,18,Calabria
2021-01-19,MAR,228,83,145,142,86,ITI,ITI3,11,Marche
2021-05-28,BAS,3612,1807,1805,949,2663,ITF,ITF5,17,Basilicata
2021-06-05,LAZ,65725,32386,33339,43171,22554,ITI,ITI4,12,Lazio
2021-02-14,PUG,786,347,439,662,124,ITF,ITF4,16,Puglia
2021-05-15,TOS,29342,13848,15494,23566,5776,ITI,ITI1,9,Toscana
2021-05-19,EMR,33671,14941,18730,18515,15156,ITH,ITH5,8,Emilia-Romagna
2021-02-02,MAR,1191,397,794,72,1119,ITI,ITI3,11,Marche
2021-06-09,VDA,1027,535,492,991,36,ITC,ITC2,2,Valle d'Aosta / Vallée d'Aoste
2021-06-11,BAS,4224,1975,2249,3195,1029,ITF,ITF5,17,Basilicata
2021-05-25,PUG,34483,16065,18418,21006,13477,ITF,ITF4,16,Puglia
2021-01-04,PAT,870,227,643,870,0,ITH,ITH2,4,Provincia Autonoma Trento
2021-03-01,VDA,181,66,115,147,34,ITC,ITC2,2,Valle d'Aosta / Vallée d'Aoste
2021-03-15,MOL,832,338,494,587,245,ITF,ITF2,14,Molise
2021-04-28,TOS,19121,8182,10939,3831,15290,ITI,ITI1,9,Toscana
2021-05-13,MAR,12603,5695,6908,7103,5500,ITI,ITI3,11,Marche
2021-05-17,FVG,8783,4077,4706,6300,2483,ITH,ITH4,6,Friuli-Venezia Giulia
2021-03-02,VEN,11484,4623,6861,8176,3308,ITH,ITH3,5,Veneto
2021-03-09,FVG,4009,1722,2287,1262,2747,ITH,ITH4,6,Friuli-Venezia Giulia
2021-04-12,MAR,8567,3772,4795,8083,484,ITI,ITI3,11,Marche
2021-05-24,CAL,17674,8806,8868,10012,7662,ITF,ITF6,18,Calabria
2021-01-09,LIG,1335,481,854,1335,0,ITC,ITC3,7,Liguria
2021-02-15,VDA,264,136,128,229,35,ITC,ITC2,2,Valle d'Aosta / Vallée d'Aoste
2021-03-18,UMB,2943,1164,1779,1705,1238,ITI,ITI2,10,Umbria
2021-06-02,EMR,23925,11913,12012,19110,4815,ITH,ITH5,8,Emilia-Romagna
2021-04-19,LIG,12807,5613,7194,8999,3808,ITC,ITC3,7,Liguria
2021-05-01,PAB,2104,1067,1037,1944,160,ITH,ITH1,4,Provincia Autonoma Bolzano / Bozen
2021-03-08,VDA,482,231,251,237,245,ITC,ITC2,2,Valle d'Aosta / Vallée d'Aoste
2021-04-23,UMB,6614,2788,3826,3493,3121,ITI,ITI2,10,Umbria
2021-05-12,EMR,38858,18273,20585,29220,9638,ITH,ITH5,8,Emilia-Romagna
2021-02-25,UMB,1336,497,839,1284,52,ITI,ITI2,10,Umbria
2021-05-04,VDA,1135,510,625,462,673,ITC,ITC2,2,Valle d'Aosta / Vallée d'Aoste
2021-02-01,EMR,10321,3611,6710,362,9959,ITH,ITH5,8,Emilia-Romagna
2021-06-15,MAR,12904,6414,6490,9852,3052,ITI,ITI3,11,Marche
2021-03-11,UMB,3595,1726,1869,2589,1006,ITI,ITI2,10,Umbria
2021-01-28,TOS,6282,1882,4400,354,5928,ITI,ITI1,9,Toscana
2021-05-01,MOL,2647,1268,1379,424,2223,ITF,ITF2,14,Molise
2021-01-13,UMB,450,139,311,450,0,ITI,ITI2,10,Umbria
2021-06-16,VDA,683,365,318,642,41,ITC,ITC2,2,Valle d'Aosta / Vallée d'Aoste
2021-06-19,UMB,4550,2194,2356,2530,2020,ITI,ITI2,10,Umbria
2021-03-05,MOL,1219,649,570,1015,204,ITF,ITF2,14,Molise
2021-05-31,PAT,4717,2172,2545,1676,3041,ITH,ITH2,4,Provincia Autonoma Trento
2021-01-30,CAM,10722,5080,5642,38,10684,ITF,ITF3,15,Campania
2021-03-25,BAS,1884,604,1280,1539,345,ITF,ITF5,17,Basilicata
2021-02-06,CAL,2912,1342,1570,445,2467,ITF,ITF6,18,Calabria
2021-06-13,MOL,2451,1329,1122,2126,325,ITF,ITF2,14,Molise
2021-01-27,BAS,411,175,236,113,298,ITF,ITF5,17,Basilicata
2021-04-17,MOL,3054,1501,1553,1568,1486,ITF,ITF2,14,Molise
2021-02-10,BAS,548,238,310,496,52,ITF,ITF5,17,Basilicata
2021-03-14,LIG,1659,752,907,1055,604,ITC,ITC3,7,Liguria
2021-04-11,FVG,3433,1520,1913,2527,906,ITH,ITH4,6,Friuli-Venezia Giulia
2021-01-12,MAR,1227,413,814,1227,0,ITI,ITI3,11,Marche
2021-05-21,BAS,4574,2320,2254,1491,3083,ITF,ITF5,17,Basilicata
2021-06-07,FVG,9016,4675,4341,8097,919,ITH,ITH4,6,Friuli-Venezia Giulia
2021-01-16,SAR,1492,525,967,1492,0,ITG,ITG2,20,Sardegna
2021-01-16,CAM,3369,1675,1694,3369,0,ITF,ITF3,15,Campania
2021-05-10,LIG,12648,5639,7009,6273,6375,ITC,ITC3,7,Liguria
2021-06-19,SIC,43486,20659,22827,18577,24909,ITG,ITG1,19,Sicilia
2021-05-05,VEN,44304,21231,23073,37731,6573,ITH,ITH3,5,Veneto
2021-04-23,SIC,28594,13701,14893,22780,5814,ITG,ITG1,19,Sicilia
2021-01-23,CAL,401,186,215,359,42,ITF,ITF6,18,Calabria
2021-06-07,PIE,34805,17827,16978,30039,4766,ITC,ITC1,1,Piemonte
2021-01-16,LOM,15425,5731,9694,15425,0,ITC,ITC4,3,Lombardia
2021-04-30,LAZ,41309,18293,23016,27117,14192,ITI,ITI4,12,Lazio
2021-02-10,ABR,947,312,635,503,444,ITF,ITF1,13,Abruzzo
2021-01-18,EMR,3128,879,2249,2449,679,ITH,ITH5,8,Emilia-Romagna
2021-03-15,VDA,362,123,239,159,203,ITC,ITC2,2,Valle d'Aosta / Vallée d'Aoste
2021-03-16,EMR,12245,5027,7218,4937,7308,ITH,ITH5,8,Emilia-Romagna
2021-05-11,VDA,647,325,322,496,151,ITC,ITC2,2,Valle d'Aosta / Vallée d'Aoste
2021-01-25,EMR,6462,2146,4316,207,6255,ITH,ITH5,8,Emilia-Romagna
2021-01-06,UMB,846,325,521,846,0,ITI,ITI2,10,Umbria
2021-04-27,VDA,978,423,555,686,292,ITC,ITC2,2,Valle d'Aosta / Vallée d'Aoste
2021-06-12,UMB,7695,3680,4015,6125,1570,ITI,ITI2,10,Umbria
2021-03-23,EMR,18795,8144,10651,12108,6687,ITH,ITH5,8,Emilia-Romagna
2021-04-26,MAR,8980,3983,4997,5958,3022,ITI,ITI3,11,Marche
2021-01-17,VDA,131,56,75,131,0,ITC,ITC2,2,Valle d'Aosta / Vallée d'Aoste
2021-04-16,UMB,8115,3749,4366,6277,1838,ITI,ITI2,10,Umbria
2021-04-30,UMB,6255,2973,3282,2866,3389,ITI,ITI2,10,Umbria
2021-06-19,LAZ,59383,27754,31629,29579,29804,ITI,ITI4,12,Lazio
2021-03-19,TOS,10143,4460,5683,7275,2868,ITI,ITI1,9,Toscana
2021-06-20,MOL,366,142,224,31,335,ITF,ITF2,14,Molise
2021-03-04,UMB,4487,1855,2632,3659,828,ITI,ITI2,10,Umbria
2021-04-24,MOL,2551,1202,1349,710,1841,ITF,ITF2,14,Molise
2021-01-24,PAB,12,10,2,0,12,ITH,ITH1,4,Provincia Autonoma Bolzano / Bozen
2021-01-31,PUG,1814,830,984,75,1739,ITF,ITF4,16,Puglia
2021-02-26,MOL,563,260,303,490,73,ITF,ITF2,14,Molise
2021-03-28,CAL,2564,1186,1378,1510,1054,ITF,ITF6,18,Calabria
2021-01-20,UMB,613,222,391,613,0,ITI,ITI2,10,Umbria
2021-04-30,SIC,34915,16303,18612,23936,10979,ITG,ITG1,19,Sicilia
2021-06-06,MOL,2059,1059,1000,1736,323,ITF,ITF2,14,Molise
2021-04-01,BAS,2710,1107,1603,1990,720,ITF,ITF5,17,Basilicata
2021-05-03,LIG,13270,5918,7352,6458,6812,ITC,ITC3,7,Liguria
2021-05-31,FVG,8869,4412,4457,6708,2161,ITH,ITH4,6,Friuli-Venezia Giulia
2021-02-03,BAS,669,301,368,32,637,ITF,ITF5,17,Basilicata
2021-05-12,VEN,36671,17749,18922,31554,5117,ITH,ITH3,5,Veneto
2021-03-21,LIG,550,220,330,69,481,ITC,ITC3,7,Liguria
2020-12-28,PIE,1,1,0,1,0,ITC,ITC1,1,Piemonte
2021-01-23,LIG,809,295,514,153,656,ITC,ITC3,7,Liguria
2021-01-09,LOM,12413,4573,7840,12413,0,ITC,ITC4,3,Lombardia
2021-01-30,CAL,2180,1149,1031,355,1825,ITF,ITF6,18,Calabria
2021-01-23,CAM,3839,2029,1810,273,3566,ITF,ITF3,15,Campania
2021-03-04,SIC,15071,6569,8502,10953,4118,ITG,ITG1,19,Sicilia
2021-03-07,LOM,12081,5356,6725,9525,2556,ITC,ITC4,3,Lombardia
2021-03-16,VEN,12521,5351,7170,6905,5616,ITH,ITH3,5,Veneto
2021-03-21,CAM,10070,4674,5396,7680,2390,ITF,ITF3,15,Campania
2021-05-17,LIG,12027,5520,6507,8703,3324,ITC,ITC3,7,Liguria
2021-06-12,SIC,44297,21673,22624,38521,5776,ITG,ITG1,19,Sicilia
2021-01-21,TOS,1589,686,903,867,722,ITI,ITI1,9,Toscana
2021-05-07,LAZ,48190,22591,25599,30451,17739,ITI,ITI4,12,Lazio
2021-03-11,LAZ,25149,11784,13365,18919,6230,ITI,ITI4,12,Lazio
2021-03-09,EMR,14754,6019,8735,10799,3955,ITH,ITH5,8,Emilia-Romagna
2021-05-05,EMR,30085,13981,16104,18836,11249,ITH,ITH5,8,Emilia-Romagna
2021-02-03,ABR,2062,717,1345,419,1643,ITF,ITF1,13,Abruzzo
2021-01-27,LOM,8033,2672,5361,808,7225,ITC,ITC4,3,Lombardia
2021-02-17,CAL,1845,808,1037,1634,211,ITF,ITF6,18,Calabria
2021-05-29,PUG,30230,14254,15976,20921,9309,ITF,ITF4,16,Puglia
2021-02-10,CAM,6904,3413,3491,6728,176,ITF,ITF3,15,Campania
2021-03-19,MOL,1184,482,702,757,427,ITF,ITF2,14,Molise
2021-05-02,PIE,25066,11266,13800,14321,10745,ITC,ITC1,1,Piemonte
2021-03-25,LOM,42780,16007,26773,30111,12669,ITC,ITC4,3,Lombardia
2021-04-02,PUG,12838,5997,6841,8314,4524,ITF,ITF4,16,Puglia
2021-05-28,CAL,20967,10192,10775,11519,9448,ITF,ITF6,18,Calabria
2021-01-21,MOL,6,2,4,6,0,ITF,ITF2,14,Molise
2021-04-08,CAM,28375,13735,14640,22534,5841,ITF,ITF3,15,Campania
2021-02-12,PAB,730,217,513,482,248,ITH,ITH1,4,Provincia Autonoma Bolzano / Bozen
2021-03-23,PIE,13077,5451,7626,6832,6245,ITC,ITC1,1,Piemonte
2021-04-19,PUG,27621,12830,14791,24577,3044,ITF,ITF4,16,Puglia
2021-04-10,PAB,5391,2664,2727,4803,588,ITH,ITH1,4,Provincia Autonoma Bolzano / Bozen
2021-06-07,CAM,55688,26765,28923,51690,3998,ITF,ITF3,15,Campania
2021-04-06,UMB,5293,2170,3123,2904,2389,ITI,ITI2,10,Umbria
2021-05-20,MAR,12364,5812,6552,7667,4697,ITI,ITI3,11,Marche
2021-01-10,ABR,1139,409,730,1139,0,ITF,ITF1,13,Abruzzo
2021-05-30,VDA,865,429,436,694,171,ITC,ITC2,2,Valle d'Aosta / Vallée d'Aoste
2021-06-14,CAL,13990,6337,7653,9356,4634,ITF,ITF6,18,Calabria
2021-01-16,PIE,7771,2630,5141,7771,0,ITC,ITC1,1,Piemonte
2021-02-11,SAR,1315,490,825,1204,111,ITG,ITG2,20,Sardegna
2021-01-23,PAT,577,334,243,388,189,ITH,ITH2,4,Provincia Autonoma Trento
2021-01-30,SIC,7632,3500,4132,168,7464,ITG,ITG1,19,Sicilia
2021-03-28,UMB,1096,442,654,1072,24,ITI,ITI2,10,Umbria
2021-04-28,FVG,7275,3211,4064,3796,3479,ITH,ITH4,6,Friuli-Venezia Giulia
2021-04-29,ABR,12672,5851,6821,9576,3096,ITF,ITF1,13,Abruzzo
2021-06-05,LIG,8089,4115,3974,4937,3152,ITC,ITC3,7,Liguria
2021-01-30,UMB,1590,490,1100,44,1546,ITI,ITI2,10,Umbria
2021-04-09,LIG,12422,5554,6868,10683,1739,ITC,ITC3,7,Liguria
2021-05-03,PAT,4257,2195,2062,4103,154,ITH,ITH2,4,Provincia Autonoma Trento
2021-06-05,TOS,28409,13589,14820,20800,7609,ITI,ITI1,9,Toscana
2020-12-31,PAB,913,519,394,913,0,ITH,ITH1,4,Provincia Autonoma Bolzano / Bozen
2021-02-04,LOM,27769,8092,19677,2008,25761,ITC,ITC4,3,Lombardia
2021-03-28,SIC,10954,5138,5816,6943,4011,ITG,ITG1,19,Sicilia
2021-03-04,CAL,5483,3191,2292,4686,797,ITF,ITF6,18,Calabria
2021-02-20,LAZ,9208,4276,4932,8439,769,ITI,ITI4,12,Lazio
2021-02-25,CAM,12425,4478,7947,11237,1188,ITF,ITF3,15,Campania
2021-03-31,LIG,11919,5271,6648,9149,2770,ITC,ITC3,7,Liguria
2021-04-24,PUG,29316,13350,15966,25371,3945,ITF,ITF4,16,Puglia
2021-04-09,LOM,52304,22341,29963,36314,15990,ITC,ITC4,3,Lombardia
2021-06-12,CAL,12881,6134,6747,10486,2395,ITF,ITF6,18,Calabria
2021-05-31,LAZ,51264,22717,28547,31775,19489,ITI,ITI4,12,Lazio
2021-01-10,BAS,77,24,53,77,0,ITF,ITF5,17,Basilicata
2021-01-15,ABR,379,149,230,379,0,ITF,ITF1,13,Abruzzo
2021-02-07,MAR,1870,734,1136,344,1526,ITI,ITI3,11,Marche
2021-04-20,BAS,4033,1920,2113,2202,1831,ITF,ITF5,17,Basilicata
2021-01-11,TOS,5094,1691,3403,5094,0,ITI,ITI1,9,Toscana
2021-04-11,EMR,15277,6934,8343,12229,3048,ITH,ITH5,8,Emilia-Romagna
2021-04-19,PAB,1871,858,1013,1689,182,ITH,ITH1,4,Provincia Autonoma Bolzano / Bozen
2021-05-28,VDA,975,414,561,563,412,ITC,ITC2,2,Valle d'Aosta / Vallée d'Aoste
2021-05-24,SAR,13856,6721,7135,8479,5377,ITG,ITG2,20,Sardegna
2021-02-17,VDA,327,144,183,227,100,ITC,ITC2,2,Valle d'Aosta / Vallée d'Aoste
2021-04-21,TOS,29603,12665,16938,17518,12085,ITI,ITI1,9,Toscana
2021-04-23,VEN,31190,13815,17375,22488,8702,ITH,ITH3,5,Veneto
2021-06-15,PAB,1402,817,585,465,937,ITH,ITH1,4,Provincia Autonoma Bolzano / Bozen
2021-01-23,FVG,816,324,492,4,812,ITH,ITH4,6,Friuli-Venezia Giulia
2021-02-13,SAR,1456,565,891,1454,2,ITG,ITG2,20,Sardegna
2021-02-23,TOS,7721,3324,4397,7560,161,ITI,ITI1,9,Toscana
2021-04-04,LAZ,17534,8105,9429,12268,5266,ITI,ITI4,12,Lazio
2021-04-09,CAM,30033,14144,15889,23904,6129,ITF,ITF3,15,Campania
2021-04-05,MOL,391,189,202,292,99,ITF,ITF2,14,Molise
2021-05-05,PAT,4986,2578,2408,4694,292,ITH,ITH2,4,Provincia Autonoma Trento
2021-06-03,TOS,31971,15403,16568,27432,4539,ITI,ITI1,9,Toscana
2021-06-05,CAM,77014,37272,39742,70999,6015,ITF,ITF3,15,Campania
2021-01-08,BAS,554,219,335,554,0,ITF,ITF5,17,Basilicata
2021-03-29,MOL,2033,835,1198,1547,486,ITF,ITF2,14,Molise
2021-02-16,VEN,6643,2871,3772,6466,177,ITH,ITH3,5,Veneto
2021-04-04,LOM,7611,3230,4381,3716,3895,ITC,ITC4,3,Lombardia
2021-01-31,MOL,268,70,198,6,262,ITF,ITF2,14,Molise
2021-02-11,EMR,4255,1415,2840,3414,841,ITH,ITH5,8,Emilia-Romagna
2021-04-27,ABR,9083,4368,4715,6616,2467,ITF,ITF1,13,Abruzzo
2021-06-14,CAM,36672,17703,18969,18710,17962,ITF,ITF3,15,Campania
2021-03-15,BAS,2356,983,1373,524,1832,ITF,ITF5,17,Basilicata
2021-05-29,SAR,17988,8644,9344,13396,4592,ITG,ITG2,20,Sardegna
2021-01-16,PAT,319,148,171,319,0,ITH,ITH2,4,Provincia Autonoma Trento
2021-01-17,BAS,328,133,195,327,1,ITF,ITF5,17,Basilicata
2021-05-05,FVG,9749,4258,5491,6282,3467,ITH,ITH4,6,Friuli-Venezia Giulia
2021-02-18,SAR,1878,732,1146,1814,64,ITG,ITG2,20,Sardegna
2021-04-04,SIC,6810,3323,3487,5518,1292,ITG,ITG1,19,Sicilia
2021-01-23,PIE,4257,1325,2932,879,3378,ITC,ITC1,1,Piemonte
2021-04-17,PAB,5233,2599,2634,5189,44,ITH,ITH1,4,Provincia Autonoma Bolzano / Bozen
2021-01-07,PAB,918,327,591,918,0,ITH,ITH1,4,Provincia Autonoma Bolzano / Bozen
2021-01-14,PUG,4072,1590,2482,4072,0,ITF,ITF4,16,Puglia
2021-03-21,PIE,10727,4741,5986,4194,6533,ITC,ITC1,1,Piemonte
2021-01-07,PUG,5716,2458,3258,5716,0,ITF,ITF4,16,Puglia
2021-01-31,MAR,1918,769,1149,103,1815,ITI,ITI3,11,Marche
2021-04-02,LOM,41164,16841,24323,26716,14448,ITC,ITC4,3,Lombardia
2021-04-17,PUG,39903,18913,20990,36335,3568,ITF,ITF4,16,Puglia
2021-02-25,CAL,2883,1552,1331,2288,595,ITF,ITF6,18,Calabria
2021-05-29,VEN,32917,16633,16284,25308,7609,ITH,ITH3,5,Veneto
2020-12-28,LIG,80,30,50,80,0,ITC,ITC3,7,Liguria
2021-01-25,FVG,1583,567,1016,194,1389,ITH,ITH4,6,Friuli-Venezia Giulia
2021-02-19,PUG,4731,2010,2721,4339,392,ITF,ITF4,16,Puglia
2021-04-27,BAS,4727,2242,2485,4402,325,ITF,ITF5,17,Basilicata
2021-06-03,LIG,15462,7666,7796,9123,6339,ITC,ITC3,7,Liguria
2021-03-23,FVG,3886,1681,2205,1745,2141,ITH,ITH4,6,Friuli-Venezia Giulia
2021-04-07,LIG,13635,6072,7563,11345,2290,ITC,ITC3,7,Liguria
2021-03-15,ABR,3684,1448,2236,1876,1808,ITF,ITF1,13,Abruzzo
2021-04-07,MAR,7810,3435,4375,7475,335,ITI,ITI3,11,Marche
2021-02-10,VDA,248,77,171,141,107,ITC,ITC2,2,Valle d'Aosta / Vallée d'Aoste
2021-01-17,ABR,188,59,129,181,7,ITF,ITF1,13,Abruzzo
2021-02-09,MAR,124,42,82,46,78,ITI,ITI3,11,Marche
2021-02-23,LIG,3806,1559,2247,3697,109,ITC,ITC3,7,Liguria
2021-05-12,UMB,6492,3024,3468,4347,2145,ITI,ITI2,10,Umbria
2021-04-18,EMR,17511,8401,9110,12583,4928,ITH,ITH5,8,Emilia-Romagna
2021-04-28,PAT,4248,1974,2274,4110,138,ITH,ITH2,4,Provincia Autonoma Trento
2021-03-02,SIC,14665,6304,8361,11892,2773,ITG,ITG1,19,Sicilia
2021-05-30,ABR,8561,4067,4494,5348,3213,ITF,ITF1,13,Abruzzo
2021-03-09,SAR,5547,2742,2805,4818,729,ITG,ITG2,20,Sardegna
2021-01-04,SIC,8248,4118,4130,8248,0,ITG,ITG1,19,Sicilia
2021-04-03,ABR,5115,2233,2882,3518,1597,ITF,ITF1,13,Abruzzo
2021-01-28,LIG,2847,971,1876,39,2808,ITC,ITC3,7,Liguria
2021-02-11,PIE,6764,2107,4657,3006,3758,ITC,ITC1,1,Piemonte
2021-05-05,SAR,10155,4644,5511,8146,2009,ITG,ITG2,20,Sardegna
2021-01-18,SIC,1439,584,855,1289,150,ITG,ITG1,19,Sicilia
2021-01-23,VEN,4051,1246,2805,31,4020,ITH,ITH3,5,Veneto
2021-01-26,PAB,810,291,519,1,809,ITH,ITH1,4,Provincia Autonoma Bolzano / Bozen
2021-04-09,PIE,25850,11388,14462,21341,4509,ITC,ITC1,1,Piemonte
2021-03-21,VEN,11980,4752,7228,8518,3462,ITH,ITH3,5,Veneto
2021-04-28,SIC,29166,13679,15487,20130,9036,ITG,ITG1,19,Sicilia
2020-12-30,PIE,730,322,408,730,0,ITC,ITC1,1,Piemonte
2021-03-16,CAM,8087,3519,4568,3773,4314,ITF,ITF3,15,Campania
2021-03-24,PAB,2062,998,1064,2049,13,ITH,ITH1,4,Provincia Autonoma Bolzano / Bozen
2021-06-05,PIE,36849,18909,17940,32393,4456,ITC,ITC1,1,Piemonte
2021-04-28,LOM,95658,43639,52019,68777,26881,ITC,ITC4,3,Lombardia
2021-02-25,PIE,12218,5252,6966,11671,547,ITC,ITC1,1,Piemonte
2021-03-16,LAZ,13545,5739,7806,7101,6444,ITI,ITI4,12,Lazio
2021-03-16,LOM,25484,10113,15371,16417,9067,ITC,ITC4,3,Lombardia
2021-01-23,EMR,2448,871,1577,443,2005,ITH,ITH5,8,Emilia-Romagna
2021-05-12,LOM,87410,41700,45710,59891,27519,ITC,ITC4,3,Lombardia
2021-01-21,MAR,910,260,650,585,325,ITI,ITI3,11,Marche
2021-05-30,BAS,2773,1419,1354,922,1851,ITF,ITF5,17,Basilicata
2021-04-09,PAT,2738,1162,1576,1538,1200,ITH,ITH2,4,Provincia Autonoma Trento
2021-05-02,VDA,765,345,420,605,160,ITC,ITC2,2,Valle d'Aosta / Vallée d'Aoste
2021-05-07,EMR,35252,16956,18296,23403,11849,ITH,ITH5,8,Emilia-Romagna
2021-05-17,TOS,29676,14800,14876,20809,8867,ITI,ITI1,9,Toscana
2021-02-18,FVG,3218,1492,1726,2811,407,ITH,ITH4,6,Friuli-Venezia Giulia
2021-04-03,BAS,1806,748,1058,1471,335,ITF,ITF5,17,Basilicata
2021-05-01,MAR,9318,3924,5394,3576,5742,ITI,ITI3,11,Marche
2021-01-22,VDA,56,21,35,20,36,ITC,ITC2,2,Valle d'Aosta / Vallée d'Aoste
2021-02-11,PAT,1132,365,767,796,336,ITH,ITH2,4,Provincia Autonoma Trento
2021-03-21,TOS,3293,1627,1666,1860,1433,ITI,ITI1,9,Toscana
2021-02-09,PUG,3840,1570,2270,2168,1672,ITF,ITF4,16,Puglia
2021-03-09,LAZ,21939,9896,12043,16740,5199,ITI,ITI4,12,Lazio
2021-01-08,VDA,299,130,169,299,0,ITC,ITC2,2,Valle d'Aosta / Vallée d'Aoste
2021-01-23,TOS,3966,1360,2606,640,3326,ITI,ITI1,9,Toscana
2021-02-25,PAT,1641,643,998,1200,441,ITH,ITH2,4,Provincia Autonoma Trento
2021-01-11,LAZ,5541,2109,3432,5541,0,ITI,ITI4,12,Lazio
2021-04-02,FVG,6569,2915,3654,4735,1834,ITH,ITH4,6,Friuli-Venezia Giulia
2021-05-20,PUG,33419,15154,18265,21083,12336,ITF,ITF4,16,Puglia
2021-06-14,UMB,5362,2742,2620,3362,2000,ITI,ITI2,10,Umbria
2020-12-30,PAT,7,3,4,7,0,ITH,ITH2,4,Provincia Autonoma Trento
2021-03-06,VDA,22,4,18,22,0,ITC,ITC2,2,Valle d'Aosta / Vallée d'Aoste
2021-05-03,TOS,11933,5510,6423,10615,1318,ITI,ITI1,9,Toscana
2021-06-05,PAT,4079,1915,2164,751,3328,ITH,ITH2,4,Provincia Autonoma Trento
2021-01-25,CAM,5746,2927,2819,164,5582,ITF,ITF3,15,Campania
2021-03-24,PUG,13450,6399,7051,6144,7306,ITF,ITF4,16,Puglia
2021-01-12,MOL,336,114,222,336,0,ITF,ITF2,14,Molise
2021-01-16,VEN,4611,1542,3069,4611,0,ITH,ITH3,5,Veneto
2021-02-01,CAL,2509,1197,1312,244,2265,ITF,ITF6,18,Calabria
2021-03-10,PAB,1268,529,739,1125,143,ITH,ITH1,4,Provincia Autonoma Bolzano / Bozen
2021-01-26,PUG,5362,2397,2965,571,4791,ITF,ITF4,16,Puglia
2021-03-23,CAM,15738,7441,8297,13225,2513,ITF,ITF3,15,Campania
2021-03-14,VEN,15174,5940,9234,14280,894,ITH,ITH3,5,Veneto
2021-05-06,PAB,5181,2747,2434,2613,2568,ITH,ITH1,4,Provincia Autonoma Bolzano / Bozen
2021-05-12,CAL,16362,7970,8392,10888,5474,ITF,ITF6,18,Calabria
2021-02-05,BAS,986,443,543,64,922,ITF,ITF5,17,Basilicata
2021-03-05,MAR,6171,2856,3315,4703,1468,ITI,ITI3,11,Marche
2021-04-16,FVG,6917,2997,3920,4993,1924,ITH,ITH4,6,Friuli-Venezia Giulia
2021-05-06,PUG,39523,17284,22239,19851,19672,ITF,ITF4,16,Puglia
2021-05-19,CAM,51095,22557,28538,34532,16563,ITF,ITF3,15,Campania
2021-02-24,MOL,666,278,388,333,333,ITF,ITF2,14,Molise
2021-05-22,PAT,3254,1595,1659,924,2330,ITH,ITH2,4,Provincia Autonoma Trento
2021-05-26,CAL,18656,9268,9388,10393,8263,ITF,ITF6,18,Calabria
2021-01-06,FVG,710,264,446,710,0,ITH,ITH4,6,Friuli-Venezia Giulia
2021-01-07,MAR,1808,636,1172,1808,0,ITI,ITI3,11,Marche
2021-01-21,LIG,1105,385,720,674,431,ITC,ITC3,7,Liguria
2021-03-02,SAR,3060,1640,1420,1907,1153,ITG,ITG2,20,Sardegna
2021-05-16,BAS,4973,2469,2504,2860,2113,ITF,ITF5,17,Basilicata
2021-03-30,CAL,6171,2648,3523,3449,2722,ITF,ITF6,18,Calabria
2021-04-02,PIE,20139,8302,11837,11712,8427,ITC,ITC1,1,Piemonte
2021-04-28,SAR,9024,4281,4743,5321,3703,ITG,ITG2,20,Sardegna
2021-02-12,ABR,1229,568,661,1039,190,ITF,ITF1,13,Abruzzo
2021-01-18,SAR,904,326,578,780,124,ITG,ITG2,20,Sardegna
2021-05-29,PIE,32772,15219,17553,20616,12156,ITC,ITC1,1,Piemonte
2021-02-23,SIC,8685,4590,4095,8219,466,ITG,ITG1,19,Sicilia
2021-05-23,ABR,9892,4701,5191,7194,2698,ITF,ITF1,13,Abruzzo
2021-02-18,PIE,4790,2093,2697,4360,430,ITC,ITC1,1,Piemonte
2021-03-16,SAR,4374,1949,2425,3452,922,ITG,ITG2,20,Sardegna
2021-03-17,PAB,581,213,368,580,1,ITH,ITH1,4,Provincia Autonoma Bolzano / Bozen
2021-03-09,SIC,13082,5701,7381,10883,2199,ITG,ITG1,19,Sicilia
2021-05-10,VEN,36442,17033,19409,26575,9867,ITH,ITH3,5,Veneto
2021-06-06,ABR,11019,5254,5765,8829,2190,ITF,ITF1,13,Abruzzo
2021-04-16,PIE,28403,13213,15190,23417,4986,ITC,ITC1,1,Piemonte
2021-05-05,CAM,51165,24852,26313,44785,6380,ITF,ITF3,15,Campania
2021-05-13,PAB,2994,1355,1639,1064,1930,ITH,ITH1,4,Provincia Autonoma Bolzano / Bozen
2021-01-11,SIC,5759,2535,3224,5759,0,ITG,ITG1,19,Sicilia
2021-01-30,VEN,8747,2672,6075,693,8054,ITH,ITH3,5,Veneto
2021-04-10,ABR,8772,4057,4715,6264,2508,ITF,ITF1,13,Abruzzo
2021-01-25,LAZ,8111,3246,4865,770,7341,ITI,ITI4,12,Lazio
2021-06-17,LOM,107364,52187,55177,53400,53964,ITC,ITC4,3,Lombardia
2021-05-05,LAZ,46764,21455,25309,30943,15821,ITI,ITI4,12,Lazio
2021-03-09,LOM,33206,12854,20352,25811,7395,ITC,ITC4,3,Lombardia
2021-01-26,MAR,2018,746,1272,91,1927,ITI,ITI3,11,Marche
2021-03-09,CAL,6353,3270,3083,5372,981,ITF,ITF6,18,Calabria
2021-05-17,VEN,26465,12968,13497,16445,10020,ITH,ITH3,5,Veneto
2021-03-26,LIG,9321,4019,5302,6166,3155,ITC,ITC3,7,Liguria
2021-03-28,LOM,20471,7807,12664,14309,6162,ITC,ITC4,3,Lombardia
2021-04-11,SIC,15350,7581,7769,8320,7030,ITG,ITG1,19,Sicilia
2021-05-22,TOS,26002,12651,13351,21724,4278,ITI,ITI1,9,Toscana
2021-02-06,VEN,4095,1354,2741,709,3386,ITH,ITH3,5,Veneto
2021-04-14,LOM,47146,21013,26133,34180,12966,ITC,ITC4,3,Lombardia
2021-02-20,CAL,1424,762,662,1105,319,ITF,ITF6,18,Calabria
2021-05-26,LAZ,47347,21726,25621,35343,12004,ITI,ITI4,12,Lazio
2021-01-02,LIG,691,245,446,691,0,ITC,ITC3,7,Liguria
2021-01-04,LOM,6097,2101,3996,6097,0,ITC,ITC4,3,Lombardia
2021-01-30,FVG,2276,745,1531,270,2006,ITH,ITH4,6,Friuli-Venezia Giulia
2021-03-04,LAZ,19408,8714,10694,14391,5017,ITI,ITI4,12,Lazio
2021-04-21,PAT,2896,1350,1546,2846,50,ITH,ITH2,4,Provincia Autonoma Trento
2021-05-05,TOS,30119,13441,16678,15646,14473,ITI,ITI1,9,Toscana
2021-06-12,LAZ,63686,29009,34677,34352,29334,ITI,ITI4,12,Lazio
2021-04-24,PAB,5104,2449,2655,4619,485,ITH,ITH1,4,Provincia Autonoma Bolzano / Bozen
2021-02-05,VDA,294,102,192,101,193,ITC,ITC2,2,Valle d'Aosta / Vallée d'Aoste
2021-02-07,PUG,1579,669,910,253,1326,ITF,ITF4,16,Puglia
2021-05-19,SAR,16396,8150,8246,12750,3646,ITG,ITG2,20,Sardegna
2021-01-21,PUG,2132,904,1228,1271,861,ITF,ITF4,16,Puglia
2021-01-22,ABR,118,57,61,118,0,ITF,ITF1,13,Abruzzo
2021-02-22,VDA,316,94,222,213,103,ITC,ITC2,2,Valle d'Aosta / Vallée d'Aoste
2021-03-28,CAM,15555,7504,8051,13930,1625,ITF,ITF3,15,Campania
2021-04-23,PIE,27446,12602,14844,20684,6762,ITC,ITC1,1,Piemonte
2021-02-28,TOS,1649,667,982,922,727,ITI,ITI1,9,Toscana
2021-05-01,PUG,27543,12617,14926,16893,10650,ITF,ITF4,16,Puglia
2021-06-05,SAR,17827,8413,9414,11377,6450,ITG,ITG2,20,Sardegna
2021-02-23,VEN,7378,3252,4126,7108,270,ITH,ITH3,5,Veneto
2021-04-19,MAR,9601,4497,5104,8020,1581,ITI,ITI3,11,Marche
2021-05-31,CAL,15254,7322,7932,7375,7879,ITF,ITF6,18,Calabria
2021-02-25,SAR,2899,1255,1644,2294,605,ITG,ITG2,20,Sardegna
2021-01-04,CAM,5825,2962,2863,5825,0,ITF,ITF3,15,Campania
2021-02-11,TOS,5383,2021,3362,5141,242,ITI,ITI1,9,Toscana
2021-05-16,VDA,688,341,347,347,341,ITC,ITC2,2,Valle d'Aosta / Vallée d'Aoste
2021-01-30,EMR,10079,3520,6559,141,9938,ITH,ITH5,8,Emilia-Romagna
2021-03-14,SAR,607,376,231,607,0,ITG,ITG2,20,Sardegna
2021-03-24,MOL,1631,658,973,1229,402,ITF,ITF2,14,Molise
2020-12-30,SIC,182,107,75,182,0,ITG,ITG1,19,Sicilia
2021-02-09,TOS,4488,1468,3020,3877,611,ITI,ITI1,9,Toscana
2021-04-05,PAB,301,144,157,23,278,ITH,ITH1,4,Provincia Autonoma Bolzano / Bozen
2021-06-14,LAZ,62153,29077,33076,32361,29792,ITI,ITI4,12,Lazio
2021-06-19,CAM,60998,29026,31972,23401,37597,ITF,ITF3,15,Campania
2021-01-16,SIC,2462,1102,1360,2462,0,ITG,ITG1,19,Sicilia
2021-01-28,PAT,530,147,383,48,482,ITH,ITH2,4,Provincia Autonoma Trento
2021-01-11,PAT,730,221,509,730,0,ITH,ITH2,4,Provincia Autonoma Trento
2021-01-22,BAS,67,24,43,67,0,ITF,ITF5,17,Basilicata
2021-06-19,LOM,100755,50626,50129,57652,43103,ITC,ITC4,3,Lombardia
2021-03-21,LAZ,18210,7146,11064,13159,5051,ITI,ITI4,12,Lazio
2021-04-09,SIC,20267,9875,10392,11192,9075,ITG,ITG1,19,Sicilia
2021-01-12,PAB,1709,459,1250,1709,0,ITH,ITH1,4,Provincia Autonoma Bolzano / Bozen
2021-03-23,SIC,20826,10005,10821,15312,5514,ITG,ITG1,19,Sicilia
2021-01-02,PUG,2950,1301,1649,2950,0,ITF,ITF4,16,Puglia
2021-01-03,ABR,471,185,286,471,0,ITF,ITF1,13,Abruzzo
2021-04-12,PUG,29147,13726,15421,26321,2826,ITF,ITF4,16,Puglia
2020-12-30,LAZ,1630,629,1001,1630,0,ITI,ITI4,12,Lazio
2021-02-16,PAT,663,244,419,658,5,ITH,ITH2,4,Provincia Autonoma Trento
2021-03-09,CAM,14124,6870,7254,10339,3785,ITF,ITF3,15,Campania
2021-05-02,BAS,4179,2000,2179,3551,628,ITF,ITF5,17,Basilicata
2021-04-15,BAS,3386,1659,1727,2632,754,ITF,ITF5,17,Basilicata
2021-01-17,MOL,78,38,40,48,30,ITF,ITF2,14,Molise
2021-06-15,LIG,17004,8264,8740,10564,6440,ITC,ITC3,7,Liguria
2021-02-14,MAR,738,301,437,738,0,ITI,ITI3,11,Marche
2021-04-28,VEN,32387,15166,17221,23369,9018,ITH,ITH3,5,Veneto
2021-04-23,EMR,29558,13811,15747,14677,14881,ITH,ITH5,8,Emilia-Romagna
2021-04-23,PAT,3611,1754,1857,3557,54,ITH,ITH2,4,Provincia Autonoma Trento
2021-01-30,PAT,386,132,254,152,234,ITH,ITH2,4,Provincia Autonoma Trento
2021-04-21,FVG,7752,3456,4296,4073,3679,ITH,ITH4,6,Friuli-Venezia Giulia
2020-12-28,SIC,211,126,85,211,0,ITG,ITG1,19,Sicilia
2021-01-13,EMR,9078,2942,6136,9078,0,ITH,ITH5,8,Emilia-Romagna
2021-03-27,ABR,6122,2620,3502,3636,2486,ITF,ITF1,13,Abruzzo
2021-04-09,LAZ,27534,12473,15061,19283,8251,ITI,ITI4,12,Lazio
2021-01-11,FVG,1882,608,1274,1882,0,ITH,ITH4,6,Friuli-Venezia Giulia
2021-03-23,LAZ,25169,11737,13432,18577,6592,ITI,ITI4,12,Lazio
2021-04-10,MOL,2638,1261,1377,2486,152,ITF,ITF2,14,Molise
2021-05-10,PAT,3209,1646,1563,2704,505,ITH,ITH2,4,Provincia Autonoma Trento
2021-03-07,LIG,1915,1138,777,1614,301,ITC,ITC3,7,Liguria
2021-05-31,CAM,40649,20593,20056,30381,10268,ITF,ITF3,15,Campania
2021-01-03,BAS,901,344,557,901,0,ITF,ITF5,17,Basilicata
2021-01-01,UMB,274,105,169,274,0,ITI,ITI2,10,Umbria
2021-02-05,MOL,593,269,324,55,538,ITF,ITF2,14,Molise
2021-04-11,UMB,3102,1503,1599,3053,49,ITI,ITI2,10,Umbria
2021-04-30,SAR,11134,5301,5833,6923,4211,ITG,ITG2,20,Sardegna
2021-01-18,VEN,2762,776,1986,2563,199,ITH,ITH3,5,Veneto
2021-01-05,ABR,1615,604,1011,1615,0,ITF,ITF1,13,Abruzzo
2021-03-11,CAL,7282,3430,3852,6018,1264,ITF,ITF6,18,Calabria
2021-04-04,EMR,9885,4718,5167,7616,2269,ITH,ITH5,8,Emilia-Romagna
2021-04-04,PIE,9255,4060,5195,6541,2714,ITC,ITC1,1,Piemonte
2021-06-04,VDA,908,383,525,474,434,ITC,ITC2,2,Valle d'Aosta / Vallée d'Aoste
2021-01-18,UMB,614,219,395,529,85,ITI,ITI2,10,Umbria
2021-01-19,MOL,173,63,110,162,11,ITF,ITF2,14,Molise
2021-04-21,PIE,25754,11840,13914,20414,5340,ITC,ITC1,1,Piemonte
2021-05-17,SAR,12128,5694,6434,9238,2890,ITG,ITG2,20,Sardegna
2021-02-04,VEN,7385,2025,5360,552,6833,ITH,ITH3,5,Veneto
2021-04-15,ABR,7819,3679,4140,5979,1840,ITF,ITF1,13,Abruzzo
2021-01-12,PUG,4213,1771,2442,4213,0,ITF,ITF4,16,Puglia
2021-02-16,LOM,9505,3073,6432,9057,448,ITC,ITC4,3,Lombardia
2021-03-02,CAM,12761,4558,8203,8416,4345,ITF,ITF3,15,Campania
2021-05-20,PAB,4721,2333,2388,3252,1469,ITH,ITH1,4,Provincia Autonoma Bolzano / Bozen
2021-01-11,CAL,2163,1045,1118,2163,0,ITF,ITF6,18,Calabria
2020-12-27,ABR,37,19,18,37,0,ITF,ITF1,13,Abruzzo
2021-01-25,CAL,1072,514,558,147,925,ITF,ITF6,18,Calabria
2021-06-10,LOM,101519,51672,49847,87172,14347,ITC,ITC4,3,Lombardia
2021-01-15,BAS,813,350,463,813,0,ITF,ITF5,17,Basilicata
2021-02-11,LIG,1979,767,1212,1103,876,ITC,ITC3,7,Liguria
2021-03-02,LOM,22802,9697,13105,19769,3033,ITC,ITC4,3,Lombardia
2021-05-05,CAL,13600,6509,7091,8493,5107,ITF,ITF6,18,Calabria
2021-03-23,SAR,6413,2879,3534,5335,1078,ITG,ITG2,20,Sardegna
2021-05-22,LIG,6644,3218,3426,4961,1683,ITC,ITC3,7,Liguria
2021-06-07,SIC,49493,23344,26149,41612,7881,ITG,ITG1,19,Sicilia
2021-01-16,TOS,3271,1046,2225,3271,0,ITI,ITI1,9,Toscana
2021-03-20,ABR,4789,2198,2591,2618,2171,ITF,ITF1,13,Abruzzo
2021-04-16,EMR,29213,13756,15457,20377,8836,ITH,ITH5,8,Emilia-Romagna
2021-01-06,EMR,8287,2955,5332,8287,0,ITH,ITH5,8,Emilia-Romagna
2021-04-26,TOS,10151,4943,5208,7598,2553,ITI,ITI1,9,Toscana
2021-04-03,VDA,676,341,335,661,15,ITC,ITC2,2,Valle d'Aosta / Vallée d'Aoste
2021-04-04,VEN,7776,3531,4245,6625,1151,ITH,ITH3,5,Veneto
2021-02-13,UMB,115,28,87,112,3,ITI,ITI2,10,Umbria
2021-03-20,VDA,208,86,122,172,36,ITC,ITC2,2,Valle d'Aosta / Vallée d'Aoste
2021-03-30,LAZ,26636,12837,13799,19487,7149,ITI,ITI4,12,Lazio
2021-06-19,PIE,37887,19093,18794,21452,16435,ITC,ITC1,1,Piemonte
2021-01-02,TOS,3497,1096,2401,3497,0,ITI,ITI1,9,Toscana
2021-04-30,EMR,36591,16782,19809,21798,14793,ITH,ITH5,8,Emilia-Romagna
2021-05-24,UMB,9046,4507,4539,8169,877,ITI,ITI2,10,Umbria
2021-04-18,UMB,1530,680,850,600,930,ITI,ITI2,10,Umbria
2021-01-11,UMB,1315,346,969,1315,0,ITI,ITI2,10,Umbria
2021-03-28,EMR,13500,6025,7475,9636,3864,ITH,ITH5,8,Emilia-Romagna
2021-04-07,PUG,15535,6979,8556,8861,6674,ITF,ITF4,16,Puglia
2020-12-27,BAS,106,41,65,106,0,ITF,ITF5,17,Basilicata
2021-01-26,MOL,450,184,266,8,442,ITF,ITF2,14,Molise
2021-02-04,FVG,2725,808,1917,35,2690,ITH,ITH4,6,Friuli-Venezia Giulia
2021-05-15,MAR,13966,6375,7591,8077,5889,ITI,ITI3,11,Marche
2021-05-05,UMB,7203,3294,3909,3902,3301,ITI,ITI2,10,Umbria
2021-05-06,MOL,2679,1214,1465,2081,598,ITF,ITF2,14,Molise
2021-06-11,VDA,1047,483,564,764,283,ITC,ITC2,2,Valle d'Aosta / Vallée d'Aoste
2021-04-18,LAZ,23808,10577,13231,16158,7650,ITI,ITI4,12,Lazio
2021-03-20,BAS,1293,572,721,280,1013,ITF,ITF5,17,Basilicata
2021-01-25,SIC,7415,3673,3742,296,7119,ITG,ITG1,19,Sicilia
2021-06-10,LIG,18138,9362,8776,12532,5606,ITC,ITC3,7,Liguria
2021-02-19,MAR,1961,712,1249,1826,135,ITI,ITI3,11,Marche
2021-04-30,FVG,7324,3231,4093,3693,3631,ITH,ITH4,6,Friuli-Venezia Giulia
2021-06-13,ABR,9691,4859,4832,7857,1834,ITF,ITF1,13,Abruzzo
2021-01-25,UMB,648,323,325,5,643,ITI,ITI2,10,Umbria
2021-05-05,SIC,26238,12184,14054,16672,9566,ITG,ITG1,19,Sicilia
2021-03-19,LIG,5296,2234,3062,2150,3146,ITC,ITC3,7,Liguria
2021-05-19,SIC,42613,20608,22005,28314,14299,ITG,ITG1,19,Sicilia
2021-02-04,PIE,10205,3341,6864,588,9617,ITC,ITC1,1,Piemonte
2021-03-02,LIG,4074,1689,2385,3764,310,ITC,ITC3,7,Liguria
2021-03-26,PAT,3221,1253,1968,2611,610,ITH,ITH2,4,Provincia Autonoma Trento
2021-01-11,CAM,4070,1871,2199,4070,0,ITF,ITF3,15,Campania
2021-03-31,PAB,1832,694,1138,821,1011,ITH,ITH1,4,Provincia Autonoma Bolzano / Bozen
2020-12-28,LOM,107,47,60,107,0,ITC,ITC4,3,Lombardia
2021-03-02,CAL,4365,2489,1876,3610,755,ITF,ITF6,18,Calabria
2021-05-24,VEN,33006,16397,16609,8010,24996,ITH,ITH3,5,Veneto
2021-03-16,CAL,3847,1888,1959,2187,1660,ITF,ITF6,18,Calabria
2021-03-06,BAS,1356,536,820,759,597,ITF,ITF5,17,Basilicata
2021-04-02,LIG,11771,5210,6561,9285,2486,ITC,ITC3,7,Liguria
2021-05-12,SAR,11075,5208,5867,7991,3084,ITG,ITG2,20,Sardegna
2021-04-21,LOM,71721,32518,39203,57112,14609,ITC,ITC4,3,Lombardia
2021-05-23,VDA,999,465,534,658,341,ITC,ITC2,2,Valle d'Aosta / Vallée d'Aoste
2021-01-11,LOM,16243,5372,10871,16243,0,ITC,ITC4,3,Lombardia
2021-02-25,EMR,9250,3499,5751,8296,954,ITH,ITH5,8,Emilia-Romagna
2021-03-07,TOS,5647,2357,3290,2104,3543,ITI,ITI1,9,Toscana
2021-06-19,PAT,3091,1692,1399,254,2837,ITH,ITH2,4,Provincia Autonoma Trento
2021-01-28,LOM,12221,3702,8519,801,11420,ITC,ITC4,3,Lombardia
2021-01-29,VDA,318,138,180,2,316,ITC,ITC2,2,Valle d'Aosta / Vallée d'Aoste
2021-04-30,PIE,31812,14312,17500,18477,13335,ITC,ITC1,1,Piemonte
2021-05-19,LAZ,46881,21538,25343,36818,10063,ITI,ITI4,12,Lazio
2021-06-19,EMR,23306,11553,11753,10758,12548,ITH,ITH5,8,Emilia-Romagna
2021-04-04,UMB,59,20,39,23,36,ITI,ITI2,10,Umbria
2021-01-29,ABR,1387,449,938,74,1313,ITF,ITF1,13,Abruzzo
2021-03-11,EMR,17456,7306,10150,11605,5851,ITH,ITH5,8,Emilia-Romagna
2021-04-22,VDA,1068,450,618,685,383,ITC,ITC2,2,Valle d'Aosta / Vallée d'Aoste
2021-06-07,UMB,6907,3396,3511,6218,689,ITI,ITI2,10,Umbria
2021-05-09,VDA,574,287,287,444,130,ITC,ITC2,2,Valle d'Aosta / Vallée d'Aoste
2021-01-04,LAZ,7484,2909,4575,7484,0,ITI,ITI4,12,Lazio
2021-02-06,EMR,7601,2407,5194,2130,5471,ITH,ITH5,8,Emilia-Romagna
2021-03-16,UMB,3539,1454,2085,1912,1627,ITI,ITI2,10,Umbria
2021-03-17,MOL,908,385,523,576,332,ITF,ITF2,14,Molise
2021-05-27,PUG,40446,19079,21367,23247,17199,ITF,ITF4,16,Puglia
2021-06-07,LAZ,61853,28824,33029,32986,28867,ITI,ITI4,12,Lazio
2021-02-27,UMB,1658,354,1304,1642,16,ITI,ITI2,10,Umbria
2021-04-21,LIG,14247,6433,7814,8920,5327,ITC,ITC3,7,Liguria
2020-12-28,SAR,65,25,40,65,0,ITG,ITG2,20,Sardegna
2020-12-31,MAR,388,182,206,388,0,ITI,ITI3,11,Marche
2021-02-11,CAL,2330,1042,1288,1082,1248,ITF,ITF6,18,Calabria
2021-05-09,BAS,4684,2339,2345,2990,1694,ITF,ITF5,17,Basilicata
2021-06-08,MOL,2885,1593,1292,2189,696,ITF,ITF2,14,Molise
2021-03-16,SIC,9561,4279,5282,3625,5936,ITG,ITG1,19,Sicilia
2021-06-19,FVG,7611,3987,3624,1228,6383,ITH,ITH4,6,Friuli-Venezia Giulia
2021-01-05,PAB,830,286,544,830,0,ITH,ITH1,4,Provincia Autonoma Bolzano / Bozen
2021-02-04,PAT,976,304,672,422,554,ITH,ITH2,4,Provincia Autonoma Trento
2021-02-14,PAB,297,130,167,297,0,ITH,ITH1,4,Provincia Autonoma Bolzano / Bozen
2021-02-18,SIC,5277,3100,2177,4847,430,ITG,ITG1,19,Sicilia
2021-06-18,VDA,998,443,555,599,399,ITC,ITC2,2,Valle d'Aosta / Vallée d'Aoste
2021-04-30,CAM,42271,20162,22109,25819,16452,ITF,ITF3,15,Campania
2021-05-08,PAB,4427,2382,2045,3764,663,ITH,ITH1,4,Provincia Autonoma Bolzano / Bozen
2021-01-30,LAZ,7012,2894,4118,807,6205,ITI,ITI4,12,Lazio
2021-02-01,UMB,1285,342,943,48,1237,ITI,ITI2,10,Umbria
2021-02-04,CAM,7943,3429,4514,1308,6635,ITF,ITF3,15,Campania
2021-05-12,SIC,36728,17301,19427,21865,14863,ITG,ITG1,19,Sicilia
2021-03-13,BAS,1798,890,908,753,1045,ITF,ITF5,17,Basilicata
2021-02-18,UMB,1496,582,914,1030,466,ITI,ITI2,10,Umbria
2021-03-03,PAB,1179,393,786,1166,13,ITH,ITH1,4,Provincia Autonoma Bolzano / Bozen
2021-05-17,LOM,94599,45332,49267,30209,64390,ITC,ITC4,3,Lombardia
2021-01-27,FVG,1272,425,847,450,822,ITH,ITH4,6,Friuli-Venezia Giulia
2021-02-07,BAS,374,159,215,49,325,ITF,ITF5,17,Basilicata
2021-01-01,CAM,919,506,413,919,0,ITF,ITF3,15,Campania
2021-04-28,MOL,1693,923,770,476,1217,ITF,ITF2,14,Molise
2021-05-14,VEN,46627,22176,24451,25783,20844,ITH,ITH3,5,Veneto
2021-05-18,BAS,5896,2855,3041,3403,2493,ITF,ITF5,17,Basilicata
2021-02-04,PUG,5929,2366,3563,1195,4734,ITF,ITF4,16,Puglia
2021-05-09,EMR,25609,12252,13357,18642,6967,ITH,ITH5,8,Emilia-Romagna
2021-01-29,EMR,10414,3496,6918,290,10124,ITH,ITH5,8,Emilia-Romagna
2021-04-08,SIC,16574,8208,8366,8121,8453,ITG,ITG1,19,Sicilia
2021-05-07,FVG,10592,4844,5748,7095,3497,ITH,ITH4,6,Friuli-Venezia Giulia
2021-01-15,LAZ,6580,2706,3874,6580,0,ITI,ITI4,12,Lazio
2021-02-20,VEN,6424,2014,4410,6353,71,ITH,ITH3,5,Veneto
2021-03-04,PAT,2359,794,1565,1581,778,ITH,ITH2,4,Provincia Autonoma Trento
2020-12-30,LIG,12,5,7,12,0,ITC,ITC3,7,Liguria
2021-02-15,EMR,2904,851,2053,2779,125,ITH,ITH5,8,Emilia-Romagna
2021-04-25,LAZ,24515,11244,13271,16703,7812,ITI,ITI4,12,Lazio
2021-04-20,PIE,25472,11661,13811,19126,6346,ITC,ITC1,1,Piemonte
2021-03-25,CAM,20319,9651,10668,16816,3503,ITF,ITF3,15,Campania
2021-05-01,BAS,4703,2136,2567,3952,751,ITF,ITF5,17,Basilicata
2021-01-19,ABR,111,55,56,91,20,ITF,ITF1,13,Abruzzo
2021-03-18,TOS,9979,3984,5995,6007,3972,ITI,ITI1,9,Toscana
2021-05-09,FVG,7355,3301,4054,3498,3857,ITH,ITH4,6,Friuli-Venezia Giulia
2021-02-07,ABR,778,307,471,201,577,ITF,ITF1,13,Abruzzo
2021-02-22,SAR,1639,949,690,1411,228,ITG,ITG2,20,Sardegna
2021-03-02,MAR,4953,1941,3012,4387,566,ITI,ITI3,11,Marche
2021-04-13,CAL,6761,3268,3493,5463,1298,ITF,ITF6,18,Calabria
2021-05-07,PIE,33063,15641,17422,18946,14117,ITC,ITC1,1,Piemonte
2021-01-27,EMR,8361,2947,5414,462,7899,ITH,ITH5,8,Emilia-Romagna
2021-01-27,PIE,4196,1453,2743,999,3197,ITC,ITC1,1,Piemonte
2021-05-19,LOM,82760,39539,43221,33793,48967,ITC,ITC4,3,Lombardia
2021-06-10,MAR,14673,7564,7109,12660,2013,ITI,ITI3,11,Marche
2021-01-20,CAL,1400,626,774,1399,1,ITF,ITF6,18,Calabria
2021-02-13,PIE,4153,1334,2819,2931,1222,ITC,ITC1,1,Piemonte
2021-03-11,SAR,6422,3087,3335,5220,1202,ITG,ITG2,20,Sardegna
2021-02-08,LOM,10080,2918,7162,2130,7950,ITC,ITC4,3,Lombardia
2021-05-17,PUG,32726,15160,17566,20876,11850,ITF,ITF4,16,Puglia
2021-06-09,TOS,34695,17488,17207,34274,421,ITI,ITI1,9,Toscana
2021-02-25,LOM,15287,6348,8939,13718,1569,ITC,ITC4,3,Lombardia
2021-01-03,CAL,6,3,3,6,0,ITF,ITF6,18,Calabria
2021-04-11,LIG,4247,1929,2318,3998,249,ITC,ITC3,7,Liguria
2021-06-02,VEN,20304,10234,10070,15957,4347,ITH,ITH3,5,Veneto
2021-02-21,MOL,574,227,347,572,2,ITF,ITF2,14,Molise
2021-03-29,VDA,493,233,260,453,40,ITC,ITC2,2,Valle d'Aosta / Vallée d'Aoste
2021-01-21,ABR,157,47,110,157,0,ITF,ITF1,13,Abruzzo
2021-03-27,CAL,8604,3897,4707,4597,4007,ITF,ITF6,18,Calabria
2021-05-16,UMB,5319,2536,2783,5267,52,ITI,ITI2,10,Umbria
2021-06-20,VDA,761,359,402,230,531,ITC,ITC2,2,Valle d'Aosta / Vallée d'Aoste
2021-02-04,MOL,758,295,463,77,681,ITF,ITF2,14,Molise
2021-04-04,TOS,13914,6604,7310,13661,253,ITI,ITI1,9,Toscana
2021-05-26,FVG,13331,6675,6656,9917,3414,ITH,ITH4,6,Friuli-Venezia Giulia
2021-03-12,VDA,531,175,356,305,226,ITC,ITC2,2,Valle d'Aosta / Vallée d'Aoste
2021-05-01,ABR,10746,5053,5693,5772,4974,ITF,ITF1,13,Abruzzo
2021-05-24,MAR,10796,5111,5685,8122,2674,ITI,ITI3,11,Marche
2021-02-15,FVG,2454,912,1542,2201,253,ITH,ITH4,6,Friuli-Venezia Giulia
2021-05-15,MOL,2979,1398,1581,2595,384,ITF,ITF2,14,Molise
2021-02-06,LOM,15253,5536,9717,1014,14239,ITC,ITC4,3,Lombardia
2021-02-20,SIC,7139,3692,3447,6897,242,ITG,ITG1,19,Sicilia
2021-04-06,LAZ,24360,11088,13272,17248,7112,ITI,ITI4,12,Lazio
2021-05-20,ABR,12590,5818,6772,7336,5254,ITF,ITF1,13,Abruzzo
2021-05-10,PAB,3018,1300,1718,1413,1605,ITH,ITH1,4,Provincia Autonoma Bolzano / Bozen
2021-05-09,PIE,27070,12906,14164,13451,13619,ITC,ITC1,1,Piemonte
2021-06-04,SAR,14372,6868,7504,9820,4552,ITG,ITG2,20,Sardegna
2021-01-18,LIG,2137,745,1392,1980,157,ITC,ITC3,7,Liguria
2021-01-27,PAT,804,277,527,93,711,ITH,ITH2,4,Provincia Autonoma Trento
2021-02-03,SIC,5920,2779,3141,721,5199,ITG,ITG1,19,Sicilia
2021-03-16,TOS,4899,1882,3017,2648,2251,ITI,ITI1,9,Toscana
2020-12-27,LAZ,274,132,142,274,0,ITI,ITI4,12,Lazio
2021-02-13,PAT,537,333,204,172,365,ITH,ITH2,4,Provincia Autonoma Trento
2021-02-27,TOS,1984,756,1228,1082,902,ITI,ITI1,9,Toscana
2021-03-11,VEN,19823,8885,10938,14254,5569,ITH,ITH3,5,Veneto
2021-03-13,SAR,2755,1076,1679,2474,281,ITG,ITG2,20,Sardegna
2021-05-26,PIE,32703,15093,17610,15644,17059,ITC,ITC1,1,Piemonte
2021-01-20,CAM,1257,650,607,1257,0,ITF,ITF3,15,Campania
2021-04-27,SIC,26249,12643,13606,15524,10725,ITG,ITG1,19,Sicilia
2021-02-15,PIE,4432,1597,2835,3227,1205,ITC,ITC1,1,Piemonte
2021-05-22,MAR,11937,5719,6218,7489,4448,ITI,ITI3,11,Marche
2021-03-04,PIE,14535,5770,8765,11587,2948,ITC,ITC1,1,Piemonte
2021-03-08,CAL,5419,2904,2515,4353,1066,ITF,ITF6,18,Calabria
2021-03-30,SAR,8778,3591,5187,6502,2276,ITG,ITG2,20,Sardegna
2021-04-27,UMB,5668,2404,3264,3090,2578,ITI,ITI2,10,Umbria
2021-02-26,BAS,2149,904,1245,2069,80,ITF,ITF5,17,Basilicata
2021-02-03,UMB,725,174,551,67,658,ITI,ITI2,10,Umbria
2021-03-10,VDA,438,183,255,225,213,ITC,ITC2,2,Valle d'Aosta / Vallée d'Aoste
2021-03-02,TOS,10599,3799,6800,7155,3444,ITI,ITI1,9,Toscana
2021-06-12,VEN,47706,24040,23666,37004,10702,ITH,ITH3,5,Veneto
2021-04-04,SAR,1,0,1,0,1,ITG,ITG2,20,Sardegna
2021-06-18,BAS,4462,2063,2399,2204,2258,ITF,ITF5,17,Basilicata
2021-01-04,TOS,5065,1894,3171,5065,0,ITI,ITI1,9,Toscana
2021-04-08,VDA,584,282,302,441,143,ITC,ITC2,2,Valle d'Aosta / Vallée d'Aoste
2021-05-24,LAZ,43828,20087,23741,34113,9715,ITI,ITI4,12,Lazio
2021-05-26,UMB,9646,4567,5079,8393,1253,ITI,ITI2,10,Umbria
2021-04-14,TOS,20168,8336,11832,15061,5107,ITI,ITI1,9,Toscana
2021-05-12,PAT,3299,1491,1808,2114,1185,ITH,ITH2,4,Provincia Autonoma Trento
2021-02-18,CAM,9080,3813,5267,8373,707,ITF,ITF3,15,Campania
2021-02-28,PUG,6053,1806,4247,5867,186,ITF,ITF4,16,Puglia
2021-06-03,MAR,14645,7478,7167,12382,2263,ITI,ITI3,11,Marche
2021-03-16,PAT,1391,506,885,608,783,ITH,ITH2,4,Provincia Autonoma Trento
2021-05-25,MOL,1963,887,1076,1333,630,ITF,ITF2,14,Molise
2021-06-08,PAB,4143,2115,2028,828,3315,ITH,ITH1,4,Provincia Autonoma Bolzano / Bozen
2021-01-15,EMR,7750,2404,5346,7750,0,ITH,ITH5,8,Emilia-Romagna
2021-05-14,PAT,5313,2539,2774,3932,1381,ITH,ITH2,4,Provincia Autonoma Trento
2021-02-02,ABR,1763,668,1095,222,1541,ITF,ITF1,13,Abruzzo
2021-05-13,ABR,11146,5042,6104,7187,3959,ITF,ITF1,13,Abruzzo
2021-06-13,VDA,851,399,452,373,478,ITC,ITC2,2,Valle d'Aosta / Vallée d'Aoste
2021-02-08,PIE,6917,2356,4561,666,6251,ITC,ITC1,1,Piemonte
2021-01-03,LAZ,5251,1973,3278,5251,0,ITI,ITI4,12,Lazio
2021-05-12,PUG,36490,16281,20209,24022,12468,ITF,ITF4,16,Puglia
2021-06-14,TOS,31759,16305,15454,27665,4094,ITI,ITI1,9,Toscana
2021-01-04,MOL,314,131,183,314,0,ITF,ITF2,14,Molise
2021-04-25,CAM,30731,15170,15561,25338,5393,ITF,ITF3,15,Campania
2021-01-01,SIC,817,437,380,817,0,ITG,ITG1,19,Sicilia
2021-03-31,ABR,6711,2937,3774,4642,2069,ITF,ITF1,13,Abruzzo
2021-04-13,LAZ,25736,11926,13810,18020,7716,ITI,ITI4,12,Lazio
2021-04-14,MOL,1806,767,1039,1145,661,ITF,ITF2,14,Molise
2021-04-08,FVG,7378,3173,4205,5456,1922,ITH,ITH4,6,Friuli-Venezia Giulia
2021-02-16,MOL,156,70,86,150,6,ITF,ITF2,14,Molise
2021-04-20,SIC,19051,9000,10051,13803,5248,ITG,ITG1,19,Sicilia
2021-02-18,MAR,2101,745,1356,1815,286,ITI,ITI3,11,Marche
2021-05-27,MOL,2834,1348,1486,1998,836,ITF,ITF2,14,Molise
2021-04-23,LIG,14672,6637,8035,8552,6120,ITC,ITC3,7,Liguria
2021-05-21,FVG,11152,4994,6158,8185,2967,ITH,ITH4,6,Friuli-Venezia Giulia
2021-06-09,EMR,42119,21428,20691,35968,6151,ITH,ITH5,8,Emilia-Romagna
2021-05-29,MAR,12788,6194,6594,8260,4528,ITI,ITI3,11,Marche
2021-01-24,BAS,839,302,537,58,781,ITF,ITF5,17,Basilicata
2021-02-10,FVG,1352,496,856,1266,86,ITH,ITH4,6,Friuli-Venezia Giulia
2021-03-01,EMR,10099,3582,6517,7841,2258,ITH,ITH5,8,Emilia-Romagna
2021-05-02,VEN,37235,17263,19972,26905,10330,ITH,ITH3,5,Veneto
2021-05-15,ABR,11439,5179,6260,6129,5310,ITF,ITF1,13,Abruzzo
2021-02-01,FVG,2097,688,1409,16,2081,ITH,ITH4,6,Friuli-Venezia Giulia
2021-03-11,LIG,6393,3088,3305,4387,2006,ITC,ITC3,7,Liguria
2021-05-28,UMB,9570,4426,5144,7279,2291,ITI,ITI2,10,Umbria
2021-01-13,LIG,2754,1013,1741,2754,0,ITC,ITC3,7,Liguria
2021-05-13,BAS,5985,2967,3018,3389,2596,ITF,ITF5,17,Basilicata
2021-06-08,VDA,712,356,356,679,33,ITC,ITC2,2,Valle d'Aosta / Vallée d'Aoste
2021-05-04,EMR,29271,13704,15567,15611,13660,ITH,ITH5,8,Emilia-Romagna
2021-06-14,VEN,42335,21404,20931,27090,15245,ITH,ITH3,5,Veneto
2021-01-08,LAZ,7729,2895,4834,7729,0,ITI,ITI4,12,Lazio
2021-01-13,CAM,8020,3666,4354,8020,0,ITF,ITF3,15,Campania
2021-04-15,UMB,7634,3486,4148,5747,1887,ITI,ITI2,10,Umbria
2021-06-16,SAR,17650,8283,9367,12348,5302,ITG,ITG2,20,Sardegna
2021-02-08,PAT,1151,318,833,342,809,ITH,ITH2,4,Provincia Autonoma Trento
2021-03-04,TOS,17847,6950,10897,14765,3082,ITI,ITI1,9,Toscana
2021-03-06,VEN,10667,4356,6311,7405,3262,ITH,ITH3,5,Veneto
2021-04-28,PAB,2464,1302,1162,2459,5,ITH,ITH1,4,Provincia Autonoma Bolzano / Bozen
2021-02-17,UMB,1618,748,870,1267,351,ITI,ITI2,10,Umbria
2021-05-21,PIE,36029,16740,19289,20392,15637,ITC,ITC1,1,Piemonte
2021-01-04,LIG,2615,854,1761,2615,0,ITC,ITC3,7,Liguria
2021-01-23,PUG,3040,1294,1746,886,2154,ITF,ITF4,16,Puglia
2021-05-29,MOL,2346,1219,1127,1956,390,ITF,ITF2,14,Molise
2021-03-13,CAL,6918,3010,3908,5947,971,ITF,ITF6,18,Calabria
2021-05-03,PUG,33275,14875,18400,22652,10623,ITF,ITF4,16,Puglia
2021-02-27,EMR,10966,3999,6967,9228,1738,ITH,ITH5,8,Emilia-Romagna
2021-03-07,PUG,4983,2000,2983,4412,571,ITF,ITF4,16,Puglia
2020-12-30,VEN,699,245,454,699,0,ITH,ITH3,5,Veneto
2021-04-25,EMR,22349,10240,12109,14841,7508,ITH,ITH5,8,Emilia-Romagna
2021-01-01,SAR,32,17,15,32,0,ITG,ITG2,20,Sardegna
2021-02-16,MAR,1288,475,813,1258,30,ITI,ITI3,11,Marche
2021-02-26,VDA,207,58,149,122,85,ITC,ITC2,2,Valle d'Aosta / Vallée d'Aoste
2021-04-13,UMB,7687,3403,4284,6017,1670,ITI,ITI2,10,Umbria
2021-05-14,FVG,10730,5346,5384,8148,2582,ITH,ITH4,6,Friuli-Venezia Giulia
2021-02-25,MAR,3509,1434,2075,3330,179,ITI,ITI3,11,Marche
2021-02-27,SAR,1921,647,1274,1366,555,ITG,ITG2,20,Sardegna
2021-02-03,FVG,2647,791,1856,23,2624,ITH,ITH4,6,Friuli-Venezia Giulia
2021-02-15,UMB,1368,692,676,1367,1,ITI,ITI2,10,Umbria
2021-02-01,PIE,8645,3055,5590,579,8066,ITC,ITC1,1,Piemonte
2021-04-18,CAM,27217,13282,13935,18317,8900,ITF,ITF3,15,Campania
2021-05-08,BAS,4835,2399,2436,3429,1406,ITF,ITF5,17,Basilicata
2021-06-05,MAR,13928,7004,6924,11869,2059,ITI,ITI3,11,Marche
2021-01-15,CAL,2802,1259,1543,2802,0,ITF,ITF6,18,Calabria
2021-04-10,VDA,404,190,214,399,5,ITC,ITC2,2,Valle d'Aosta / Vallée d'Aoste
2021-01-08,CAM,10454,4967,5487,10454,0,ITF,ITF3,15,Campania
2021-01-16,PAB,2840,1265,1575,2840,0,ITH,ITH1,4,Provincia Autonoma Bolzano / Bozen
2020-12-31,VDA,18,4,14,18,0,ITC,ITC2,2,Valle d'Aosta / Vallée d'Aoste
2021-01-03,UMB,270,112,158,270,0,ITI,ITI2,10,Umbria
2021-02-20,LOM,9335,3867,5468,9038,297,ITC,ITC4,3,Lombardia
2021-04-25,CAL,15829,8034,7795,14696,1133,ITF,ITF6,18,Calabria
2021-05-05,PUG,39072,17118,21954,24913,14159,ITF,ITF4,16,Puglia
2021-06-06,VDA,1160,582,578,787,373,ITC,ITC2,2,Valle d'Aosta / Vallée d'Aoste
2021-04-23,MAR,11159,5140,6019,8104,3055,ITI,ITI3,11,Marche
2021-05-21,PAT,5047,2418,2629,3340,1707,ITH,ITH2,4,Provincia Autonoma Trento
2021-05-07,CAL,16100,7590,8510,9722,6378,ITF,ITF6,18,Calabria
2021-05-08,PUG,54199,22942,31257,24488,29711,ITF,ITF4,16,Puglia
2021-02-18,TOS,8822,3284,5538,7926,896,ITI,ITI1,9,Toscana
2021-04-04,CAM,7965,4017,3948,6919,1046,ITF,ITF3,15,Campania
2021-01-02,MAR,455,140,315,455,0,ITI,ITI3,11,Marche
2021-02-13,CAL,1397,604,793,1032,365,ITF,ITF6,18,Calabria
2021-05-11,BAS,2653,1352,1301,1620,1033,ITF,ITF5,17,Basilicata
2021-05-29,TOS,31541,15249,16292,23390,8151,ITI,ITI1,9,Toscana
2021-06-10,VEN,51587,26655,24932,42440,9147,ITH,ITH3,5,Veneto
2021-06-12,SAR,14739,7187,7552,10040,4699,ITG,ITG2,20,Sardegna
2021-02-17,ABR,2071,948,1123,1789,282,ITF,ITF1,13,Abruzzo
2021-03-04,SAR,4363,2291,2072,3107,1256,ITG,ITG2,20,Sardegna
2021-04-02,VEN,24041,10597,13444,17711,6330,ITH,ITH3,5,Veneto
2021-04-16,SIC,28553,14334,14219,20284,8269,ITG,ITG1,19,Sicilia
2021-05-17,PIE,30858,14577,16281,17743,13115,ITC,ITC1,1,Piemonte
2021-06-12,CAM,60376,29647,30729,53188,7188,ITF,ITF3,15,Campania
2021-02-06,PIE,7995,2666,5329,400,7595,ITC,ITC1,1,Piemonte
2021-01-23,SIC,4415,2273,2142,208,4207,ITG,ITG1,19,Sicilia
2021-02-23,PIE,9234,3713,5521,8653,581,ITC,ITC1,1,Piemonte
2021-03-04,CAM,14706,5395,9311,8812,5894,ITF,ITF3,15,Campania
2021-03-12,PAB,1664,734,930,1251,413,ITH,ITH1,4,Provincia Autonoma Bolzano / Bozen
2021-03-21,SAR,4030,1809,2221,2590,1440,ITG,ITG2,20,Sardegna
2021-06-11,ABR,11549,5755,5794,8805,2744,ITF,ITF1,13,Abruzzo
2021-01-06,SIC,6235,3281,2954,6235,0,ITG,ITG1,19,Sicilia
2021-03-29,PAB,1171,499,672,412,759,ITH,ITH1,4,Provincia Autonoma Bolzano / Bozen
2021-05-31,PIE,29020,13995,15025,20510,8510,ITC,ITC1,1,Piemonte
2021-06-17,PIE,40531,20343,20188,24379,16152,ITC,ITC1,1,Piemonte
2021-01-18,PAT,643,154,489,588,55,ITH,ITH2,4,Provincia Autonoma Trento
2021-06-12,LOM,88474,47639,40835,85424,3050,ITC,ITC4,3,Lombardia
2021-03-09,PIE,14054,5506,8548,11711,2343,ITC,ITC1,1,Piemonte
2021-03-21,LOM,23507,8492,15015,18314,5193,ITC,ITC4,3,Lombardia
2021-05-11,ABR,10737,5097,5640,5907,4830,ITF,ITF1,13,Abruzzo
2021-04-02,SIC,13853,6532,7321,9120,4733,ITG,ITG1,19,Sicilia
2021-02-10,SIC,4355,1777,2578,3973,382,ITG,ITG1,19,Sicilia
2021-03-23,TOS,9397,4375,5022,7123,2274,ITI,ITI1,9,Toscana
2021-03-07,MAR,5179,2106,3073,4425,754,ITI,ITI3,11,Marche
2021-03-13,EMR,16136,6360,9776,10823,5313,ITH,ITH5,8,Emilia-Romagna
2021-05-21,SIC,45756,21571,24185,24372,21384,ITG,ITG1,19,Sicilia
2021-03-02,MOL,667,383,284,509,158,ITF,ITF2,14,Molise
2021-06-09,VEN,42218,21676,20542,34863,7355,ITH,ITH3,5,Veneto
2021-06-11,CAL,17310,8507,8803,14732,2578,ITF,ITF6,18,Calabria
2021-02-13,LOM,6417,2441,3976,4941,1476,ITC,ITC4,3,Lombardia
2021-04-20,UMB,5442,2359,3083,3495,1947,ITI,ITI2,10,Umbria
2021-06-10,MOL,2555,1173,1382,1254,1301,ITF,ITF2,14,Molise
2021-01-08,CAL,2139,1026,1113,2139,0,ITF,ITF6,18,Calabria
2021-04-05,BAS,723,233,490,421,302,ITF,ITF5,17,Basilicata
2021-01-27,UMB,840,330,510,13,827,ITI,ITI2,10,Umbria
2021-03-27,EMR,21666,9063,12603,14758,6908,ITH,ITH5,8,Emilia-Romagna
2021-05-07,CAM,59755,29198,30557,43810,15945,ITF,ITF3,15,Campania
2021-03-18,CAL,4399,2053,2346,2344,2055,ITF,ITF6,18,Calabria
2020-12-30,TOS,327,104,223,327,0,ITI,ITI1,9,Toscana
2021-01-10,UMB,1070,277,793,1070,0,ITI,ITI2,10,Umbria
2021-01-27,CAM,7738,3820,3918,162,7576,ITF,ITF3,15,Campania
2021-04-13,EMR,23681,11109,12572,19376,4305,ITH,ITH5,8,Emilia-Romagna
2021-06-04,FVG,11974,6133,5841,10633,1341,ITH,ITH4,6,Friuli-Venezia Giulia
2021-05-21,UMB,8973,3668,5305,4136,4837,ITI,ITI2,10,Umbria
2021-01-03,EMR,2763,943,1820,2763,0,ITH,ITH5,8,Emilia-Romagna
2021-03-22,BAS,1187,535,652,639,548,ITF,ITF5,17,Basilicata
2021-05-04,UMB,5535,2545,2990,2410,3125,ITI,ITI2,10,Umbria
2021-04-01,LAZ,29509,13949,15560,22368,7141,ITI,ITI4,12,Lazio
2021-01-13,SAR,573,178,395,573,0,ITG,ITG2,20,Sardegna
2021-04-01,UMB,4376,1838,2538,2366,2010,ITI,ITI2,10,Umbria
2021-05-24,LIG,11818,5558,6260,9334,2484,ITC,ITC3,7,Liguria
2021-01-21,PAB,953,442,511,139,814,ITH,ITH1,4,Provincia Autonoma Bolzano / Bozen
2021-05-25,VDA,1115,530,585,541,574,ITC,ITC2,2,Valle d'Aosta / Vallée d'Aoste
2021-03-13,FVG,2939,1122,1817,1668,1271,ITH,ITH4,6,Friuli-Venezia Giulia
2021-01-25,VEN,6468,2075,4393,159,6309,ITH,ITH3,5,Veneto
2021-02-14,VDA,48,16,32,1,47,ITC,ITC2,2,Valle d'Aosta / Vallée d'Aoste
2021-04-05,ABR,2693,1147,1546,1813,880,ITF,ITF1,13,Abruzzo
2021-05-07,LIG,13590,6037,7553,5798,7792,ITC,ITC3,7,Liguria
2021-01-01,PIE,1038,395,643,1038,0,ITC,ITC1,1,Piemonte
2021-05-08,VDA,904,540,364,526,378,ITC,ITC2,2,Valle d'Aosta / Vallée d'Aoste
2021-01-13,LOM,26422,8070,18352,26422,0,ITC,ITC4,3,Lombardia
2021-02-13,LIG,1080,508,572,800,280,ITC,ITC3,7,Liguria
2021-06-12,PUG,33471,16681,16790,24774,8697,ITF,ITF4,16,Puglia
2021-03-03,BAS,1746,816,930,1187,559,ITF,ITF5,17,Basilicata
2021-04-02,MOL,1454,709,745,677,777,ITF,ITF2,14,Molise
2021-05-02,PAT,3514,1955,1559,3477,37,ITH,ITH2,4,Provincia Autonoma Trento
2021-06-07,LIG,15653,7643,8010,8654,6999,ITC,ITC3,7,Liguria
2021-01-16,MAR,2034,732,1302,2034,0,ITI,ITI3,11,Marche
2021-02-27,CAL,3999,2058,1941,3617,382,ITF,ITF6,18,Calabria
2021-05-25,BAS,4193,2110,2083,873,3320,ITF,ITF5,17,Basilicata
2021-04-01,SIC,14232,6608,7624,9568,4664,ITG,ITG1,19,Sicilia
2021-05-02,EMR,25576,11649,13927,13585,11991,ITH,ITH5,8,Emilia-Romagna
2021-05-12,TOS,34178,15567,18611,14165,20013,ITI,ITI1,9,Toscana
2021-05-08,MOL,2973,1454,1519,1729,1244,ITF,ITF2,14,Molise
2021-01-22,EMR,1829,477,1352,1088,741,ITH,ITH5,8,Emilia-Romagna
2021-03-01,UMB,1503,774,729,1389,114,ITI,ITI2,10,Umbria
2021-01-18,TOS,1119,636,483,1021,98,ITI,ITI1,9,Toscana
2021-04-20,VEN,22427,9494,12933,8428,13999,ITH,ITH3,5,Veneto
2021-04-21,MOL,1864,789,1075,969,895,ITF,ITF2,14,Molise
2021-06-19,MAR,14459,7283,7176,7791,6668,ITI,ITI3,11,Marche
2021-02-08,EMR,5231,1534,3697,2318,2913,ITH,ITH5,8,Emilia-Romagna
2021-02-14,BAS,151,48,103,151,0,ITF,ITF5,17,Basilicata
2021-06-09,UMB,8047,3896,4151,7325,722,ITI,ITI2,10,Umbria
2021-05-16,EMR,25842,12166,13676,18731,7111,ITH,ITH5,8,Emilia-Romagna
2021-01-27,CAL,1461,735,726,397,1064,ITF,ITF6,18,Calabria
2021-05-21,LOM,93758,45201,48557,29110,64648,ITC,ITC4,3,Lombardia
2021-01-23,MAR,557,190,367,123,434,ITI,ITI3,11,Marche
2021-02-20,PAT,407,245,162,123,284,ITH,ITH2,4,Provincia Autonoma Trento
2021-06-01,BAS,6136,2925,3211,3060,3076,ITF,ITF5,17,Basilicata
2021-06-04,CAM,74176,35622,38554,65152,9024,ITF,ITF3,15,Campania
2021-04-15,CAL,7686,3765,3921,5994,1692,ITF,ITF6,18,Calabria
2021-05-03,MAR,10197,4605,5592,4790,5407,ITI,ITI3,11,Marche
2021-02-27,FVG,3530,1200,2330,3529,1,ITH,ITH4,6,Friuli-Venezia Giulia
2021-02-28,ABR,1702,508,1194,1700,2,ITF,ITF1,13,Abruzzo
2021-05-07,SIC,36521,17251,19270,24935,11586,ITG,ITG1,19,Sicilia
2021-06-02,TOS,27571,13608,13963,22067,5504,ITI,ITI1,9,Toscana
2021-01-02,ABR,552,220,332,552,0,ITF,ITF1,13,Abruzzo
2021-03-11,SIC,15338,6620,8718,12968,2370,ITG,ITG1,19,Sicilia
2021-04-06,TOS,22214,9815,12399,18500,3714,ITI,ITI1,9,Toscana
2021-04-25,FVG,2365,990,1375,2354,11,ITH,ITH4,6,Friuli-Venezia Giulia
2021-05-23,EMR,25453,11855,13598,13885,11568,ITH,ITH5,8,Emilia-Romagna
2021-06-08,ABR,12635,6496,6139,10438,2197,ITF,ITF1,13,Abruzzo
2021-02-08,TOS,4097,1360,2737,3638,459,ITI,ITI1,9,Toscana
2021-04-01,CAL,8491,3847,4644,3985,4506,ITF,ITF6,18,Calabria
2021-01-27,SIC,7278,3710,3568,178,7100,ITG,ITG1,19,Sicilia
2021-04-26,ABR,8563,4066,4497,7349,1214,ITF,ITF1,13,Abruzzo
2021-05-19,TOS,27916,13557,14359,18883,9033,ITI,ITI1,9,Toscana
2021-05-21,CAM,63646,29555,34091,43178,20468,ITF,ITF3,15,Campania
2021-01-30,LIG,1660,566,1094,24,1636,ITC,ITC3,7,Liguria
2021-03-23,VEN,22202,10234,11968,17492,4710,ITH,ITH3,5,Veneto
2021-05-15,PAB,7000,3687,3313,6705,295,ITH,ITH1,4,Provincia Autonoma Bolzano / Bozen
2021-02-03,LAZ,6488,2488,4000,964,5524,ITI,ITI4,12,Lazio
2021-02-04,PAB,1958,593,1365,8,1950,ITH,ITH1,4,Provincia Autonoma Bolzano / Bozen
2021-05-19,VEN,32831,15033,17798,16923,15908,ITH,ITH3,5,Veneto
2021-01-13,SIC,5124,2422,2702,5124,0,ITG,ITG1,19,Sicilia
2021-01-15,FVG,2021,605,1416,2021,0,ITH,ITH4,6,Friuli-Venezia Giulia
2021-06-01,ABR,10994,4879,6115,6628,4366,ITF,ITF1,13,Abruzzo
2021-03-28,LIG,1141,511,630,390,751,ITC,ITC3,7,Liguria
2021-05-07,SAR,14447,6621,7826,9946,4501,ITG,ITG2,20,Sardegna
2021-04-13,TOS,8487,3506,4981,6030,2457,ITI,ITI1,9,Toscana
2021-01-20,LAZ,4807,1943,2864,3264,1543,ITI,ITI4,12,Lazio
2021-01-27,SAR,1413,497,916,79,1334,ITG,ITG2,20,Sardegna
2021-03-28,MAR,4125,1739,2386,2434,1691,ITI,ITI3,11,Marche
2021-01-08,PAT,1449,313,1136,1449,0,ITH,ITH2,4,Provincia Autonoma Trento
2021-01-31,VDA,291,91,200,58,233,ITC,ITC2,2,Valle d'Aosta / Vallée d'Aoste
2021-06-14,PAT,5725,2964,2761,2112,3613,ITH,ITH2,4,Provincia Autonoma Trento
2021-01-30,MAR,1905,668,1237,28,1877,ITI,ITI3,11,Marche
2021-02-27,PIE,12691,4851,7840,12346,345,ITC,ITC1,1,Piemonte
2021-03-25,SAR,9113,3971,5142,7807,1306,ITG,ITG2,20,Sardegna
2021-06-08,BAS,4576,2186,2390,4219,357,ITF,ITF5,17,Basilicata
2021-04-18,PAT,1855,845,1010,1846,9,ITH,ITH2,4,Provincia Autonoma Trento
2021-04-16,PUG,35957,16901,19056,32676,3281,ITF,ITF4,16,Puglia
2021-04-25,PIE,20233,9305,10928,17732,2501,ITC,ITC1,1,Piemonte
2021-05-14,LAZ,51169,23379,27790,32891,18278,ITI,ITI4,12,Lazio
2021-05-21,SAR,21142,10363,10779,15491,5651,ITG,ITG2,20,Sardegna
2021-02-08,VEN,4976,1541,3435,1929,3047,ITH,ITH3,5,Veneto
2021-04-02,PAB,2077,837,1240,720,1357,ITH,ITH1,4,Provincia Autonoma Bolzano / Bozen
2021-01-15,PIE,9114,3012,6102,9114,0,ITC,ITC1,1,Piemonte
2021-02-18,PUG,4378,1846,2532,3773,605,ITF,ITF4,16,Puglia
2021-03-18,LAZ,14226,6078,8148,7835,6391,ITI,ITI4,12,Lazio
2021-05-07,LOM,92251,43683,48568,69890,22361,ITC,ITC4,3,Lombardia
2021-03-06,PAT,786,277,509,635,151,ITH,ITH2,4,Provincia Autonoma Trento
2021-04-06,VEN,28926,13312,15614,23873,5053,ITH,ITH3,5,Veneto
2021-05-29,PAB,7133,3767,3366,3994,3139,ITH,ITH1,4,Provincia Autonoma Bolzano / Bozen
2021-01-28,MOL,613,217,396,17,596,ITF,ITF2,14,Molise
2021-03-13,PIE,13046,4722,8324,11601,1445,ITC,ITC1,1,Piemonte
2021-04-01,CAM,24677,12007,12670,20544,4133,ITF,ITF3,15,Campania
2021-03-18,LOM,27382,10953,16429,16149,11233,ITC,ITC4,3,Lombardia
2021-04-08,CAL,9387,4426,4961,5799,3588,ITF,ITF6,18,Calabria
2021-04-09,PUG,21969,9456,12513,17347,4622,ITF,ITF4,16,Puglia
2021-05-28,CAM,72958,35243,37715,26885,46073,ITF,ITF3,15,Campania
2021-02-10,CAL,2510,1079,1431,884,1626,ITF,ITF6,18,Calabria
2021-02-11,PUG,3697,1401,2296,2419,1278,ITF,ITF4,16,Puglia
2021-05-14,LOM,85854,41351,44503,55625,30229,ITC,ITC4,3,Lombardia
2021-03-12,MOL,1459,637,822,1423,36,ITF,ITF2,14,Molise
2021-04-11,PAT,2340,1135,1205,2249,91,ITH,ITH2,4,Provincia Autonoma Trento
2021-04-12,BAS,2169,1050,1119,1680,489,ITF,ITF5,17,Basilicata
2021-05-10,MAR,9448,4336,5112,4897,4551,ITI,ITI3,11,Marche
2021-05-22,PUG,34387,15742,18645,24037,10350,ITF,ITF4,16,Puglia
2021-01-14,MOL,646,239,407,646,0,ITF,ITF2,14,Molise
2021-03-14,MAR,2499,1032,1467,1907,592,ITI,ITI3,11,Marche
2021-06-04,CAL,17284,8031,9253,12752,4532,ITF,ITF6,18,Calabria
2021-01-20,SIC,791,404,387,531,260,ITG,ITG1,19,Sicilia
2021-04-18,FVG,6038,2800,3238,5631,407,ITH,ITH4,6,Friuli-Venezia Giulia
2021-04-19,ABR,6227,2858,3369,3855,2372,ITF,ITF1,13,Abruzzo
2021-01-08,FVG,2320,746,1574,2320,0,ITH,ITH4,6,Friuli-Venezia Giulia
2021-02-21,ABR,1218,550,668,1217,1,ITF,ITF1,13,Abruzzo
2021-05-26,TOS,35533,17065,18468,20382,15151,ITI,ITI1,9,Toscana
2021-06-14,FVG,9969,4818,5151,5215,4754,ITH,ITH4,6,Friuli-Venezia Giulia
2021-05-11,UMB,6240,2832,3408,4036,2204,ITI,ITI2,10,Umbria
2021-05-14,CAM,60898,27536,33362,36321,24577,ITF,ITF3,15,Campania
2021-03-30,TOS,17016,7640,9376,13453,3563,ITI,ITI1,9,Toscana
2021-05-21,CAL,21342,10864,10478,13974,7368,ITF,ITF6,18,Calabria
2021-02-20,FVG,2068,933,1135,1924,144,ITH,ITH4,6,Friuli-Venezia Giulia
2021-03-18,SIC,15284,7664,7620,9788,5496,ITG,ITG1,19,Sicilia
2021-06-15,ABR,10968,5404,5564,8566,2402,ITF,ITF1,13,Abruzzo
2021-01-22,FVG,90,30,60,0,90,ITH,ITH4,6,Friuli-Venezia Giulia
2021-02-01,VEN,8561,2502,6059,160,8401,ITH,ITH3,5,Veneto
2021-03-26,PAB,1656,732,924,523,1133,ITH,ITH1,4,Provincia Autonoma Bolzano / Bozen
2021-04-12,ABR,6214,2947,3267,5040,1174,ITF,ITF1,13,Abruzzo
2021-02-06,LIG,1892,768,1124,145,1747,ITC,ITC3,7,Liguria
2021-03-06,FVG,3500,1196,2304,3175,325,ITH,ITH4,6,Friuli-Venezia Giulia
2021-04-26,PUG,26244,12020,14224,23011,3233,ITF,ITF4,16,Puglia
2021-05-05,PIE,32195,15097,17098,19177,13018,ITC,ITC1,1,Piemonte
2021-05-31,SAR,11360,5405,5955,8253,3107,ITG,ITG2,20,Sardegna
2021-02-18,VEN,5828,2455,3373,5764,64,ITH,ITH3,5,Veneto
2021-03-25,VDA,389,154,235,379,10,ITC,ITC2,2,Valle d'Aosta / Vallée d'Aoste
2021-04-12,PAB,2105,946,1159,2098,7,ITH,ITH1,4,Provincia Autonoma Bolzano / Bozen
2021-06-14,EMR,40411,20849,19562,27414,12997,ITH,ITH5,8,Emilia-Romagna
2021-01-16,FVG,1230,360,870,1230,0,ITH,ITH4,6,Friuli-Venezia Giulia
2021-03-28,LAZ,18960,7645,11315,13650,5310,ITI,ITI4,12,Lazio
2021-03-30,UMB,3970,1725,2245,2438,1532,ITI,ITI2,10,Umbria
2021-02-16,TOS,9280,3340,5940,8559,721,ITI,ITI1,9,Toscana
2021-04-16,VEN,24436,10486,13950,12555,11881,ITH,ITH3,5,Veneto
2021-05-21,VDA,917,433,484,531,386,ITC,ITC2,2,Valle d'Aosta / Vallée d'Aoste
2021-04-18,SAR,5127,2225,2902,2258,2869,ITG,ITG2,20,Sardegna
2021-06-12,MAR,13397,7128,6269,12132,1265,ITI,ITI3,11,Marche
2020-12-27,UMB,86,45,41,86,0,ITI,ITI2,10,Umbria
2021-04-17,VDA,638,407,231,636,2,ITC,ITC2,2,Valle d'Aosta / Vallée d'Aoste
2021-05-02,TOS,11167,4931,6236,9204,1963,ITI,ITI1,9,Toscana
2021-01-08,SAR,3258,1184,2074,3258,0,ITG,ITG2,20,Sardegna
2021-04-16,MAR,10082,4702,5380,9557,525,ITI,ITI3,11,Marche
2021-01-07,VDA,276,111,165,276,0,ITC,ITC2,2,Valle d'Aosta / Vallée d'Aoste
2021-03-25,FVG,5523,2415,3108,3389,2134,ITH,ITH4,6,Friuli-Venezia Giulia
2021-06-14,LIG,14623,7086,7537,9225,5398,ITC,ITC3,7,Liguria
2021-02-27,CAM,13949,4473,9476,12307,1642,ITF,ITF3,15,Campania
2021-03-07,PAB,114,13,101,9,105,ITH,ITH1,4,Provincia Autonoma Bolzano / Bozen
2021-04-01,PAT,2898,1230,1668,1804,1094,ITH,ITH2,4,Provincia Autonoma Trento
2021-06-04,SIC,57582,26620,30962,45780,11802,ITG,ITG1,19,Sicilia
2021-03-06,CAL,8433,4344,4089,7639,794,ITF,ITF6,18,Calabria
2021-06-09,LAZ,69647,32813,36834,36297,33350,ITI,ITI4,12,Lazio
2021-02-19,VDA,292,102,190,268,24,ITC,ITC2,2,Valle d'Aosta / Vallée d'Aoste
2021-02-22,UMB,1889,807,1082,1803,86,ITI,ITI2,10,Umbria
2021-03-16,PUG,9871,4687,5184,3511,6360,ITF,ITF4,16,Puglia
2021-04-11,LOM,32210,13940,18270,24821,7389,ITC,ITC4,3,Lombardia
2021-06-16,CAM,30347,14345,16002,19607,10740,ITF,ITF3,15,Campania
2021-01-01,LOM,24,7,17,24,0,ITC,ITC4,3,Lombardia
2021-02-25,TOS,10633,4306,6327,9635,998,ITI,ITI1,9,Toscana
2021-06-07,LOM,98488,50175,48313,85202,13286,ITC,ITC4,3,Lombardia
2021-04-18,VEN,17512,7252,10260,9947,7565,ITH,ITH3,5,Veneto
2021-02-27,LOM,13944,5869,8075,13303,641,ITC,ITC4,3,Lombardia
2021-04-21,PAB,3012,1468,1544,2164,848,ITH,ITH1,4,Provincia Autonoma Bolzano / Bozen
2021-04-28,PUG,19765,8857,10908,15012,4753,ITF,ITF4,16,Puglia
2021-03-17,ABR,4539,1873,2666,2799,1740,ITF,ITF1,13,Abruzzo
2021-03-31,MOL,2193,919,1274,1374,819,ITF,ITF2,14,Molise
2021-02-25,LIG,3457,1349,2108,3327,130,ITC,ITC3,7,Liguria
2021-06-02,SAR,9784,4690,5094,8143,1641,ITG,ITG2,20,Sardegna
2021-01-10,EMR,7171,2684,4487,7171,0,ITH,ITH5,8,Emilia-Romagna
2021-06-16,EMR,44879,22912,21967,25111,19768,ITH,ITH5,8,Emilia-Romagna
2021-04-06,SIC,17682,8462,9220,13400,4282,ITG,ITG1,19,Sicilia
2021-01-20,TOS,1331,637,694,1083,248,ITI,ITI1,9,Toscana
2021-03-08,EMR,12222,5097,7125,9546,2676,ITH,ITH5,8,Emilia-Romagna
2021-03-23,PAT,2446,944,1502,1706,740,ITH,ITH2,4,Provincia Autonoma Trento
2021-01-04,MAR,1509,570,939,1509,0,ITI,ITI3,11,Marche
2021-03-30,FVG,7190,3226,3964,6267,923,ITH,ITH4,6,Friuli-Venezia Giulia
2021-04-20,SAR,10995,4993,6002,7780,3215,ITG,ITG2,20,Sardegna
2020-12-30,LOM,114,42,72,114,0,ITC,ITC4,3,Lombardia
2021-01-08,VEN,9405,2835,6570,9405,0,ITH,ITH3,5,Veneto
2021-04-30,TOS,40186,17778,22408,20333,19853,ITI,ITI1,9,Toscana
2021-02-22,SIC,7890,4093,3797,7399,491,ITG,ITG1,19,Sicilia
2021-01-05,VDA,150,54,96,150,0,ITC,ITC2,2,Valle d'Aosta / Vallée d'Aoste
2020-12-27,SIC,92,55,37,92,0,ITG,ITG1,19,Sicilia
2021-06-02,SIC,35246,16287,18959,27475,7771,ITG,ITG1,19,Sicilia
2021-05-09,CAL,9619,4483,5136,6086,3533,ITF,ITF6,18,Calabria
2021-04-27,LAZ,30697,13857,16840,19851,10846,ITI,ITI4,12,Lazio
2021-04-29,BAS,4831,2385,2446,4410,421,ITF,ITF5,17,Basilicata
2021-05-02,CAM,43494,21540,21954,32139,11355,ITF,ITF3,15,Campania
2021-01-09,PAB,612,326,286,612,0,ITH,ITH1,4,Provincia Autonoma Bolzano / Bozen
2021-05-28,PAT,3716,1735,1981,1492,2224,ITH,ITH2,4,Provincia Autonoma Trento
2021-01-22,CAM,1525,776,749,673,852,ITF,ITF3,15,Campania
2021-03-01,LAZ,17113,7365,9748,13228,3885,ITI,ITI4,12,Lazio
2021-06-11,UMB,6896,3461,3435,6131,765,ITI,ITI2,10,Umbria
2021-01-14,VDA,237,69,168,237,0,ITC,ITC2,2,Valle d'Aosta / Vallée d'Aoste
2021-01-25,PAT,818,215,603,24,794,ITH,ITH2,4,Provincia Autonoma Trento
2021-03-17,BAS,1453,609,844,28,1425,ITF,ITF5,17,Basilicata
2021-04-14,MAR,10214,4563,5651,9842,372,ITI,ITI3,11,Marche
2021-01-29,CAL,2051,989,1062,230,1821,ITF,ITF6,18,Calabria
2021-01-09,PUG,4887,2250,2637,4887,0,ITF,ITF4,16,Puglia
2021-01-19,BAS,199,84,115,199,0,ITF,ITF5,17,Basilicata
2021-06-16,LOM,98397,49996,48401,50571,47826,ITC,ITC4,3,Lombardia
2021-03-25,PAT,2874,1104,1770,1825,1049,ITH,ITH2,4,Provincia Autonoma Trento
2021-03-24,ABR,6384,2784,3600,4133,2251,ITF,ITF1,13,Abruzzo
2021-04-24,VDA,722,400,322,555,167,ITC,ITC2,2,Valle d'Aosta / Vallée d'Aoste
2020-12-30,MAR,17,5,12,17,0,ITI,ITI3,11,Marche
2021-01-13,VEN,5986,1607,4379,5986,0,ITH,ITH3,5,Veneto
2021-02-22,LAZ,11459,4992,6467,10957,502,ITI,ITI4,12,Lazio
2021-04-25,TOS,11054,5248,5806,8917,2137,ITI,ITI1,9,Toscana
2021-03-30,PIE,16894,7035,9859,9021,7873,ITC,ITC1,1,Piemonte
2021-02-09,ABR,909,312,597,500,409,ITF,ITF1,13,Abruzzo
2021-06-02,LAZ,43226,21477,21749,31735,11491,ITI,ITI4,12,Lazio
2021-02-23,MOL,582,223,359,363,219,ITF,ITF2,14,Molise
2021-03-06,CAM,16371,6814,9557,10702,5669,ITF,ITF3,15,Campania
2021-05-04,CAL,16353,7528,8825,11717,4636,ITF,ITF6,18,Calabria
2021-06-11,LAZ,68678,32135,36543,36742,31936,ITI,ITI4,12,Lazio
2021-06-03,MOL,3290,1565,1725,2736,554,ITF,ITF2,14,Molise
2021-03-01,SIC,12691,6012,6679,11037,1654,ITG,ITG1,19,Sicilia
2021-04-07,MOL,1688,847,841,1413,275,ITF,ITF2,14,Molise
2021-03-04,LIG,4738,2118,2620,3891,847,ITC,ITC3,7,Liguria
2021-03-06,LOM,21317,9092,12225,16805,4512,ITC,ITC4,3,Lombardia
2021-05-05,LOM,87882,41904,45978,72580,15302,ITC,ITC4,3,Lombardia
2021-03-13,VDA,147,88,59,147,0,ITC,ITC2,2,Valle d'Aosta / Vallée d'Aoste
2021-03-28,TOS,6212,2808,3404,5958,254,ITI,ITI1,9,Toscana
2021-05-29,PAT,2233,1165,1068,840,1393,ITH,ITH2,4,Provincia Autonoma Trento
2021-02-11,FVG,1930,664,1266,1738,192,ITH,ITH4,6,Friuli-Venezia Giulia
2021-03-02,LAZ,17193,7609,9584,13259,3934,ITI,ITI4,12,Lazio
2021-03-12,MAR,4640,1972,2668,3402,1238,ITI,ITI3,11,Marche
2021-01-30,TOS,4622,1622,3000,198,4424,ITI,ITI1,9,Toscana
2021-04-02,PAT,2841,1155,1686,2166,675,ITH,ITH2,4,Provincia Autonoma Trento
2021-01-14,MAR,2010,692,1318,2010,0,ITI,ITI3,11,Marche
2021-04-09,FVG,7891,3646,4245,6647,1244,ITH,ITH4,6,Friuli-Venezia Giulia
2021-05-23,BAS,4517,2302,2215,1533,2984,ITF,ITF5,17,Basilicata
2021-06-20,MAR,7913,3979,3934,3926,3987,ITI,ITI3,11,Marche
2021-04-16,PAT,2857,1354,1503,2712,145,ITH,ITH2,4,Provincia Autonoma Trento
2021-05-10,TOS,26186,12384,13802,15567,10619,ITI,ITI1,9,Toscana
2021-01-18,LAZ,6267,2557,3710,5289,978,ITI,ITI4,12,Lazio
2021-04-25,UMB,4364,1685,2679,4282,82,ITI,ITI2,10,Umbria
2021-01-15,VDA,218,82,136,218,0,ITC,ITC2,2,Valle d'Aosta / Vallée d'Aoste
2021-02-18,PAT,1208,426,782,1146,62,ITH,ITH2,4,Provincia Autonoma Trento
2021-03-14,TOS,7174,2569,4605,3239,3935,ITI,ITI1,9,Toscana
2021-03-31,PUG,14485,6761,7724,8927,5558,ITF,ITF4,16,Puglia
2021-04-28,LAZ,32912,15023,17889,21349,11563,ITI,ITI4,12,Lazio
2021-03-07,VEN,4488,1767,2721,3926,562,ITH,ITH3,5,Veneto
2021-04-29,PAB,2630,1351,1279,1936,694,ITH,ITH1,4,Provincia Autonoma Bolzano / Bozen
2021-05-19,CAL,18347,9085,9262,11359,6988,ITF,ITF6,18,Calabria
2021-01-14,LIG,2981,1055,1926,2981,0,ITC,ITC3,7,Liguria
2021-02-02,PUG,4346,1847,2499,593,3753,ITF,ITF4,16,Puglia
2021-05-12,CAM,40870,19941,20929,31719,9151,ITF,ITF3,15,Campania
2021-01-19,PAB,853,371,482,723,130,ITH,ITH1,4,Provincia Autonoma Bolzano / Bozen
2021-03-03,MOL,672,316,356,590,82,ITF,ITF2,14,Molise
2021-03-23,CAL,5231,2450,2781,3423,1808,ITF,ITF6,18,Calabria
2021-05-03,VEN,40660,19789,20871,34225,6435,ITH,ITH3,5,Veneto
2021-05-13,PUG,38591,17211,21380,21471,17120,ITF,ITF4,16,Puglia
2021-01-05,MOL,449,180,269,449,0,ITF,ITF2,14,Molise
2020-12-30,FVG,626,244,382,626,0,ITH,ITH4,6,Friuli-Venezia Giulia
2021-03-17,PUG,10343,4700,5643,4170,6173,ITF,ITF4,16,Puglia
2021-03-27,BAS,2242,859,1383,1818,424,ITF,ITF5,17,Basilicata
2021-04-21,SAR,12075,5558,6517,6542,5533,ITG,ITG2,20,Sardegna
2021-04-24,MAR,12022,5303,6719,7558,4464,ITI,ITI3,11,Marche
2021-06-05,FVG,10286,5315,4971,8738,1548,ITH,ITH4,6,Friuli-Venezia Giulia
2021-01-11,SAR,1183,505,678,1183,0,ITG,ITG2,20,Sardegna
2021-02-25,FVG,3164,1651,1513,3135,29,ITH,ITH4,6,Friuli-Venezia Giulia
2021-02-26,MAR,3628,1498,2130,3152,476,ITI,ITI3,11,Marche
2021-03-12,LIG,6215,2871,3344,3745,2470,ITC,ITC3,7,Liguria
2021-06-17,SAR,18424,8516,9908,10034,8390,ITG,ITG2,20,Sardegna
2021-03-27,LAZ,26185,10541,15644,19712,6473,ITI,ITI4,12,Lazio
2021-02-09,PAB,317,126,191,1,316,ITH,ITH1,4,Provincia Autonoma Bolzano / Bozen
2021-03-31,VDA,555,302,253,529,26,ITC,ITC2,2,Valle d'Aosta / Vallée d'Aoste
2021-04-17,ABR,7346,3398,3948,4293,3053,ITF,ITF1,13,Abruzzo
2021-05-19,LIG,13570,5962,7608,10451,3119,ITC,ITC3,7,Liguria
2021-06-16,FVG,11867,5776,6091,4037,7830,ITH,ITH4,6,Friuli-Venezia Giulia
2021-01-25,SAR,591,214,377,22,569,ITG,ITG2,20,Sardegna
2021-02-19,ABR,3300,1551,1749,3200,100,ITF,ITF1,13,Abruzzo
2021-03-23,LIG,9266,4218,5048,6057,3209,ITC,ITC3,7,Liguria
2021-05-23,LAZ,47075,22835,24240,39696,7379,ITI,ITI4,12,Lazio
2021-05-27,VDA,1089,497,592,586,503,ITC,ITC2,2,Valle d'Aosta / Vallée d'Aoste
2021-05-13,VDA,1139,556,583,540,599,ITC,ITC2,2,Valle d'Aosta / Vallée d'Aoste
2021-05-12,MAR,10424,4686,5738,4922,5502,ITI,ITI3,11,Marche
2021-05-28,VEN,46541,22796,23745,24813,21728,ITH,ITH3,5,Veneto
2021-01-07,BAS,640,319,321,640,0,ITF,ITF5,17,Basilicata
2021-01-06,PAT,42,13,29,42,0,ITH,ITH2,4,Provincia Autonoma Trento
2021-01-18,LOM,9196,2969,6227,8221,975,ITC,ITC4,3,Lombardia
2021-02-02,VDA,272,70,202,2,270,ITC,ITC2,2,Valle d'Aosta / Vallée d'Aoste
2021-05-09,LAZ,37535,17255,20280,26265,11270,ITI,ITI4,12,Lazio
2021-05-16,SAR,8225,3834,4391,6065,2160,ITG,ITG2,20,Sardegna
2021-01-13,PIE,10085,3226,6859,10085,0,ITC,ITC1,1,Piemonte
2021-06-16,PIE,40009,20064,19945,23813,16196,ITC,ITC1,1,Piemonte
2021-05-10,MOL,2889,1285,1604,2516,373,ITF,ITF2,14,Molise
2021-03-23,LOM,42561,15461,27100,29702,12859,ITC,ITC4,3,Lombardia
2021-05-03,MOL,2484,1164,1320,2321,163,ITF,ITF2,14,Molise
2021-05-16,SIC,33136,16138,16998,21813,11323,ITG,ITG1,19,Sicilia
2021-02-15,CAL,1144,542,602,994,150,ITF,ITF6,18,Calabria
2021-03-06,UMB,4317,1154,3163,4174,143,ITI,ITI2,10,Umbria
2021-03-25,EMR,21470,9413,12057,14481,6989,ITH,ITH5,8,Emilia-Romagna
2021-02-19,BAS,1623,738,885,1561,62,ITF,ITF5,17,Basilicata
2021-05-21,EMR,39186,17512,21674,22208,16978,ITH,ITH5,8,Emilia-Romagna
2021-01-22,UMB,276,105,171,32,244,ITI,ITI2,10,Umbria
2021-05-02,SIC,24600,11426,13174,18000,6600,ITG,ITG1,19,Sicilia
2021-02-10,EMR,4022,1385,2637,2766,1256,ITH,ITH5,8,Emilia-Romagna
2021-01-07,ABR,1604,553,1051,1604,0,ITF,ITF1,13,Abruzzo
2021-05-02,UMB,3787,1868,1919,1333,2454,ITI,ITI2,10,Umbria
2021-04-08,EMR,31208,14331,16877,25905,5303,ITH,ITH5,8,Emilia-Romagna
2021-03-20,SIC,18573,8967,9606,13436,5137,ITG,ITG1,19,Sicilia
2021-02-08,CAM,5113,2449,2664,4310,803,ITF,ITF3,15,Campania
2021-03-20,UMB,2308,842,1466,2283,25,ITI,ITI2,10,Umbria
2021-02-06,TOS,4527,1550,2977,1294,3233,ITI,ITI1,9,Toscana
2021-02-02,PAB,1745,506,1239,8,1737,ITH,ITH1,4,Provincia Autonoma Bolzano / Bozen
2021-05-16,LAZ,50921,24518,26403,37438,13483,ITI,ITI4,12,Lazio
2021-02-01,LIG,2557,922,1635,90,2467,ITC,ITC3,7,Liguria
2021-05-20,VDA,807,363,444,367,440,ITC,ITC2,2,Valle d'Aosta / Vallée d'Aoste
2021-04-27,FVG,8101,3718,4383,3626,4475,ITH,ITH4,6,Friuli-Venezia Giulia
2021-05-12,LIG,12015,5442,6573,6676,5339,ITC,ITC3,7,Liguria
2021-01-06,PIE,3116,1111,2005,3116,0,ITC,ITC1,1,Piemonte
2021-05-26,LIG,16655,8408,8247,12282,4373,ITC,ITC3,7,Liguria
2021-03-24,VDA,515,230,285,258,257,ITC,ITC2,2,Valle d'Aosta / Vallée d'Aoste
2021-03-30,LIG,12188,5418,6770,8800,3388,ITC,ITC3,7,Liguria
2021-05-17,MOL,2228,1092,1136,1732,496,ITF,ITF2,14,Molise
2021-02-15,BAS,622,232,390,580,42,ITF,ITF5,17,Basilicata
2021-05-08,LIG,7529,3334,4195,2316,5213,ITC,ITC3,7,Liguria
2021-01-09,VEN,7928,2539,5389,7928,0,ITH,ITH3,5,Veneto
2021-01-29,BAS,616,231,385,63,553,ITF,ITF5,17,Basilicata
2021-05-26,CAM,52595,25778,26817,21548,31047,ITF,ITF3,15,Campania
2021-01-23,PAB,197,117,80,0,197,ITH,ITH1,4,Provincia Autonoma Bolzano / Bozen
2021-01-25,LIG,2725,888,1837,478,2247,ITC,ITC3,7,Liguria
2021-04-03,UMB,2112,717,1395,1059,1053,ITI,ITI2,10,Umbria
2021-03-18,VEN,12611,5137,7474,7385,5226,ITH,ITH3,5,Veneto
2021-05-05,LIG,13717,6135,7582,5296,8421,ITC,ITC3,7,Liguria
2021-06-14,SAR,13733,6633,7100,10124,3609,ITG,ITG2,20,Sardegna
2021-03-06,SAR,2638,1079,1559,858,1780,ITG,ITG2,20,Sardegna
2021-02-27,SIC,12237,5502,6735,11033,1204,ITG,ITG1,19,Sicilia
2021-03-11,FVG,3474,1515,1959,1723,1751,ITH,ITH4,6,Friuli-Venezia Giulia
2021-05-27,ABR,12989,5920,7069,8308,4681,ITF,ITF1,13,Abruzzo
2021-05-03,PAB,1830,847,983,417,1413,ITH,ITH1,4,Provincia Autonoma Bolzano / Bozen
2021-03-05,BAS,1855,857,998,1109,746,ITF,ITF5,17,Basilicata
2021-06-02,PIE,26530,12998,13532,22061,4469,ITC,ITC1,1,Piemonte
2021-02-23,PAB,769,324,445,763,6,ITH,ITH1,4,Provincia Autonoma Bolzano / Bozen
2021-02-04,MAR,2383,841,1542,112,2271,ITI,ITI3,11,Marche
2021-02-22,PIE,8483,3472,5011,7893,590,ITC,ITC1,1,Piemonte
2021-06-13,BAS,3011,1438,1573,2703,308,ITF,ITF5,17,Basilicata
2021-04-13,PAT,2555,1058,1497,2048,507,ITH,ITH2,4,Provincia Autonoma Trento
2021-01-20,PAT,291,73,218,279,12,ITH,ITH2,4,Provincia Autonoma Trento
2021-05-17,PAB,3139,1516,1623,2445,694,ITH,ITH1,4,Provincia Autonoma Bolzano / Bozen
2021-03-02,PUG,16386,6091,10295,15085,1301,ITF,ITF4,16,Puglia
2021-04-06,SAR,7457,3122,4335,5028,2429,ITG,ITG2,20,Sardegna
2021-04-25,LOM,51493,23612,27881,46750,4743,ITC,ITC4,3,Lombardia
2021-03-13,LAZ,21727,8668,13059,15833,5894,ITI,ITI4,12,Lazio
2021-03-17,VDA,433,185,248,273,160,ITC,ITC2,2,Valle d'Aosta / Vallée d'Aoste
2021-04-30,PAT,4925,2401,2524,4774,151,ITH,ITH2,4,Provincia Autonoma Trento
2020-12-27,SAR,65,34,31,65,0,ITG,ITG2,20,Sardegna
2021-03-11,PIE,13780,5079,8701,10683,3097,ITC,ITC1,1,Piemonte
2021-06-03,PAB,4721,2565,2156,3775,946,ITH,ITH1,4,Provincia Autonoma Bolzano / Bozen
2021-06-10,PUG,46479,22829,23650,29665,16814,ITF,ITF4,16,Puglia
2021-03-03,VDA,255,118,137,187,68,ITC,ITC2,2,Valle d'Aosta / Vallée d'Aoste
2021-04-06,CAM,24525,11569,12956,20001,4524,ITF,ITF3,15,Campania
2021-05-19,PAT,5097,2455,2642,3842,1255,ITH,ITH2,4,Provincia Autonoma Trento
2021-04-04,PUG,5962,2962,3000,5957,5,ITF,ITF4,16,Puglia
2020-12-27,CAM,720,422,298,720,0,ITF,ITF3,15,Campania
2021-03-19,ABR,5794,2584,3210,2774,3020,ITF,ITF1,13,Abruzzo
2021-05-23,CAL,11382,5550,5832,7032,4350,ITF,ITF6,18,Calabria
2021-02-08,SIC,3882,1678,2204,2129,1753,ITG,ITG1,19,Sicilia
2021-01-18,MAR,696,237,459,547,149,ITI,ITI3,11,Marche
2021-03-01,CAL,2724,1546,1178,2269,455,ITF,ITF6,18,Calabria
2021-03-25,PIE,17062,7203,9859,8423,8639,ITC,ITC1,1,Piemonte
2021-05-27,BAS,3603,1856,1747,1072,2531,ITF,ITF5,17,Basilicata
2021-01-08,UMB,1190,345,845,1190,0,ITI,ITI2,10,Umbria
2021-01-09,MOL,450,152,298,450,0,ITF,ITF2,14,Molise
2021-04-20,CAM,32038,15501,16537,20728,11310,ITF,ITF3,15,Campania
2021-03-21,PUG,2694,1227,1467,590,2104,ITF,ITF4,16,Puglia
2021-04-06,LOM,43054,17582,25472,25120,17934,ITC,ITC4,3,Lombardia
2021-04-28,MAR,10735,4891,5844,6003,4732,ITI,ITI3,11,Marche
2021-06-09,CAL,17496,8213,9283,15266,2230,ITF,ITF6,18,Calabria
2021-03-05,ABR,5348,1958,3390,4651,697,ITF,ITF1,13,Abruzzo
2021-04-19,MOL,1827,842,985,1049,778,ITF,ITF2,14,Molise
2021-02-20,TOS,4640,1789,2851,4127,513,ITI,ITI1,9,Toscana
2021-04-13,FVG,7366,3290,4076,5762,1604,ITH,ITH4,6,Friuli-Venezia Giulia
2021-01-03,FVG,312,122,190,312,0,ITH,ITH4,6,Friuli-Venezia Giulia
2021-05-31,TOS,30262,14594,15668,19445,10817,ITI,ITI1,9,Toscana
2021-03-20,CAM,13986,6525,7461,10247,3739,ITF,ITF3,15,Campania
2021-06-04,EMR,45433,22888,22545,37360,8073,ITH,ITH5,8,Emilia-Romagna
2021-01-22,SIC,1253,632,621,243,1010,ITG,ITG1,19,Sicilia
2021-05-14,TOS,33295,15393,17902,20645,12650,ITI,ITI1,9,Toscana
2021-05-07,VEN,48456,23216,25240,39790,8666,ITH,ITH3,5,Veneto
2021-03-16,LIG,6082,2731,3351,2349,3733,ITC,ITC3,7,Liguria
2021-05-23,UMB,5069,1855,3214,652,4417,ITI,ITI2,10,Umbria
2021-01-27,VEN,7141,2064,5077,241,6900,ITH,ITH3,5,Veneto
2021-02-08,LAZ,9740,4153,5587,4508,5232,ITI,ITI4,12,Lazio
2021-04-25,SAR,4497,2269,2228,3718,779,ITG,ITG2,20,Sardegna
2021-01-08,SIC,8105,3776,4329,8105,0,ITG,ITG1,19,Sicilia
2021-01-20,FVG,748,320,428,13,735,ITH,ITH4,6,Friuli-Venezia Giulia
2021-04-07,ABR,7225,3333,3892,4438,2787,ITF,ITF1,13,Abruzzo
2021-01-15,SAR,1563,573,990,1563,0,ITG,ITG2,20,Sardegna
2021-04-18,SIC,19706,9849,9857,15346,4360,ITG,ITG1,19,Sicilia
2021-03-14,PAB,758,336,422,25,733,ITH,ITH1,4,Provincia Autonoma Bolzano / Bozen
2021-02-01,SAR,1524,605,919,225,1299,ITG,ITG2,20,Sardegna
2021-04-14,PAB,3593,1645,1948,3502,91,ITH,ITH1,4,Provincia Autonoma Bolzano / Bozen
2021-01-26,VDA,139,48,91,0,139,ITC,ITC2,2,Valle d'Aosta / Vallée d'Aoste
2021-04-24,BAS,4544,2197,2347,3531,1013,ITF,ITF5,17,Basilicata
2021-05-02,LAZ,32632,14337,18295,23270,9362,ITI,ITI4,12,Lazio
2021-05-09,SAR,6129,2874,3255,5203,926,ITG,ITG2,20,Sardegna
2021-01-04,PAB,508,201,307,508,0,ITH,ITH1,4,Provincia Autonoma Bolzano / Bozen
2021-01-11,PUG,3754,1588,2166,3754,0,ITF,ITF4,16,Puglia
2021-02-12,VDA,263,96,167,217,46,ITC,ITC2,2,Valle d'Aosta / Vallée d'Aoste
2021-06-02,PAT,2838,1359,1479,944,1894,ITH,ITH2,4,Provincia Autonoma Trento
2021-06-14,LOM,94108,47832,46276,49684,44424,ITC,ITC4,3,Lombardia
2021-03-26,MAR,6332,2606,3726,3524,2808,ITI,ITI3,11,Marche
2021-04-13,PIE,25931,11610,14321,22471,3460,ITC,ITC1,1,Piemonte
2021-04-21,PUG,23080,10652,12428,19346,3734,ITF,ITF4,16,Puglia
2021-05-26,SAR,14911,7652,7259,9873,5038,ITG,ITG2,20,Sardegna
2021-02-13,VEN,3266,1473,1793,3246,20,ITH,ITH3,5,Veneto
2021-01-20,PIE,6617,2089,4528,5899,718,ITC,ITC1,1,Piemonte
2021-02-15,SAR,958,349,609,927,31,ITG,ITG2,20,Sardegna
2021-01-22,LAZ,4005,1635,2370,490,3515,ITI,ITI4,12,Lazio
2021-03-11,PAT,2298,851,1447,1474,824,ITH,ITH2,4,Provincia Autonoma Trento
2021-01-20,EMR,1325,270,1055,1324,1,ITH,ITH5,8,Emilia-Romagna
2021-04-16,LOM,53625,23907,29718,39287,14338,ITC,ITC4,3,Lombardia
2021-05-08,MAR,12267,5476,6791,5021,7246,ITI,ITI3,11,Marche
2021-06-19,CAL,15609,7302,8307,8311,7298,ITF,ITF6,18,Calabria
2021-01-11,PIE,8744,2980,5764,8744,0,ITC,ITC1,1,Piemonte
2021-02-06,SAR,1971,698,1273,569,1402,ITG,ITG2,20,Sardegna
2021-04-29,MOL,2237,1144,1093,890,1347,ITF,ITF2,14,Molise
2021-05-03,LOM,83654,39737,43917,71532,12122,ITC,ITC4,3,Lombardia
2021-04-23,FVG,7463,3377,4086,3602,3861,ITH,ITH4,6,Friuli-Venezia Giulia
2021-01-11,EMR,9348,3274,6074,9348,0,ITH,ITH5,8,Emilia-Romagna
2021-01-23,LOM,1115,357,758,916,199,ITC,ITC4,3,Lombardia
2021-02-23,SAR,1537,1026,511,1285,252,ITG,ITG2,20,Sardegna
2021-04-12,MOL,1299,557,742,1048,251,ITF,ITF2,14,Molise
2021-06-10,TOS,26301,13482,12819,25788,513,ITI,ITI1,9,Toscana
2021-05-24,TOS,33708,16696,17012,24140,9568,ITI,ITI1,9,Toscana
2021-06-17,LIG,16125,7651,8474,10427,5698,ITC,ITC3,7,Liguria
2021-01-19,PUG,1221,452,769,1211,10,ITF,ITF4,16,Puglia
2021-02-15,LAZ,8026,3540,4486,7395,631,ITI,ITI4,12,Lazio
2021-01-25,TOS,5126,1895,3231,247,4879,ITI,ITI1,9,Toscana
2021-01-29,LAZ,8042,3079,4963,813,7229,ITI,ITI4,12,Lazio
2021-03-18,PAT,2320,957,1363,1240,1080,ITH,ITH2,4,Provincia Autonoma Trento
2021-03-21,PAB,768,285,483,14,754,ITH,ITH1,4,Provincia Autonoma Bolzano / Bozen
2021-01-09,MAR,1710,605,1105,1710,0,ITI,ITI3,11,Marche
2021-04-30,VEN,49981,23472,26509,34320,15661,ITH,ITH3,5,Veneto
2021-06-12,PAB,4888,2651,2237,1602,3286,ITH,ITH1,4,Provincia Autonoma Bolzano / Bozen
2021-04-06,PIE,20241,8810,11431,15045,5196,ITC,ITC1,1,Piemonte
2021-05-02,SAR,5886,2669,3217,5305,581,ITG,ITG2,20,Sardegna
2021-05-30,UMB,5981,2998,2983,5780,201,ITI,ITI2,10,Umbria
2021-01-20,VEN,1038,368,670,386,652,ITH,ITH3,5,Veneto
2021-04-18,TOS,8357,4090,4267,7342,1015,ITI,ITI1,9,Toscana
2020-12-27,PIE,913,369,544,913,0,ITC,ITC1,1,Piemonte
2021-04-02,MAR,6886,2983,3903,6147,739,ITI,ITI3,11,Marche
2021-05-14,CAL,19920,9581,10339,13046,6874,ITF,ITF6,18,Calabria
2021-03-08,UMB,3702,1829,1873,2339,1363,ITI,ITI2,10,Umbria
2021-06-09,PAT,6232,3075,3157,2161,4071,ITH,ITH2,4,Provincia Autonoma Trento
2021-06-16,SIC,39329,18305,21024,20906,18423,ITG,ITG1,19,Sicilia
2021-01-14,PAB,1946,575,1371,1946,0,ITH,ITH1,4,Provincia Autonoma Bolzano / Bozen
2021-02-08,SAR,1470,533,937,856,614,ITG,ITG2,20,Sardegna
2021-03-16,MAR,3471,1485,1986,290,3181,ITI,ITI3,11,Marche
2021-04-27,CAL,9950,4891,5059,8003,1947,ITF,ITF6,18,Calabria
2021-06-16,UMB,6306,3085,3221,3217,3089,ITI,ITI2,10,Umbria
2021-01-19,VDA,256,77,179,256,0,ITC,ITC2,2,Valle d'Aosta / Vallée d'Aoste
2021-03-25,SIC,20340,9453,10887,14875,5465,ITG,ITG1,19,Sicilia
2021-04-07,PAB,1798,823,975,1258,540,ITH,ITH1,4,Provincia Autonoma Bolzano / Bozen
2021-02-03,CAL,2773,1432,1341,578,2195,ITF,ITF6,18,Calabria
2021-03-25,UMB,3904,1699,2205,2840,1064,ITI,ITI2,10,Umbria
2021-06-02,LIG,8530,4342,4188,5363,3167,ITC,ITC3,7,Liguria
2021-01-04,PUG,4508,2016,2492,4508,0,ITF,ITF4,16,Puglia
2021-04-12,VDA,486,186,300,323,163,ITC,ITC2,2,Valle d'Aosta / Vallée d'Aoste
2021-04-29,VDA,1291,634,657,757,534,ITC,ITC2,2,Valle d'Aosta / Vallée d'Aoste
2021-06-02,CAM,42739,20107,22632,38109,4630,ITF,ITF3,15,Campania
2021-06-19,LIG,7081,3622,3459,5620,1461,ITC,ITC3,7,Liguria
2021-02-17,LAZ,9183,4605,4578,8309,874,ITI,ITI4,12,Lazio
2021-02-22,CAM,10680,3294,7386,10417,263,ITF,ITF3,15,Campania
2021-03-02,PAB,695,200,495,693,2,ITH,ITH1,4,Provincia Autonoma Bolzano / Bozen
2021-03-07,MOL,1132,501,631,1130,2,ITF,ITF2,14,Molise
2021-04-06,PAT,2261,950,1311,1496,765,ITH,ITH2,4,Provincia Autonoma Trento
2021-04-17,BAS,3461,1655,1806,2199,1262,ITF,ITF5,17,Basilicata
2021-05-28,LAZ,56648,26217,30431,43641,13007,ITI,ITI4,12,Lazio
2021-06-15,MOL,2077,974,1103,639,1438,ITF,ITF2,14,Molise
2021-03-11,CAM,17997,9056,8941,10718,7279,ITF,ITF3,15,Campania
2021-03-19,PAB,1906,773,1133,799,1107,ITH,ITH1,4,Provincia Autonoma Bolzano / Bozen
2021-06-02,LOM,84621,43570,41051,78294,6327,ITC,ITC4,3,Lombardia
2021-03-06,SIC,12638,5058,7580,9856,2782,ITG,ITG1,19,Sicilia
2021-06-09,FVG,10969,5759,5210,9671,1298,ITH,ITH4,6,Friuli-Venezia Giulia
2021-03-11,LOM,36205,13473,22732,26300,9905,ITC,ITC4,3,Lombardia
2021-05-16,CAM,51146,23226,27920,33574,17572,ITF,ITF3,15,Campania
2021-06-11,EMR,44783,23260,21523,38305,6478,ITH,ITH5,8,Emilia-Romagna
2021-02-20,CAM,8573,3080,5493,8270,303,ITF,ITF3,15,Campania
2021-03-29,BAS,2434,880,1554,2147,287,ITF,ITF5,17,Basilicata
2021-03-27,UMB,4253,1512,2741,3913,340,ITI,ITI2,10,Umbria
2021-06-17,MOL,2222,991,1231,932,1290,ITF,ITF2,14,Molise
2021-06-14,SIC,42260,20108,22152,27580,14680,ITG,ITG1,19,Sicilia
2021-01-05,BAS,946,409,537,946,0,ITF,ITF5,17,Basilicata
2021-03-01,FVG,2957,1041,1916,2905,52,ITH,ITH4,6,Friuli-Venezia Giulia
2021-03-20,EMR,16088,6831,9257,9124,6964,ITH,ITH5,8,Emilia-Romagna
2021-03-18,FVG,3372,1421,1951,1691,1681,ITH,ITH4,6,Friuli-Venezia Giulia
2021-03-26,PUG,11916,5762,6154,7272,4644,ITF,ITF4,16,Puglia
2021-05-28,SIC,51189,22950,28239,24717,26472,ITG,ITG1,19,Sicilia
2021-06-16,VEN,46965,23155,23810,25837,21128,ITH,ITH3,5,Veneto
2021-03-09,PUG,13591,6066,7525,11581,2010,ITF,ITF4,16,Puglia
2021-04-06,EMR,24785,11195,13590,20043,4742,ITH,ITH5,8,Emilia-Romagna
2021-01-01,VEN,1528,471,1057,1528,0,ITH,ITH3,5,Veneto
2021-01-13,PAT,421,123,298,421,0,ITH,ITH2,4,Provincia Autonoma Trento
2020-12-27,EMR,972,373,599,972,0,ITH,ITH5,8,Emilia-Romagna
2021-02-18,LIG,2765,1126,1639,2431,334,ITC,ITC3,7,Liguria
2021-03-06,LAZ,18354,7082,11272,14097,4257,ITI,ITI4,12,Lazio
2021-03-25,VEN,25950,11054,14896,19851,6099,ITH,ITH3,5,Veneto
2021-06-09,PIE,38475,20291,18184,35792,2683,ITC,ITC1,1,Piemonte
2021-02-03,CAM,8903,4003,4900,878,8025,ITF,ITF3,15,Campania
2021-04-11,VEN,21009,8876,12133,14702,6307,ITH,ITH3,5,Veneto
2021-06-20,BAS,3006,1422,1584,1375,1631,ITF,ITF5,17,Basilicata
2021-01-11,MAR,1176,411,765,1176,0,ITI,ITI3,11,Marche
2021-02-22,CAL,2041,1034,1007,1483,558,ITF,ITF6,18,Calabria
2021-03-18,PIE,11759,4805,6954,4029,7730,ITC,ITC1,1,Piemonte
2021-04-14,PUG,31875,15049,16826,28568,3307,ITF,ITF4,16,Puglia
2021-05-07,TOS,32112,14687,17425,12002,20110,ITI,ITI1,9,Toscana
2021-03-28,PUG,3534,1652,1882,1209,2325,ITF,ITF4,16,Puglia
2021-03-20,LAZ,18979,7467,11512,13094,5885,ITI,ITI4,12,Lazio
2021-05-07,PAT,5992,3083,2909,5153,839,ITH,ITH2,4,Provincia Autonoma Trento
2021-05-14,SIC,52016,24377,27639,36326,15690,ITG,ITG1,19,Sicilia
2021-02-16,PAB,530,205,325,530,0,ITH,ITH1,4,Provincia Autonoma Bolzano / Bozen
2021-02-23,PUG,9349,4421,4928,8872,477,ITF,ITF4,16,Puglia
2021-04-20,PAT,2879,1377,1502,2843,36,ITH,ITH2,4,Provincia Autonoma Trento
2021-05-02,LOM,83498,38332,45166,61036,22462,ITC,ITC4,3,Lombardia
2021-01-06,SAR,1615,549,1066,1615,0,ITG,ITG2,20,Sardegna
2021-02-11,MAR,1987,657,1330,1598,389,ITI,ITI3,11,Marche
2021-03-25,CAL,7422,3480,3942,4571,2851,ITF,ITF6,18,Calabria
2021-01-28,PAB,871,308,563,9,862,ITH,ITH1,4,Provincia Autonoma Bolzano / Bozen
2021-02-02,MOL,539,176,363,216,323,ITF,ITF2,14,Molise
2021-02-21,VDA,18,3,15,0,18,ITC,ITC2,2,Valle d'Aosta / Vallée d'Aoste
2021-05-09,PAT,2323,1210,1113,1979,344,ITH,ITH2,4,Provincia Autonoma Trento
2021-05-20,BAS,5855,2964,2891,2890,2965,ITF,ITF5,17,Basilicata
2021-01-16,MOL,420,166,254,420,0,ITF,ITF2,14,Molise
2021-04-13,CAM,26603,12683,13920,21072,5531,ITF,ITF3,15,Campania
2021-05-05,MAR,11647,5300,6347,5218,6429,ITI,ITI3,11,Marche
2021-06-16,CAL,17900,8251,9649,11802,6098,ITF,ITF6,18,Calabria
2021-01-03,CAM,3836,2009,1827,3836,0,ITF,ITF3,15,Campania
2021-02-15,PAT,534,188,346,420,114,ITH,ITH2,4,Provincia Autonoma Trento
2021-04-26,MOL,1157,521,636,826,331,ITF,ITF2,14,Molise
2021-06-06,BAS,4502,2070,2432,3723,779,ITF,ITF5,17,Basilicata
2021-06-01,VDA,871,469,402,518,353,ITC,ITC2,2,Valle d'Aosta / Vallée d'Aoste
2021-04-08,LAZ,26717,12231,14486,19025,7692,ITI,ITI4,12,Lazio
2021-05-26,PAT,3917,1843,2074,1225,2692,ITH,ITH2,4,Provincia Autonoma Trento
2021-04-09,MOL,2321,1249,1072,2130,191,ITF,ITF2,14,Molise
2021-04-13,LOM,47590,21243,26347,33519,14071,ITC,ITC4,3,Lombardia
2021-06-07,TOS,34799,17043,17756,31191,3608,ITI,ITI1,9,Toscana
2021-01-15,SIC,4814,2080,2734,4814,0,ITG,ITG1,19,Sicilia
2021-04-20,FVG,7111,3060,4051,3208,3903,ITH,ITH4,6,Friuli-Venezia Giulia
2021-05-28,EMR,41150,18922,22228,17842,23308,ITH,ITH5,8,Emilia-Romagna
2021-04-25,SIC,21351,10183,11168,16375,4976,ITG,ITG1,19,Sicilia
2021-05-21,TOS,28865,13443,15422,17462,11403,ITI,ITI1,9,Toscana
2021-04-30,LOM,117211,54776,62435,89730,27481,ITC,ITC4,3,Lombardia
2021-02-01,SIC,5891,2617,3274,293,5598,ITG,ITG1,19,Sicilia
2021-01-20,LOM,5663,1377,4286,5549,114,ITC,ITC4,3,Lombardia
2021-01-18,MOL,114,48,66,114,0,ITF,ITF2,14,Molise
2021-04-27,VEN,28122,12750,15372,21205,6917,ITH,ITH3,5,Veneto
2021-03-22,SIC,16569,7831,8738,11208,5361,ITG,ITG1,19,Sicilia
2021-04-22,EMR,29048,13449,15599,14970,14078,ITH,ITH5,8,Emilia-Romagna
2021-06-19,ABR,10311,5082,5229,6480,3831,ITF,ITF1,13,Abruzzo
2021-01-17,VEN,1933,781,1152,1584,349,ITH,ITH3,5,Veneto
2021-02-05,UMB,780,234,546,18,762,ITI,ITI2,10,Umbria
2021-01-12,EMR,9476,3124,6352,9476,0,ITH,ITH5,8,Emilia-Romagna
2020-12-29,SIC,243,152,91,243,0,ITG,ITG1,19,Sicilia
2021-01-10,FVG,2939,918,2021,2939,0,ITH,ITH4,6,Friuli-Venezia Giulia
2021-03-28,ABR,2415,1016,1399,2044,371,ITF,ITF1,13,Abruzzo
2021-04-11,MOL,1196,591,605,1182,14,ITF,ITF2,14,Molise
2021-01-18,PUG,1845,771,1074,1496,349,ITF,ITF4,16,Puglia
2021-04-14,BAS,2042,998,1044,1368,674,ITF,ITF5,17,Basilicata
2021-04-05,FVG,2890,1437,1453,2875,15,ITH,ITH4,6,Friuli-Venezia Giulia
2021-04-03,PIE,19432,8158,11274,10885,8547,ITC,ITC1,1,Piemonte
2021-01-21,BAS,30,10,20,30,0,ITF,ITF5,17,Basilicata
2021-02-03,VEN,5945,1667,4278,479,5466,ITH,ITH3,5,Veneto
2021-01-10,PIE,5214,2275,2939,5214,0,ITC,ITC1,1,Piemonte
2021-06-13,SIC,33478,16637,16841,29993,3485,ITG,ITG1,19,Sicilia
2021-01-04,BAS,607,271,336,607,0,ITF,ITF5,17,Basilicata
2021-01-22,LOM,3140,867,2273,3071,69,ITC,ITC4,3,Lombardia
2021-06-16,LIG,15601,7501,8100,10123,5478,ITC,ITC3,7,Liguria
2021-01-12,FVG,2260,713,1547,2260,0,ITH,ITH4,6,Friuli-Venezia Giulia
2021-04-25,PAB,3072,1497,1575,2401,671,ITH,ITH1,4,Provincia Autonoma Bolzano / Bozen
2021-01-29,FVG,2412,813,1599,264,2148,ITH,ITH4,6,Friuli-Venezia Giulia
2021-02-06,PUG,4547,1929,2618,1591,2956,ITF,ITF4,16,Puglia
2021-03-01,TOS,4473,1733,2740,832,3641,ITI,ITI1,9,Toscana
2021-04-29,VEN,50225,23363,26862,37041,13184,ITH,ITH3,5,Veneto
2021-01-20,PUG,1546,540,1006,1538,8,ITF,ITF4,16,Puglia
2021-03-08,LIG,5623,2458,3165,3934,1689,ITC,ITC3,7,Liguria
2021-04-30,PUG,34879,15622,19257,22917,11962,ITF,ITF4,16,Puglia
2021-04-22,FVG,6773,3080,3693,3086,3687,ITH,ITH4,6,Friuli-Venezia Giulia
2021-02-05,VEN,8372,2534,5838,1415,6957,ITH,ITH3,5,Veneto
2021-04-14,ABR,6615,2957,3658,4497,2118,ITF,ITF1,13,Abruzzo
2021-05-07,MAR,12836,5804,7032,3658,9178,ITI,ITI3,11,Marche
2021-06-18,CAL,18500,8596,9904,10961,7539,ITF,ITF6,18,Calabria
2021-04-12,UMB,7089,3079,4010,5371,1718,ITI,ITI2,10,Umbria
2021-02-22,VEN,7014,3041,3973,6627,387,ITH,ITH3,5,Veneto
2021-03-25,LIG,9763,4229,5534,6370,3393,ITC,ITC3,7,Liguria
2021-04-13,PUG,28670,13592,15078,25269,3401,ITF,ITF4,16,Puglia
2021-02-13,MAR,1093,462,631,1011,82,ITI,ITI3,11,Marche
2021-01-19,UMB,103,23,80,103,0,ITI,ITI2,10,Umbria
2021-02-23,VDA,216,123,93,216,0,ITC,ITC2,2,Valle d'Aosta / Vallée d'Aoste
2021-01-01,LIG,144,55,89,144,0,ITC,ITC3,7,Liguria
2021-04-05,EMR,14863,6812,8051,11971,2892,ITH,ITH5,8,Emilia-Romagna
2021-05-16,VEN,28411,14006,14405,21320,7091,ITH,ITH3,5,Veneto
2021-01-04,ABR,1403,576,827,1403,0,ITF,ITF1,13,Abruzzo
2021-01-27,MAR,2118,780,1338,122,1996,ITI,ITI3,11,Marche
2021-03-10,CAL,6556,3314,3242,5274,1282,ITF,ITF6,18,Calabria
2021-04-29,UMB,5215,2248,2967,2889,2326,ITI,ITI2,10,Umbria
2021-05-18,SAR,14039,6780,7259,9502,4537,ITG,ITG2,20,Sardegna
2021-01-13,PAB,1691,557,1134,1691,0,ITH,ITH1,4,Provincia Autonoma Bolzano / Bozen
2021-03-24,UMB,4106,1792,2314,2783,1323,ITI,ITI2,10,Umbria
2021-01-23,ABR,265,116,149,57,208,ITF,ITF1,13,Abruzzo
2021-04-22,PIE,27674,12744,14930,20975,6699,ITC,ITC1,1,Piemonte
2021-01-12,PIE,10090,3415,6675,10090,0,ITC,ITC1,1,Piemonte
2021-01-30,PAB,498,245,253,4,494,ITH,ITH1,4,Provincia Autonoma Bolzano / Bozen
2021-03-29,CAM,19397,9571,9826,17851,1546,ITF,ITF3,15,Campania
2021-05-03,ABR,11110,5240,5870,7262,3848,ITF,ITF1,13,Abruzzo
2021-01-28,PUG,5474,2278,3196,471,5003,ITF,ITF4,16,Puglia
2021-01-12,ABR,1805,667,1138,1805,0,ITF,ITF1,13,Abruzzo
2021-03-18,CAM,12174,5380,6794,5986,6188,ITF,ITF3,15,Campania
2021-04-15,LAZ,31931,14307,17624,21119,10812,ITI,ITI4,12,Lazio
2021-01-31,BAS,77,24,53,0,77,ITF,ITF5,17,Basilicata
2021-02-22,EMR,7482,3091,4391,7210,272,ITH,ITH5,8,Emilia-Romagna
2021-03-15,UMB,4616,1950,2666,2848,1768,ITI,ITI2,10,Umbria
2021-02-01,TOS,5509,1958,3551,521,4988,ITI,ITI1,9,Toscana
2021-05-25,ABR,11403,5314,6089,8264,3139,ITF,ITF1,13,Abruzzo
2021-02-10,LAZ,8188,3399,4789,4849,3339,ITI,ITI4,12,Lazio
2021-02-10,UMB,715,349,366,700,15,ITI,ITI2,10,Umbria
2021-03-13,PAT,831,381,450,783,48,ITH,ITH2,4,Provincia Autonoma Trento
2021-05-09,VEN,35029,16108,18921,24968,10061,ITH,ITH3,5,Veneto
2021-05-21,LAZ,51442,24699,26743,37567,13875,ITI,ITI4,12,Lazio
2021-05-31,MAR,11780,5941,5839,8851,2929,ITI,ITI3,11,Marche
2021-04-05,VDA,462,222,240,458,4,ITC,ITC2,2,Valle d'Aosta / Vallée d'Aoste
2021-06-04,LAZ,61174,29792,31382,43693,17481,ITI,ITI4,12,Lazio
2021-05-02,FVG,6840,3211,3629,3939,2901,ITH,ITH4,6,Friuli-Venezia Giulia
2021-02-20,PIE,3834,1254,2580,3660,174,ITC,ITC1,1,Piemonte
2021-05-17,MAR,11853,5568,6285,7690,4163,ITI,ITI3,11,Marche
2021-01-12,BAS,217,88,129,217,0,ITF,ITF5,17,Basilicata
2021-02-11,MOL,293,133,160,257,36,ITF,ITF2,14,Molise
2021-06-05,PAB,6066,3022,3044,4972,1094,ITH,ITH1,4,Provincia Autonoma Bolzano / Bozen
2021-03-04,LOM,29305,12102,17203,20250,9055,ITC,ITC4,3,Lombardia
2021-04-04,LIG,756,366,390,507,249,ITC,ITC3,7,Liguria
2021-04-23,PUG,29373,13647,15726,24161,5212,ITF,ITF4,16,Puglia
2021-01-31,ABR,1521,493,1028,288,1233,ITF,ITF1,13,Abruzzo
2021-05-04,LAZ,39822,18323,21499,26320,13502,ITI,ITI4,12,Lazio
2021-05-22,MOL,1313,711,602,1229,84,ITF,ITF2,14,Molise
2021-04-18,LIG,2613,1164,1449,2145,468,ITC,ITC3,7,Liguria
2021-05-16,FVG,9976,4775,5201,8577,1399,ITH,ITH4,6,Friuli-Venezia Giulia
2021-05-26,VEN,31024,15163,15861,14562,16462,ITH,ITH3,5,Veneto
2021-05-28,SAR,17935,8687,9248,13665,4270,ITG,ITG2,20,Sardegna
2021-05-10,ABR,10103,4782,5321,5455,4648,ITF,ITF1,13,Abruzzo
2021-02-17,SAR,1407,577,830,1333,74,ITG,ITG2,20,Sardegna
2021-04-30,PAB,3337,1592,1745,1562,1775,ITH,ITH1,4,Provincia Autonoma Bolzano / Bozen
2021-04-29,PIE,48397,21920,26477,35779,12618,ITC,ITC1,1,Piemonte
2021-05-25,SAR,14322,7022,7300,8592,5730,ITG,ITG2,20,Sardegna
2021-01-08,LIG,2926,999,1927,2926,0,ITC,ITC3,7,Liguria
2021-01-20,PAB,617,252,365,409,208,ITH,ITH1,4,Provincia Autonoma Bolzano / Bozen
2021-01-24,SIC,4343,2268,2075,136,4207,ITG,ITG1,19,Sicilia
2021-04-23,ABR,7382,3388,3994,5080,2302,ITF,ITF1,13,Abruzzo
2021-04-30,MAR,13941,6101,7840,5398,8543,ITI,ITI3,11,Marche
2021-01-06,PAB,59,18,41,59,0,ITH,ITH1,4,Provincia Autonoma Bolzano / Bozen
2021-02-14,CAL,465,212,253,435,30,ITF,ITF6,18,Calabria
2021-06-11,SAR,14765,7013,7752,9238,5527,ITG,ITG2,20,Sardegna
2021-01-30,ABR,1511,568,943,69,1442,ITF,ITF1,13,Abruzzo
2021-03-01,VEN,9394,3716,5678,7572,1822,ITH,ITH3,5,Veneto
2021-04-05,CAM,11639,5544,6095,9216,2423,ITF,ITF3,15,Campania
2021-03-03,SAR,4067,2266,1801,2816,1251,ITG,ITG2,20,Sardegna
2021-03-22,LOM,40319,14296,26023,29769,10550,ITC,ITC4,3,Lombardia
2021-05-16,PIE,28128,12768,15360,15063,13065,ITC,ITC1,1,Piemonte
2021-05-25,CAL,16348,7984,8364,10281,6067,ITF,ITF6,18,Calabria
2021-04-08,LOM,52312,21744,30568,35865,16447,ITC,ITC4,3,Lombardia
2021-02-05,PIE,9604,3139,6465,659,8945,ITC,ITC1,1,Piemonte
2020-12-29,LOM,104,44,60,104,0,ITC,ITC4,3,Lombardia
2021-02-24,LAZ,12050,5209,6841,11056,994,ITI,ITI4,12,Lazio
2021-01-24,UMB,258,106,152,1,257,ITI,ITI2,10,Umbria
2021-05-04,SIC,26777,12465,14312,17535,9242,ITG,ITG1,19,Sicilia
2021-04-22,LOM,73851,33359,40492,57533,16318,ITC,ITC4,3,Lombardia
2021-03-17,CAM,11590,5100,6490,5009,6581,ITF,ITF3,15,Campania
2021-04-29,PAT,4639,2238,2401,4429,210,ITH,ITH2,4,Provincia Autonoma Trento
2021-05-10,BAS,4805,2383,2422,2763,2042,ITF,ITF5,17,Basilicata
2021-03-03,LOM,26957,11507,15450,19678,7279,ITC,ITC4,3,Lombardia
2021-04-27,TOS,10350,4912,5438,3866,6484,ITI,ITI1,9,Toscana
2021-06-18,FVG,9952,4873,5079,2962,6990,ITH,ITH4,6,Friuli-Venezia Giulia
2021-03-18,PUG,9451,4279,5172,3317,6134,ITF,ITF4,16,Puglia
2021-04-11,MAR,7117,3115,4002,6831,286,ITI,ITI3,11,Marche
2021-01-22,PAT,1669,433,1236,329,1340,ITH,ITH2,4,Provincia Autonoma Trento
2021-01-26,CAL,1818,867,951,277,1541,ITF,ITF6,18,Calabria
2021-03-10,FVG,3579,1691,1888,1786,1793,ITH,ITH4,6,Friuli-Venezia Giulia
2021-01-27,LIG,1744,603,1141,141,1603,ITC,ITC3,7,Liguria
2021-02-05,PAT,802,272,530,283,519,ITH,ITH2,4,Provincia Autonoma Trento
2021-02-24,FVG,2522,1086,1436,2504,18,ITH,ITH4,6,Friuli-Venezia Giulia
2021-03-29,LAZ,25098,11795,13303,18060,7038,ITI,ITI4,12,Lazio
2021-05-01,EMR,28402,12774,15628,15626,12776,ITH,ITH5,8,Emilia-Romagna
2021-05-16,PAT,1330,735,595,1091,239,ITH,ITH2,4,Provincia Autonoma Trento
2021-03-04,PUG,15341,6090,9251,13921,1420,ITF,ITF4,16,Puglia
2021-03-30,PAB,1298,532,766,218,1080,ITH,ITH1,4,Provincia Autonoma Bolzano / Bozen
2021-06-08,UMB,7264,3584,3680,6743,521,ITI,ITI2,10,Umbria
2021-06-11,CAM,67754,32844,34910,61749,6005,ITF,ITF3,15,Campania
2021-05-21,LIG,12838,5952,6886,9714,3124,ITC,ITC3,7,Liguria
2021-06-09,PUG,41359,20484,20875,30275,11084,ITF,ITF4,16,Puglia
2021-01-28,VDA,291,123,168,56,235,ITC,ITC2,2,Valle d'Aosta / Vallée d'Aoste
2021-03-03,CAM,13922,5495,8427,7292,6630,ITF,ITF3,15,Campania
2021-04-03,VEN,21949,9627,12322,14240,7709,ITH,ITH3,5,Veneto
2021-03-11,MAR,6591,2784,3807,5221,1370,ITI,ITI3,11,Marche
2021-04-16,PAB,2949,1418,1531,2438,511,ITH,ITH1,4,Provincia Autonoma Bolzano / Bozen
2021-04-22,CAL,9617,4795,4822,6777,2840,ITF,ITF6,18,Calabria
2021-01-05,PAT,709,232,477,709,0,ITH,ITH2,4,Provincia Autonoma Trento
2021-02-27,LIG,1888,921,967,1759,129,ITC,ITC3,7,Liguria
2021-03-20,VEN,13010,5386,7624,10931,2079,ITH,ITH3,5,Veneto
2021-03-27,FVG,5358,2902,2456,3947,1411,ITH,ITH4,6,Friuli-Venezia Giulia
2021-02-15,PUG,3255,1269,1986,2634,621,ITF,ITF4,16,Puglia
2021-03-15,LAZ,20711,9631,11080,13968,6743,ITI,ITI4,12,Lazio
2021-03-22,SAR,3696,1497,2199,3183,513,ITG,ITG2,20,Sardegna
2021-03-25,MAR,6654,2772,3882,3246,3408,ITI,ITI3,11,Marche
2021-05-06,CAL,13255,6275,6980,8991,4264,ITF,ITF6,18,Calabria
2021-03-16,MOL,614,230,384,267,347,ITF,ITF2,14,Molise
2021-04-15,PAT,3186,1438,1748,3032,154,ITH,ITH2,4,Provincia Autonoma Trento
2021-01-17,TOS,2536,871,1665,2022,514,ITI,ITI1,9,Toscana
2021-02-10,LIG,2314,837,1477,1019,1295,ITC,ITC3,7,Liguria
2021-05-26,PUG,38229,18358,19871,26600,11629,ITF,ITF4,16,Puglia
2021-04-08,SAR,13441,5936,7505,8321,5120,ITG,ITG2,20,Sardegna
2021-06-19,PAB,5607,2981,2626,577,5030,ITH,ITH1,4,Provincia Autonoma Bolzano / Bozen
2020-12-29,SAR,57,32,25,57,0,ITG,ITG2,20,Sardegna
2021-03-11,PAB,1684,825,859,1146,538,ITH,ITH1,4,Provincia Autonoma Bolzano / Bozen
2021-01-11,MOL,557,194,363,557,0,ITF,ITF2,14,Molise
2021-06-18,PIE,38207,19017,19190,24210,13997,ITC,ITC1,1,Piemonte
2021-02-25,PAB,1498,549,949,1497,1,ITH,ITH1,4,Provincia Autonoma Bolzano / Bozen
2021-05-11,LOM,86826,41409,45417,60650,26176,ITC,ITC4,3,Lombardia
2021-03-10,PIE,13681,5213,8468,11387,2294,ITC,ITC1,1,Piemonte
2021-05-25,CAM,46427,22313,24114,23063,23364,ITF,ITF3,15,Campania
2021-06-02,PAB,1444,809,635,987,457,ITH,ITH1,4,Provincia Autonoma Bolzano / Bozen
2021-03-27,PIE,18397,7828,10569,9570,8827,ITC,ITC1,1,Piemonte
2021-04-05,CAL,3415,1606,1809,2557,858,ITF,ITF6,18,Calabria
2021-04-22,SAR,10503,4659,5844,5584,4919,ITG,ITG2,20,Sardegna
2021-01-10,VEN,5032,1671,3361,5032,0,ITH,ITH3,5,Veneto
2021-03-21,ABR,2134,914,1220,844,1290,ITF,ITF1,13,Abruzzo
2021-01-05,LAZ,7375,2803,4572,7375,0,ITI,ITI4,12,Lazio
2021-01-12,SAR,865,408,457,865,0,ITG,ITG2,20,Sardegna
2021-02-05,EMR,9321,2967,6354,1638,7683,ITH,ITH5,8,Emilia-Romagna
2021-05-28,LOM,93416,44769,48647,42924,50492,ITC,ITC4,3,Lombardia
2021-06-12,VDA,1232,599,633,1066,166,ITC,ITC2,2,Valle d'Aosta / Vallée d'Aoste
2021-04-15,FVG,6490,2862,3628,5219,1271,ITH,ITH4,6,Friuli-Venezia Giulia
2021-02-17,LOM,11986,3755,8231,10596,1390,ITC,ITC4,3,Lombardia
2021-03-15,SIC,10612,4686,5926,5720,4892,ITG,ITG1,19,Sicilia
2021-06-12,ABR,11247,5821,5426,9895,1352,ITF,ITF1,13,Abruzzo
2021-06-11,LOM,100225,51015,49210,85861,14364,ITC,ITC4,3,Lombardia
2021-03-08,TOS,6705,2943,3762,1885,4820,ITI,ITI1,9,Toscana
2021-04-29,FVG,6699,2939,3760,4165,2534,ITH,ITH4,6,Friuli-Venezia Giulia
2021-02-20,MAR,4121,1705,2416,4010,111,ITI,ITI3,11,Marche
2021-01-24,LAZ,5694,2229,3465,612,5082,ITI,ITI4,12,Lazio
2021-06-16,TOS,31645,16193,15452,26528,5117,ITI,ITI1,9,Toscana
2021-01-27,PUG,4583,1932,2651,612,3971,ITF,ITF4,16,Puglia
2021-06-18,PAT,6284,3358,2926,1382,4902,ITH,ITH2,4,Provincia Autonoma Trento
2021-01-05,FVG,1678,551,1127,1678,0,ITH,ITH4,6,Friuli-Venezia Giulia
2021-02-07,LAZ,4944,2025,2919,387,4557,ITI,ITI4,12,Lazio
2021-03-27,PAT,1620,710,910,1363,257,ITH,ITH2,4,Provincia Autonoma Trento
2021-05-07,PUG,49925,22282,27643,26503,23422,ITF,ITF4,16,Puglia
2021-05-30,TOS,28669,13942,14727,21725,6944,ITI,ITI1,9,Toscana
2021-03-18,LIG,4986,2124,2862,2007,2979,ITC,ITC3,7,Liguria
2021-05-18,LAZ,44601,20411,24190,35100,9501,ITI,ITI4,12,Lazio
2021-06-20,EMR,21427,10939,10488,10668,10759,ITH,ITH5,8,Emilia-Romagna
2021-03-21,BAS,1054,486,568,359,695,ITF,ITF5,17,Basilicata
2021-04-01,LIG,12417,5509,6908,9647,2770,ITC,ITC3,7,Liguria
2021-01-13,PUG,4543,1730,2813,4543,0,ITF,ITF4,16,Puglia
2021-02-08,PAB,2,1,1,1,1,ITH,ITH1,4,Provincia Autonoma Bolzano / Bozen
2021-04-22,CAM,33941,16532,17409,21538,12403,ITF,ITF3,15,Campania
2021-05-23,VEN,34472,16457,18015,11065,23407,ITH,ITH3,5,Veneto
2021-06-04,PAT,5818,2603,3215,1830,3988,ITH,ITH2,4,Provincia Autonoma Trento
2021-06-08,CAL,15853,7482,8371,13850,2003,ITF,ITF6,18,Calabria
2021-01-20,MAR,403,100,303,384,19,ITI,ITI3,11,Marche
2021-05-29,BAS,3059,1534,1525,834,2225,ITF,ITF5,17,Basilicata
2021-01-12,CAM,5215,2564,2651,5215,0,ITF,ITF3,15,Campania
2021-02-12,VEN,4314,1447,2867,3742,572,ITH,ITH3,5,Veneto
2021-03-19,VDA,322,85,237,287,35,ITC,ITC2,2,Valle d'Aosta / Vallée d'Aoste
2021-02-03,MAR,2124,741,1383,119,2005,ITI,ITI3,11,Marche
2021-03-17,CAL,4047,1803,2244,2138,1909,ITF,ITF6,18,Calabria
2021-04-06,PUG,13799,6220,7579,7048,6751,ITF,ITF4,16,Puglia
2021-05-11,SAR,8874,4108,4766,6527,2347,ITG,ITG2,20,Sardegna
2021-01-25,MOL,319,130,189,3,316,ITF,ITF2,14,Molise
2021-01-29,VEN,9022,2788,6234,367,8655,ITH,ITH3,5,Veneto
2021-01-31,SAR,2121,750,1371,48,2073,ITG,ITG2,20,Sardegna
2021-05-14,MAR,13494,6219,7275,6721,6773,ITI,ITI3,11,Marche
2021-02-05,FVG,2609,784,1825,89,2520,ITH,ITH4,6,Friuli-Venezia Giulia
2021-02-24,PAT,1324,525,799,926,398,ITH,ITH2,4,Provincia Autonoma Trento
2021-05-05,MOL,2413,1042,1371,2272,141,ITF,ITF2,14,Molise
2021-05-06,CAM,57266,27900,29366,42823,14443,ITF,ITF3,15,Campania
2021-05-19,PAB,3624,1847,1777,1840,1784,ITH,ITH1,4,Provincia Autonoma Bolzano / Bozen
2021-01-03,PAB,41,16,25,41,0,ITH,ITH1,4,Provincia Autonoma Bolzano / Bozen
2021-04-14,FVG,7217,3118,4099,5505,1712,ITH,ITH4,6,Friuli-Venezia Giulia
2021-01-13,ABR,1257,441,816,1257,0,ITF,ITF1,13,Abruzzo
2021-06-03,PAT,4763,2233,2530,1304,3459,ITH,ITH2,4,Provincia Autonoma Trento
2021-01-19,PIE,6466,2105,4361,6454,12,ITC,ITC1,1,Piemonte
2021-02-14,SAR,539,263,276,537,2,ITG,ITG2,20,Sardegna
2021-06-08,LIG,17813,8893,8920,11201,6612,ITC,ITC3,7,Liguria
2021-04-13,PAB,2391,1130,1261,2384,7,ITH,ITH1,4,Provincia Autonoma Bolzano / Bozen
2021-05-03,LAZ,39171,17685,21486,26588,12583,ITI,ITI4,12,Lazio
2021-05-07,VDA,564,245,319,533,31,ITC,ITC2,2,Valle d'Aosta / Vallée d'Aoste
2021-03-17,LIG,5552,2368,3184,2473,3079,ITC,ITC3,7,Liguria
2021-04-23,VDA,921,443,478,538,383,ITC,ITC2,2,Valle d'Aosta / Vallée d'Aoste
2021-05-04,MOL,2705,1181,1524,2577,128,ITF,ITF2,14,Molise
2021-05-08,VEN,41412,18729,22683,29607,11805,ITH,ITH3,5,Veneto
2021-01-13,VDA,337,110,227,337,0,ITC,ITC2,2,Valle d'Aosta / Vallée d'Aoste
2021-01-10,MOL,270,72,198,270,0,ITF,ITF2,14,Molise
2021-04-05,LOM,27377,11694,15683,19274,8103,ITC,ITC4,3,Lombardia
2021-04-06,VDA,741,381,360,629,112,ITC,ITC2,2,Valle d'Aosta / Vallée d'Aoste
2021-04-20,MOL,2318,1025,1293,1220,1098,ITF,ITF2,14,Molise
2021-06-18,MAR,15117,7550,7567,8370,6747,ITI,ITI3,11,Marche
2021-06-09,MOL,1015,563,452,515,500,ITF,ITF2,14,Molise
2021-01-13,BAS,916,387,529,916,0,ITF,ITF5,17,Basilicata
2020-12-31,TOS,803,202,601,803,0,ITI,ITI1,9,Toscana
2021-04-14,PIE,27711,12562,15149,23186,4525,ITC,ITC1,1,Piemonte
2021-03-18,SAR,7257,3071,4186,5652,1605,ITG,ITG2,20,Sardegna
2021-02-15,VEN,4389,1824,2565,4149,240,ITH,ITH3,5,Veneto
2021-02-27,PAT,1029,457,572,608,421,ITH,ITH2,4,Provincia Autonoma Trento
2021-04-09,PAB,2937,1301,1636,2207,730,ITH,ITH1,4,Provincia Autonoma Bolzano / Bozen
2021-04-19,BAS,4166,1913,2253,2528,1638,ITF,ITF5,17,Basilicata
2021-05-14,SAR,14204,6584,7620,10897,3307,ITG,ITG2,20,Sardegna
2021-01-01,PAT,213,50,163,213,0,ITH,ITH2,4,Provincia Autonoma Trento
2021-06-07,PAT,5788,2880,2908,2805,2983,ITH,ITH2,4,Provincia Autonoma Trento
2021-02-03,SAR,1119,419,700,426,693,ITG,ITG2,20,Sardegna
2021-03-21,MAR,4504,1873,2631,1629,2875,ITI,ITI3,11,Marche
2021-04-18,PIE,22970,10821,12149,20214,2756,ITC,ITC1,1,Piemonte
2021-03-30,VEN,35932,15281,20651,30681,5251,ITH,ITH3,5,Veneto
2021-05-22,PAB,6821,3552,3269,4654,2167,ITH,ITH1,4,Provincia Autonoma Bolzano / Bozen
2021-01-08,PIE,5532,1762,3770,5532,0,ITC,ITC1,1,Piemonte
2021-02-25,PUG,11970,5062,6908,10800,1170,ITF,ITF4,16,Puglia
2021-03-25,LAZ,28800,13179,15621,22193,6607,ITI,ITI4,12,Lazio
2021-04-01,SAR,10153,4062,6091,7139,3014,ITG,ITG2,20,Sardegna
2021-06-14,PIE,37775,19465,18310,30714,7061,ITC,ITC1,1,Piemonte
2021-02-11,PAB,1094,432,662,239,855,ITH,ITH1,4,Provincia Autonoma Bolzano / Bozen
2021-03-22,VDA,560,205,355,333,227,ITC,ITC2,2,Valle d'Aosta / Vallée d'Aoste
2021-04-25,PAT,1971,940,1031,1964,7,ITH,ITH2,4,Provincia Autonoma Trento
2021-01-27,LAZ,6114,2387,3727,997,5117,ITI,ITI4,12,Lazio
2021-02-06,MAR,2463,902,1561,522,1941,ITI,ITI3,11,Marche
2021-03-06,PIE,13994,5211,8783,11205,2789,ITC,ITC1,1,Piemonte
2021-06-05,PUG,41839,20509,21330,29451,12388,ITF,ITF4,16,Puglia
2021-06-15,BAS,3206,1406,1800,2230,976,ITF,ITF5,17,Basilicata
2021-06-11,LIG,17324,8835,8489,11296,6028,ITC,ITC3,7,Liguria
2021-04-15,LIG,11834,5231,6603,9982,1852,ITC,ITC3,7,Liguria
2021-01-22,PIE,3867,1249,2618,2526,1341,ITC,ITC1,1,Piemonte
2021-01-05,CAL,1512,708,804,1512,0,ITF,ITF6,18,Calabria
2021-02-07,SIC,2327,984,1343,674,1653,ITG,ITG1,19,Sicilia
2021-04-10,VEN,27457,11975,15482,18975,8482,ITH,ITH3,5,Veneto
2021-02-10,LOM,14394,4504,9890,7577,6817,ITC,ITC4,3,Lombardia
2021-02-24,CAM,11785,4149,7636,11097,688,ITF,ITF3,15,Campania
2021-05-18,SIC,36063,17340,18723,23560,12503,ITG,ITG1,19,Sicilia
2021-06-06,VEN,37279,19098,18181,32559,4720,ITH,ITH3,5,Veneto
2020-12-27,TOS,620,267,353,620,0,ITI,ITI1,9,Toscana
2021-06-01,LAZ,48540,23394,25146,30249,18291,ITI,ITI4,12,Lazio
2021-04-05,LAZ,19842,9061,10781,13661,6181,ITI,ITI4,12,Lazio
2021-01-16,ABR,933,430,503,933,0,ITF,ITF1,13,Abruzzo
2021-02-12,EMR,5324,1679,3645,3921,1403,ITH,ITH5,8,Emilia-Romagna
2021-06-05,VDA,925,476,449,737,188,ITC,ITC2,2,Valle d'Aosta / Vallée d'Aoste
2021-04-10,EMR,20921,9300,11621,16776,4145,ITH,ITH5,8,Emilia-Romagna
2021-02-11,VDA,231,107,124,222,9,ITC,ITC2,2,Valle d'Aosta / Vallée d'Aoste
2021-03-29,UMB,3890,1731,2159,2411,1479,ITI,ITI2,10,Umbria
2021-04-17,EMR,27307,13078,14229,17956,9351,ITH,ITH5,8,Emilia-Romagna
2021-01-31,UMB,1058,276,782,25,1033,ITI,ITI2,10,Umbria
2021-04-09,VDA,237,111,126,204,33,ITC,ITC2,2,Valle d'Aosta / Vallée d'Aoste
2021-01-07,EMR,10273,3406,6867,10273,0,ITH,ITH5,8,Emilia-Romagna
2021-05-21,MAR,12952,6114,6838,6696,6256,ITI,ITI3,11,Marche
2021-01-03,TOS,3336,1052,2284,3336,0,ITI,ITI1,9,Toscana
2021-05-25,LAZ,47234,22135,25099,35624,11610,ITI,ITI4,12,Lazio
2021-05-22,VDA,940,494,446,540,400,ITC,ITC2,2,Valle d'Aosta / Vallée d'Aoste
2021-05-25,UMB,8811,4298,4513,7748,1063,ITI,ITI2,10,Umbria
2021-05-26,MOL,1548,697,851,794,754,ITF,ITF2,14,Molise
2021-01-05,CAM,7237,3637,3600,7237,0,ITF,ITF3,15,Campania
2021-02-28,BAS,804,343,461,775,29,ITF,ITF5,17,Basilicata
2021-03-30,MOL,2003,857,1146,1491,512,ITF,ITF2,14,Molise
2020-12-27,VEN,880,395,485,880,0,ITH,ITH3,5,Veneto
2021-01-12,CAL,2070,1022,1048,2070,0,ITF,ITF6,18,Calabria
2021-02-18,PAB,1839,457,1382,1832,7,ITH,ITH1,4,Provincia Autonoma Bolzano / Bozen
2021-01-02,BAS,949,380,569,949,0,ITF,ITF5,17,Basilicata
2021-01-06,PUG,3948,1671,2277,3948,0,ITF,ITF4,16,Puglia
2021-02-01,MOL,562,201,361,14,548,ITF,ITF2,14,Molise
2021-01-16,BAS,722,304,418,722,0,ITF,ITF5,17,Basilicata
2021-05-12,MOL,2849,1292,1557,2753,96,ITF,ITF2,14,Molise
2021-04-08,LIG,13724,6157,7567,11681,2043,ITC,ITC3,7,Liguria
2021-05-06,FVG,11875,5516,6359,7918,3957,ITH,ITH4,6,Friuli-Venezia Giulia
2021-02-10,SAR,1959,765,1194,1441,518,ITG,ITG2,20,Sardegna
2021-04-26,BAS,4464,2164,2300,4244,220,ITF,ITF5,17,Basilicata
2021-06-04,LIG,14708,7231,7477,9242,5466,ITC,ITC3,7,Liguria
2021-02-17,CAM,7388,3210,4178,6328,1060,ITF,ITF3,15,Campania
2021-05-25,SIC,33385,15280,18105,14097,19288,ITG,ITG1,19,Sicilia
2021-05-30,VEN,22533,11263,11270,15843,6690,ITH,ITH3,5,Veneto
2021-02-03,LOM,25637,7916,17721,1080,24557,ITC,ITC4,3,Lombardia
2021-02-24,CAL,1914,975,939,1436,478,ITF,ITF6,18,Calabria
2021-03-29,SIC,14977,7057,7920,10480,4497,ITG,ITG1,19,Sicilia
2021-04-15,CAM,34337,16658,17679,24439,9898,ITF,ITF3,15,Campania
2021-04-01,LOM,42949,17225,25724,26751,16198,ITC,ITC4,3,Lombardia
2021-02-15,TOS,8771,3376,5395,7945,826,ITI,ITI1,9,Toscana
2021-04-12,LAZ,23818,10733,13085,16920,6898,ITI,ITI4,12,Lazio
2021-04-03,EMR,19939,8766,11173,16199,3740,ITH,ITH5,8,Emilia-Romagna
2021-03-07,ABR,2522,630,1892,2522,0,ITF,ITF1,13,Abruzzo
2021-05-30,EMR,27068,12787,14281,13377,13691,ITH,ITH5,8,Emilia-Romagna
2021-01-09,ABR,1484,566,918,1484,0,ITF,ITF1,13,Abruzzo
2021-02-19,EMR,7327,3010,4317,6813,514,ITH,ITH5,8,Emilia-Romagna
2021-04-16,VDA,599,261,338,597,2,ITC,ITC2,2,Valle d'Aosta / Vallée d'Aoste
2021-06-08,LAZ,65990,31345,34645,36485,29505,ITI,ITI4,12,Lazio
2020-12-31,EMR,2215,780,1435,2215,0,ITH,ITH5,8,Emilia-Romagna
2021-05-28,MAR,13955,6734,7221,9096,4859,ITI,ITI3,11,Marche
2021-06-06,EMR,36404,18911,17493,31998,4406,ITH,ITH5,8,Emilia-Romagna
2021-04-02,VDA,873,344,529,648,225,ITC,ITC2,2,Valle d'Aosta / Vallée d'Aoste
2021-05-18,UMB,7732,3345,4387,3890,3842,ITI,ITI2,10,Umbria
2021-02-26,EMR,9634,3673,5961,8586,1048,ITH,ITH5,8,Emilia-Romagna
2021-04-01,MAR,7576,3182,4394,4160,3416,ITI,ITI3,11,Marche
2021-03-22,UMB,3560,1655,1905,2314,1246,ITI,ITI2,10,Umbria
2021-05-29,VDA,798,434,364,561,237,ITC,ITC2,2,Valle d'Aosta / Vallée d'Aoste
2021-01-06,TOS,4520,1460,3060,4520,0,ITI,ITI1,9,Toscana
2021-03-10,ABR,5047,1682,3365,4091,956,ITF,ITF1,13,Abruzzo
2021-04-16,LIG,11968,5281,6687,10158,1810,ITC,ITC3,7,Liguria
2021-04-18,LOM,36344,16204,20140,31114,5230,ITC,ITC4,3,Lombardia
2021-04-27,CAM,32154,15622,16532,24234,7920,ITF,ITF3,15,Campania
2021-06-07,VEN,44330,23142,21188,37337,6993,ITH,ITH3,5,Veneto
2021-01-08,LOM,12698,3918,8780,12698,0,ITC,ITC4,3,Lombardia
2021-06-10,PAB,4439,2304,2135,1346,3093,ITH,ITH1,4,Provincia Autonoma Bolzano / Bozen
2021-06-17,PUG,40861,19981,20880,20786,20075,ITF,ITF4,16,Puglia
2021-02-27,VEN,8988,2691,6297,8141,847,ITH,ITH3,5,Veneto
2021-01-26,ABR,1542,567,975,30,1512,ITF,ITF1,13,Abruzzo
2021-06-15,VDA,876,479,397,621,255,ITC,ITC2,2,Valle d'Aosta / Vallée d'Aoste
2021-02-09,MOL,359,170,189,197,162,ITF,ITF2,14,Molise
2021-01-06,LIG,1660,616,1044,1660,0,ITC,ITC3,7,Liguria
2021-05-06,ABR,13006,6088,6918,7980,5026,ITF,ITF1,13,Abruzzo
2021-02-15,SIC,3730,1733,1997,3166,564,ITG,ITG1,19,Sicilia
2021-04-13,SAR,7608,3594,4014,5781,1827,ITG,ITG2,20,Sardegna
2021-04-27,EMR,32100,14862,17238,19639,12461,ITH,ITH5,8,Emilia-Romagna
2021-02-08,FVG,2357,694,1663,92,2265,ITH,ITH4,6,Friuli-Venezia Giulia
2021-05-14,PIE,33366,16259,17107,17959,15407,ITC,ITC1,1,Piemonte
2021-05-26,SIC,44536,20850,23686,24074,20462,ITG,ITG1,19,Sicilia
2021-06-09,SAR,15454,7361,8093,11718,3736,ITG,ITG2,20,Sardegna
2021-02-01,PAT,1221,335,886,92,1129,ITH,ITH2,4,Provincia Autonoma Trento
2021-03-11,TOS,15881,6337,9544,12553,3328,ITI,ITI1,9,Toscana
2021-01-03,SIC,4776,2494,2282,4776,0,ITG,ITG1,19,Sicilia
2021-06-19,TOS,26325,13784,12541,21688,4637,ITI,ITI1,9,Toscana
2021-01-01,LAZ,3554,1382,2172,3554,0,ITI,ITI4,12,Lazio
2021-04-13,SIC,19683,9586,10097,10932,8751,ITG,ITG1,19,Sicilia
2021-01-10,LAZ,4043,1702,2341,4043,0,ITI,ITI4,12,Lazio
2021-01-15,CAM,4980,2381,2599,4980,0,ITF,ITF3,15,Campania
2021-03-10,BAS,1680,842,838,841,839,ITF,ITF5,17,Basilicata
2021-06-16,LAZ,63471,30298,33173,32119,31352,ITI,ITI4,12,Lazio
2021-03-13,CAM,14517,7038,7479,9235,5282,ITF,ITF3,15,Campania
2021-04-20,LAZ,31063,14263,16800,19764,11299,ITI,ITI4,12,Lazio
2021-04-22,UMB,5437,2237,3200,2773,2664,ITI,ITI2,10,Umbria
2021-03-04,VEN,12980,4884,8096,9508,3472,ITH,ITH3,5,Veneto
2021-04-26,PAB,1543,771,772,1538,5,ITH,ITH1,4,Provincia Autonoma Bolzano / Bozen
2021-01-26,BAS,798,352,446,101,697,ITF,ITF5,17,Basilicata
2021-02-23,MAR,3267,1397,1870,3211,56,ITI,ITI3,11,Marche
2021-03-05,VDA,275,124,151,53,222,ITC,ITC2,2,Valle d'Aosta / Vallée d'Aoste
2021-03-08,LAZ,20856,9041,11815,15583,5273,ITI,ITI4,12,Lazio
2021-05-06,BAS,5052,2435,2617,3483,1569,ITF,ITF5,17,Basilicata
2021-03-20,CAL,6704,3072,3632,4199,2505,ITF,ITF6,18,Calabria
2021-03-22,CAM,13180,6343,6837,11140,2040,ITF,ITF3,15,Campania
2021-05-15,BAS,6536,3347,3189,3964,2572,ITF,ITF5,17,Basilicata
2021-03-30,PUG,12268,5862,6406,6371,5897,ITF,ITF4,16,Puglia
2021-06-13,FVG,8628,4490,4138,5316,3312,ITH,ITH4,6,Friuli-Venezia Giulia
2021-02-01,PUG,3965,1660,2305,373,3592,ITF,ITF4,16,Puglia
2021-02-07,CAM,2929,1382,1547,2158,771,ITF,ITF3,15,Campania
2021-04-02,BAS,2318,1047,1271,1714,604,ITF,ITF5,17,Basilicata
2021-02-03,PAT,847,315,532,414,433,ITH,ITH2,4,Provincia Autonoma Trento
2021-02-04,BAS,1096,442,654,63,1033,ITF,ITF5,17,Basilicata
2021-04-17,FVG,7450,3232,4218,5967,1483,ITH,ITH4,6,Friuli-Venezia Giulia
2021-05-06,EMR,35925,16600,19325,22869,13056,ITH,ITH5,8,Emilia-Romagna
2021-01-10,SIC,3533,1578,1955,3533,0,ITG,ITG1,19,Sicilia
2021-01-26,EMR,8334,3000,5334,214,8120,ITH,ITH5,8,Emilia-Romagna
2021-02-05,TOS,5750,2246,3504,1924,3826,ITI,ITI1,9,Toscana
2021-04-09,ABR,8838,4180,4658,6299,2539,ITF,ITF1,13,Abruzzo
2021-04-22,LAZ,38853,19217,19636,24247,14606,ITI,ITI4,12,Lazio
2021-01-15,MAR,1771,500,1271,1771,0,ITI,ITI3,11,Marche
2021-04-17,UMB,6666,3059,3607,5326,1340,ITI,ITI2,10,Umbria
2021-05-23,PAT,1955,993,962,447,1508,ITH,ITH2,4,Provincia Autonoma Trento
2021-03-20,LIG,2316,995,1321,1142,1174,ITC,ITC3,7,Liguria
2021-03-24,EMR,21202,9399,11803,13819,7383,ITH,ITH5,8,Emilia-Romagna
2021-05-16,TOS,26662,12879,13783,24201,2461,ITI,ITI1,9,Toscana
2021-02-28,VDA,260,86,174,77,183,ITC,ITC2,2,Valle d'Aosta / Vallée d'Aoste
2021-03-10,LAZ,23302,10633,12669,17655,5647,ITI,ITI4,12,Lazio
2021-03-11,MOL,1465,637,828,1459,6,ITF,ITF2,14,Molise
2021-04-10,PAT,2808,1311,1497,2013,795,ITH,ITH2,4,Provincia Autonoma Trento
2021-05-11,VEN,33109,16478,16631,28386,4723,ITH,ITH3,5,Veneto
2021-01-12,LAZ,5413,1981,3432,5413,0,ITI,ITI4,12,Lazio
2021-01-15,LOM,25209,7430,17779,25209,0,ITC,ITC4,3,Lombardia
2021-03-15,CAL,3556,1688,1868,2112,1444,ITF,ITF6,18,Calabria
2021-06-18,LAZ,62628,30056,32572,30349,32279,ITI,ITI4,12,Lazio
2021-01-18,PAB,1772,687,1085,1767,5,ITH,ITH1,4,Provincia Autonoma Bolzano / Bozen
2021-05-14,PUG,44855,20493,24362,28748,16107,ITF,ITF4,16,Puglia
2021-02-02,BAS,367,143,224,175,192,ITF,ITF5,17,Basilicata
2021-04-17,PIE,30456,14146,16310,27141,3315,ITC,ITC1,1,Piemonte
2021-01-22,VEN,1080,332,748,25,1055,ITH,ITH3,5,Veneto
2021-01-06,MOL,689,260,429,689,0,ITF,ITF2,14,Molise
2021-04-29,LOM,115456,53571,61885,85625,29831,ITC,ITC4,3,Lombardia
2021-06-13,PIE,37826,19965,17861,33700,4126,ITC,ITC1,1,Piemonte
2021-04-02,ABR,6682,3092,3590,5195,1487,ITF,ITF1,13,Abruzzo
2021-04-25,MAR,8599,3993,4606,7024,1575,ITI,ITI3,11,Marche
2021-04-16,MOL,2430,1033,1397,1198,1232,ITF,ITF2,14,Molise
2021-05-05,VDA,1038,566,472,456,582,ITC,ITC2,2,Valle d'Aosta / Vallée d'Aoste
2021-01-24,EMR,2443,885,1558,298,2145,ITH,ITH5,8,Emilia-Romagna
2021-02-04,ABR,1681,615,1066,610,1071,ITF,ITF1,13,Abruzzo
2021-03-08,SAR,4678,2424,2254,3458,1220,ITG,ITG2,20,Sardegna
2021-05-20,CAL,16892,8433,8459,11287,5605,ITF,ITF6,18,Calabria
2021-01-05,SIC,10295,5056,5239,10295,0,ITG,ITG1,19,Sicilia
2021-02-10,PIE,7535,2371,5164,1316,6219,ITC,ITC1,1,Piemonte
2021-04-09,BAS,1151,350,801,1088,63,ITF,ITF5,17,Basilicata
2021-05-04,SAR,9538,4386,5152,7685,1853,ITG,ITG2,20,Sardegna
2021-04-10,FVG,5028,2202,2826,3803,1225,ITH,ITH4,6,Friuli-Venezia Giulia
2021-01-05,UMB,854,429,425,854,0,ITI,ITI2,10,Umbria
2021-01-24,SAR,90,34,56,5,85,ITG,ITG2,20,Sardegna
2021-04-08,PIE,25146,10932,14214,20416,4730,ITC,ITC1,1,Piemonte
2021-04-15,SIC,21007,10239,10768,11715,9292,ITG,ITG1,19,Sicilia
2021-05-11,TOS,27942,12982,14960,12484,15458,ITI,ITI1,9,Toscana
2021-04-20,LOM,67634,30821,36813,57299,10335,ITC,ITC4,3,Lombardia
2021-05-23,FVG,10268,4853,5415,6120,4148,ITH,ITH4,6,Friuli-Venezia Giulia
2021-01-10,LOM,10513,3957,6556,10513,0,ITC,ITC4,3,Lombardia
2021-04-25,MOL,792,395,397,559,233,ITF,ITF2,14,Molise
2021-01-15,LIG,2257,755,1502,2257,0,ITC,ITC3,7,Liguria
2021-01-17,LOM,8336,3340,4996,8136,200,ITC,ITC4,3,Lombardia
2021-02-07,CAL,859,428,431,148,711,ITF,ITF6,18,Calabria
2021-03-13,TOS,9288,3310,5978,5324,3964,ITI,ITI1,9,Toscana
2021-03-17,LAZ,13805,5910,7895,7549,6256,ITI,ITI4,12,Lazio
2021-03-15,LOM,31547,11327,20220,23032,8515,ITC,ITC4,3,Lombardia
2021-04-25,LIG,1936,921,1015,1521,415,ITC,ITC3,7,Liguria
2021-05-18,CAL,15382,7683,7699,11919,3463,ITF,ITF6,18,Calabria
2021-05-04,VEN,42893,20316,22577,34866,8027,ITH,ITH3,5,Veneto
2021-06-20,SIC,25725,12220,13505,10543,15182,ITG,ITG1,19,Sicilia
2021-01-25,PUG,3826,1681,2145,423,3403,ITF,ITF4,16,Puglia
2021-01-13,MAR,2105,746,1359,2105,0,ITI,ITI3,11,Marche
2021-02-10,PAT,853,291,562,511,342,ITH,ITH2,4,Provincia Autonoma Trento
2021-03-13,LIG,3849,1637,2212,2994,855,ITC,ITC3,7,Liguria
2021-05-03,VDA,839,400,439,488,351,ITC,ITC2,2,Valle d'Aosta / Vallée d'Aoste
2021-06-18,SAR,16418,7481,8937,8706,7712,ITG,ITG2,20,Sardegna
2021-05-02,MAR,8899,3936,4963,3161,5738,ITI,ITI3,11,Marche
2021-03-10,SAR,6050,2953,3097,5200,850,ITG,ITG2,20,Sardegna
2021-01-17,CAM,1155,551,604,702,453,ITF,ITF3,15,Campania
2021-01-29,TOS,6144,1700,4444,304,5840,ITI,ITI1,9,Toscana
2021-03-22,CAL,4930,2308,2622,3172,1758,ITF,ITF6,18,Calabria
2021-04-10,PIE,30166,13417,16749,25888,4278,ITC,ITC1,1,Piemonte
2021-05-06,SAR,12952,6011,6941,9806,3146,ITG,ITG2,20,Sardegna
2021-05-07,PAB,4193,2061,2132,3665,528,ITH,ITH1,4,Provincia Autonoma Bolzano / Bozen
2021-01-24,VEN,4117,1219,2898,28,4089,ITH,ITH3,5,Veneto
2021-03-15,CAM,13337,6485,6852,8592,4745,ITF,ITF3,15,Campania
2021-06-20,UMB,5190,2524,2666,1188,4002,ITI,ITI2,10,Umbria
2021-03-07,VDA,64,30,34,11,53,ITC,ITC2,2,Valle d'Aosta / Vallée d'Aoste
2021-05-09,TOS,22527,9765,12762,9668,12859,ITI,ITI1,9,Toscana
2021-04-24,UMB,4564,1963,2601,3386,1178,ITI,ITI2,10,Umbria
2021-01-13,MOL,474,160,314,474,0,ITF,ITF2,14,Molise
2021-06-19,MOL,2267,1132,1135,1301,966,ITF,ITF2,14,Molise
2021-05-05,PAB,4154,1945,2209,2038,2116,ITH,ITH1,4,Provincia Autonoma Bolzano / Bozen
2021-04-23,MOL,2050,882,1168,1391,659,ITF,ITF2,14,Molise
2021-01-17,EMR,2890,887,2003,2644,246,ITH,ITH5,8,Emilia-Romagna
2021-01-25,PAB,487,183,304,3,484,ITH,ITH1,4,Provincia Autonoma Bolzano / Bozen
2021-03-01,SAR,2267,1155,1112,1608,659,ITG,ITG2,20,Sardegna
2021-01-12,UMB,838,248,590,838,0,ITI,ITI2,10,Umbria
2021-04-22,SIC,26860,12664,14196,20402,6458,ITG,ITG1,19,Sicilia
2021-04-04,ABR,1636,771,865,1507,129,ITF,ITF1,13,Abruzzo
2021-04-08,PAT,3116,1296,1820,1998,1118,ITH,ITH2,4,Provincia Autonoma Trento
2021-03-10,SIC,13860,6059,7801,11677,2183,ITG,ITG1,19,Sicilia
2021-04-15,PIE,29646,13580,16066,24161,5485,ITC,ITC1,1,Piemonte
2021-03-23,PAB,1553,759,794,1552,1,ITH,ITH1,4,Provincia Autonoma Bolzano / Bozen
2021-01-05,PIE,5381,1603,3778,5381,0,ITC,ITC1,1,Piemonte
2021-01-12,SIC,4321,2119,2202,4321,0,ITG,ITG1,19,Sicilia
2021-04-27,LOM,85952,39962,45990,69414,16538,ITC,ITC4,3,Lombardia
2021-06-18,SIC,42722,19782,22940,18716,24006,ITG,ITG1,19,Sicilia
2021-03-14,UMB,66,48,18,66,0,ITI,ITI2,10,Umbria
2021-04-07,VEN,35955,16155,19800,28625,7330,ITH,ITH3,5,Veneto
2021-01-07,FVG,2093,718,1375,2093,0,ITH,ITH4,6,Friuli-Venezia Giulia
2021-02-14,LIG,233,122,111,233,0,ITC,ITC3,7,Liguria
2021-04-02,EMR,23400,10556,12844,18919,4481,ITH,ITH5,8,Emilia-Romagna
2021-02-27,BAS,1993,861,1132,1829,164,ITF,ITF5,17,Basilicata
2021-03-05,FVG,3772,1511,2261,2698,1074,ITH,ITH4,6,Friuli-Venezia Giulia
2021-05-25,LIG,14087,6864,7223,10931,3156,ITC,ITC3,7,Liguria
2021-05-29,EMR,37742,16475,21267,17148,20594,ITH,ITH5,8,Emilia-Romagna
2021-05-15,SIC,56479,26391,30088,41234,15245,ITG,ITG1,19,Sicilia
2021-03-19,SIC,16213,7984,8229,10732,5481,ITG,ITG1,19,Sicilia
2021-06-16,ABR,10704,5354,5350,8045,2659,ITF,ITF1,13,Abruzzo
2021-01-30,VDA,439,202,237,14,425,ITC,ITC2,2,Valle d'Aosta / Vallée d'Aoste
2021-01-31,VEN,4769,1562,3207,392,4377,ITH,ITH3,5,Veneto
2021-05-27,CAM,72851,35300,37551,26368,46483,ITF,ITF3,15,Campania
2021-02-16,CAM,5440,2411,3029,4669,771,ITF,ITF3,15,Campania
2021-03-29,VEN,31456,13690,17766,27623,3833,ITH,ITH3,5,Veneto
2021-02-04,LAZ,6302,2481,3821,987,5315,ITI,ITI4,12,Lazio
2021-04-01,PAB,2786,1407,1379,2642,144,ITH,ITH1,4,Provincia Autonoma Bolzano / Bozen
2021-04-08,PUG,17457,7578,9879,11283,6174,ITF,ITF4,16,Puglia
2020-12-31,PAT,1625,449,1176,1625,0,ITH,ITH2,4,Provincia Autonoma Trento
2021-06-07,BAS,4233,1918,2315,3917,316,ITF,ITF5,17,Basilicata
2021-04-11,BAS,848,330,518,785,63,ITF,ITF5,17,Basilicata
2021-05-13,SAR,11934,5610,6324,8888,3046,ITG,ITG2,20,Sardegna
2021-04-19,FVG,6710,3133,3577,3295,3415,ITH,ITH4,6,Friuli-Venezia Giulia
2021-02-02,SAR,1498,669,829,257,1241,ITG,ITG2,20,Sardegna
2021-01-09,FVG,2513,841,1672,2513,0,ITH,ITH4,6,Friuli-Venezia Giulia
2021-02-27,ABR,2812,1338,1474,2546,266,ITF,ITF1,13,Abruzzo
2021-03-22,MAR,5652,2375,3277,2524,3128,ITI,ITI3,11,Marche
2021-06-15,FVG,11622,5870,5752,5282,6340,ITH,ITH4,6,Friuli-Venezia Giulia
2021-01-07,PIE,5387,1739,3648,5387,0,ITC,ITC1,1,Piemonte
2021-03-12,UMB,2698,1082,1616,2202,496,ITI,ITI2,10,Umbria
2021-06-06,PUG,30487,15352,15135,25467,5020,ITF,ITF4,16,Puglia
2021-02-09,CAL,2157,911,1246,956,1201,ITF,ITF6,18,Calabria
2021-03-05,PIE,15375,6059,9316,11557,3818,ITC,ITC1,1,Piemonte
2021-05-20,TOS,29712,13871,15841,18906,10806,ITI,ITI1,9,Toscana
2021-04-10,PUG,30824,13062,17762,26601,4223,ITF,ITF4,16,Puglia
2021-01-25,VDA,147,65,82,0,147,ITC,ITC2,2,Valle d'Aosta / Vallée d'Aoste
2021-03-17,LOM,26252,10493,15759,15254,10998,ITC,ITC4,3,Lombardia
2021-03-22,LIG,7743,3466,4277,4806,2937,ITC,ITC3,7,Liguria
2021-05-22,CAM,67881,32467,35414,46444,21437,ITF,ITF3,15,Campania
2021-01-31,TOS,3050,1129,1921,106,2944,ITI,ITI1,9,Toscana
2021-06-16,PAT,6201,3343,2858,2047,4154,ITH,ITH2,4,Provincia Autonoma Trento
2021-03-21,MOL,1246,542,704,479,767,ITF,ITF2,14,Molise
2021-05-21,VEN,44708,21989,22719,20957,23751,ITH,ITH3,5,Veneto
2021-01-25,LOM,7011,2367,4644,473,6538,ITC,ITC4,3,Lombardia
2021-05-06,VDA,1063,509,554,679,384,ITC,ITC2,2,Valle d'Aosta / Vallée d'Aoste
2021-05-31,PUG,37571,18074,19497,23520,14051,ITF,ITF4,16,Puglia
2021-02-01,LOM,16064,5322,10742,309,15755,ITC,ITC4,3,Lombardia
2021-02-12,BAS,775,332,443,744,31,ITF,ITF5,17,Basilicata
2021-03-14,MOL,596,240,356,17,579,ITF,ITF2,14,Molise
2020-12-27,CAL,311,170,141,311,0,ITF,ITF6,18,Calabria
2021-03-18,EMR,13676,5807,7869,5676,8000,ITH,ITH5,8,Emilia-Romagna
2021-05-14,EMR,37231,17161,20070,27637,9594,ITH,ITH5,8,Emilia-Romagna
2021-02-03,EMR,9357,2997,6360,984,8373,ITH,ITH5,8,Emilia-Romagna
2021-04-10,BAS,1032,378,654,949,83,ITF,ITF5,17,Basilicata
2021-04-01,EMR,23930,10770,13160,19383,4547,ITH,ITH5,8,Emilia-Romagna
2021-03-13,UMB,1731,524,1207,1486,245,ITI,ITI2,10,Umbria
2021-01-15,UMB,701,215,486,701,0,ITI,ITI2,10,Umbria
2021-02-01,CAM,3984,1813,2171,110,3874,ITF,ITF3,15,Campania
2021-02-26,ABR,3914,1670,2244,2946,968,ITF,ITF1,13,Abruzzo
2021-02-17,EMR,6538,2764,3774,5766,772,ITH,ITH5,8,Emilia-Romagna
2021-04-06,CAL,7445,3369,4076,4144,3301,ITF,ITF6,18,Calabria
2021-01-29,UMB,1232,348,884,79,1153,ITI,ITI2,10,Umbria
2021-03-30,CAM,22039,10565,11474,19081,2958,ITF,ITF3,15,Campania
2021-05-09,SIC,28076,13136,14940,19807,8269,ITG,ITG1,19,Sicilia
2021-02-08,CAL,1855,736,1119,664,1191,ITF,ITF6,18,Calabria
2021-05-09,UMB,5768,2759,3009,5377,391,ITI,ITI2,10,Umbria
2021-02-16,VDA,326,53,273,320,6,ITC,ITC2,2,Valle d'Aosta / Vallée d'Aoste
2021-05-04,FVG,9534,4297,5237,6180,3354,ITH,ITH4,6,Friuli-Venezia Giulia
2021-06-01,EMR,27120,13081,14039,17233,9887,ITH,ITH5,8,Emilia-Romagna
2021-02-15,MAR,967,412,555,954,13,ITI,ITI3,11,Marche
2021-03-15,PAT,1411,545,866,947,464,ITH,ITH2,4,Provincia Autonoma Trento
2021-01-24,FVG,305,119,186,1,304,ITH,ITH4,6,Friuli-Venezia Giulia
2021-06-11,TOS,29640,15407,14233,25038,4602,ITI,ITI1,9,Toscana
2021-01-17,PAT,251,195,56,251,0,ITH,ITH2,4,Provincia Autonoma Trento
2021-04-28,BAS,4704,2158,2546,4263,441,ITF,ITF5,17,Basilicata
2021-05-26,MAR,11803,5916,5887,8620,3183,ITI,ITI3,11,Marche
2021-02-12,LAZ,6846,2847,3999,6431,415,ITI,ITI4,12,Lazio
2021-04-15,TOS,24401,10196,14205,15865,8536,ITI,ITI1,9,Toscana
2021-02-17,TOS,8175,3169,5006,7423,752,ITI,ITI1,9,Toscana
2021-03-08,FVG,4119,1642,2477,2034,2085,ITH,ITH4,6,Friuli-Venezia Giulia
2021-04-25,PUG,11264,5217,6047,10106,1158,ITF,ITF4,16,Puglia
2021-05-11,PAT,3697,1749,1948,2849,848,ITH,ITH2,4,Provincia Autonoma Trento
2021-02-27,PUG,14222,4818,9404,12997,1225,ITF,ITF4,16,Puglia
2021-04-06,LIG,13213,5888,7325,10973,2240,ITC,ITC3,7,Liguria
2021-04-24,CAL,19002,9479,9523,15586,3416,ITF,ITF6,18,Calabria
2021-04-17,CAM,36179,17510,18669,24671,11508,ITF,ITF3,15,Campania
2021-01-01,PUG,148,61,87,148,0,ITF,ITF4,16,Puglia
2021-02-08,LIG,1977,741,1236,306,1671,ITC,ITC3,7,Liguria
2021-02-26,CAL,3068,1636,1432,2615,453,ITF,ITF6,18,Calabria
2021-05-31,PAB,2987,1464,1523,2120,867,ITH,ITH1,4,Provincia Autonoma Bolzano / Bozen
2021-06-07,PUG,43957,21463,22494,30781,13176,ITF,ITF4,16,Puglia
2021-02-17,VEN,6022,2772,3250,5928,94,ITH,ITH3,5,Veneto
2021-03-28,MOL,1626,747,879,524,1102,ITF,ITF2,14,Molise
2021-06-13,CAM,41848,20401,21447,37124,4724,ITF,ITF3,15,Campania
2021-03-22,FVG,3657,1445,2212,1703,1954,ITH,ITH4,6,Friuli-Venezia Giulia
2021-04-11,PUG,16455,7246,9209,14799,1656,ITF,ITF4,16,Puglia
2021-01-30,MOL,461,158,303,12,449,ITF,ITF2,14,Molise
2021-03-02,BAS,797,384,413,661,136,ITF,ITF5,17,Basilicata
2021-03-30,MAR,7420,3044,4376,4605,2815,ITI,ITI3,11,Marche
2021-04-27,PAT,3908,1877,2031,3840,68,ITH,ITH2,4,Provincia Autonoma Trento
2020-12-27,LIG,135,56,79,135,0,ITC,ITC3,7,Liguria
2021-02-05,SAR,1897,749,1148,433,1464,ITG,ITG2,20,Sardegna
2021-06-20,CAL,4935,2338,2597,2673,2262,ITF,ITF6,18,Calabria
2021-02-01,MAR,1362,479,883,98,1264,ITI,ITI3,11,Marche
2021-04-01,VEN,25299,11144,14155,18893,6406,ITH,ITH3,5,Veneto
2021-06-10,BAS,4340,2099,2241,3899,441,ITF,ITF5,17,Basilicata
2021-02-05,SIC,6804,2995,3809,2125,4679,ITG,ITG1,19,Sicilia
2021-03-08,PIE,14020,5359,8661,11306,2714,ITC,ITC1,1,Piemonte
2021-04-03,SAR,4666,1805,2861,2699,1967,ITG,ITG2,20,Sardegna
2021-01-18,ABR,124,50,74,46,78,ITF,ITF1,13,Abruzzo
2021-05-04,PIE,28563,13138,15425,16405,12158,ITC,ITC1,1,Piemonte
2021-05-30,SAR,9726,4836,4890,7369,2357,ITG,ITG2,20,Sardegna
2021-04-28,ABR,9512,4587,4925,7489,2023,ITF,ITF1,13,Abruzzo
2021-01-24,PIE,3153,959,2194,434,2719,ITC,ITC1,1,Piemonte
2021-02-19,SAR,1499,473,1026,1443,56,ITG,ITG2,20,Sardegna
2021-06-06,CAL,13375,6433,6942,11681,1694,ITF,ITF6,18,Calabria
2021-01-01,PAB,6,5,1,6,0,ITH,ITH1,4,Provincia Autonoma Bolzano / Bozen
2021-04-15,VEN,20872,8619,12253,10047,10825,ITH,ITH3,5,Veneto
2021-05-12,ABR,9610,4585,5025,6044,3566,ITF,ITF1,13,Abruzzo
2021-05-30,CAM,52146,25436,26710,38835,13311,ITF,ITF3,15,Campania
2021-06-07,PAB,2901,1506,1395,2582,319,ITH,ITH1,4,Provincia Autonoma Bolzano / Bozen
2021-03-22,PIE,11513,4883,6630,3907,7606,ITC,ITC1,1,Piemonte
2021-04-03,SIC,16391,7803,8588,13555,2836,ITG,ITG1,19,Sicilia
2021-01-05,VEN,7329,2182,5147,7329,0,ITH,ITH3,5,Veneto
2021-02-19,CAM,9570,3559,6011,8920,650,ITF,ITF3,15,Campania
2021-02-27,PAB,2458,759,1699,2448,10,ITH,ITH1,4,Provincia Autonoma Bolzano / Bozen
2021-03-16,ABR,3484,1452,2032,1830,1654,ITF,ITF1,13,Abruzzo
2020-12-31,LAZ,5293,2121,3172,5293,0,ITI,ITI4,12,Lazio
2021-04-03,LOM,36235,14859,21376,26148,10087,ITC,ITC4,3,Lombardia
2021-05-28,TOS,30062,13905,16157,17623,12439,ITI,ITI1,9,Toscana
2021-04-10,LAZ,23890,10387,13503,16701,7189,ITI,ITI4,12,Lazio
2021-05-30,LOM,74363,35585,38778,34410,39953,ITC,ITC4,3,Lombardia
2021-05-04,PAT,4508,2447,2061,4414,94,ITH,ITH2,4,Provincia Autonoma Trento
2021-01-17,FVG,1716,523,1193,1716,0,ITH,ITH4,6,Friuli-Venezia Giulia
2021-02-05,LAZ,7281,2962,4319,1184,6097,ITI,ITI4,12,Lazio
2021-04-07,VDA,910,474,436,681,229,ITC,ITC2,2,Valle d'Aosta / Vallée d'Aoste
2021-04-12,EMR,19242,9005,10237,14796,4446,ITH,ITH5,8,Emilia-Romagna
2021-04-01,FVG,6376,3045,3331,5361,1015,ITH,ITH4,6,Friuli-Venezia Giulia
2021-04-09,MAR,9560,4189,5371,9360,200,ITI,ITI3,11,Marche
2021-04-20,EMR,22617,10401,12216,14264,8353,ITH,ITH5,8,Emilia-Romagna
2021-05-28,FVG,10490,5026,5464,6391,4099,ITH,ITH4,6,Friuli-Venezia Giulia
2021-06-12,LIG,10048,4887,5161,7875,2173,ITC,ITC3,7,Liguria
2021-04-08,UMB,5892,2524,3368,4097,1795,ITI,ITI2,10,Umbria
2021-03-30,PAT,2387,973,1414,1750,637,ITH,ITH2,4,Provincia Autonoma Trento
2021-03-24,BAS,1886,722,1164,1488,398,ITF,ITF5,17,Basilicata
2021-04-19,VDA,751,325,426,542,209,ITC,ITC2,2,Valle d'Aosta / Vallée d'Aoste
2021-04-30,LIG,14396,6436,7960,5828,8568,ITC,ITC3,7,Liguria
2021-06-09,SIC,48997,23318,25679,41920,7077,ITG,ITG1,19,Sicilia
2021-01-13,TOS,4062,1398,2664,4062,0,ITI,ITI1,9,Toscana
2021-04-25,VEN,18317,8149,10168,13482,4835,ITH,ITH3,5,Veneto
2021-06-17,PAB,1178,657,521,657,521,ITH,ITH1,4,Provincia Autonoma Bolzano / Bozen
2021-04-01,PIE,19331,8073,11258,11211,8120,ITC,ITC1,1,Piemonte
2021-06-04,UMB,8895,4397,4498,7711,1184,ITI,ITI2,10,Umbria
2021-06-05,MOL,2878,1456,1422,2724,154,ITF,ITF2,14,Molise
2021-04-23,TOS,25682,11431,14251,9364,16318,ITI,ITI1,9,Toscana
2021-03-14,PUG,3322,1430,1892,2511,811,ITF,ITF4,16,Puglia
2021-05-28,PIE,34928,16528,18400,19027,15901,ITC,ITC1,1,Piemonte
2021-01-06,VEN,8135,2387,5748,8135,0,ITH,ITH3,5,Veneto
2021-01-22,CAL,658,274,384,656,2,ITF,ITF6,18,Calabria
2021-01-16,PUG,2506,1033,1473,2506,0,ITF,ITF4,16,Puglia
2021-06-09,LOM,102550,51682,50868,88272,14278,ITC,ITC4,3,Lombardia
2021-05-02,CAL,12506,5835,6671,10664,1842,ITF,ITF6,18,Calabria
2021-01-08,EMR,10866,3580,7286,10866,0,ITH,ITH5,8,Emilia-Romagna
2021-01-25,PIE,6215,1938,4277,983,5232,ITC,ITC1,1,Piemonte
2021-02-20,SAR,2041,855,1186,1707,334,ITG,ITG2,20,Sardegna
2021-01-02,PAB,91,48,43,91,0,ITH,ITH1,4,Provincia Autonoma Bolzano / Bozen
2021-03-06,EMR,20896,5936,14960,18164,2732,ITH,ITH5,8,Emilia-Romagna
2021-01-06,MAR,2201,800,1401,2201,0,ITI,ITI3,11,Marche
2021-03-06,LIG,3304,1842,1462,2599,705,ITC,ITC3,7,Liguria
2021-03-08,LOM,29718,11172,18546,22648,7070,ITC,ITC4,3,Lombardia
2021-03-29,CAL,5613,2373,3240,3857,1756,ITF,ITF6,18,Calabria
2021-01-31,CAL,1110,555,555,154,956,ITF,ITF6,18,Calabria
2021-05-04,LOM,86793,41067,45726,72410,14383,ITC,ITC4,3,Lombardia
2021-05-06,LAZ,48707,22673,26034,31175,17532,ITI,ITI4,12,Lazio
2021-01-22,LIG,1819,604,1215,1333,486,ITC,ITC3,7,Liguria
2021-01-24,LOM,1199,457,742,536,663,ITC,ITC4,3,Lombardia
2021-02-19,FVG,3252,1290,1962,2825,427,ITH,ITH4,6,Friuli-Venezia Giulia
2021-03-04,MAR,6486,2868,3618,5093,1393,ITI,ITI3,11,Marche
2021-05-02,LIG,3879,1768,2111,506,3373,ITC,ITC3,7,Liguria
2021-03-13,MAR,5766,2656,3110,1809,3957,ITI,ITI3,11,Marche
2021-06-13,UMB,6755,3553,3202,6525,230,ITI,ITI2,10,Umbria
2021-01-16,VDA,237,80,157,237,0,ITC,ITC2,2,Valle d'Aosta / Vallée d'Aoste
2021-04-29,SAR,11117,5110,6007,6762,4355,ITG,ITG2,20,Sardegna
2021-03-08,CAM,14687,6848,7839,9911,4776,ITF,ITF3,15,Campania
2021-02-11,ABR,816,262,554,773,43,ITF,ITF1,13,Abruzzo
2021-03-14,VDA,392,200,192,392,0,ITC,ITC2,2,Valle d'Aosta / Vallée d'Aoste
2021-03-15,VEN,16666,7327,9339,11458,5208,ITH,ITH3,5,Veneto
2021-05-01,UMB,5377,2642,2735,2147,3230,ITI,ITI2,10,Umbria
2021-05-04,CAM,48474,23344,25130,39575,8899,ITF,ITF3,15,Campania
2021-06-06,PAT,2228,1061,1167,445,1783,ITH,ITH2,4,Provincia Autonoma Trento
2021-03-18,PAB,1302,531,771,226,1076,ITH,ITH1,4,Provincia Autonoma Bolzano / Bozen
2021-03-20,TOS,6585,2977,3608,5449,1136,ITI,ITI1,9,Toscana
2021-05-11,CAL,15050,7281,7769,10280,4770,ITF,ITF6,18,Calabria
2021-05-20,EMR,40204,18298,21906,18859,21345,ITH,ITH5,8,Emilia-Romagna
2021-05-30,PIE,27701,13186,14515,18377,9324,ITC,ITC1,1,Piemonte
2021-01-24,CAM,4122,2119,2003,377,3745,ITF,ITF3,15,Campania
2021-03-05,UMB,4624,1403,3221,3968,656,ITI,ITI2,10,Umbria
2021-05-09,MAR,8769,3985,4784,3638,5131,ITI,ITI3,11,Marche
2021-01-22,TOS,2866,1064,1802,528,2338,ITI,ITI1,9,Toscana
2021-02-19,PIE,5535,2175,3360,5034,501,ITC,ITC1,1,Piemonte
2021-04-26,VDA,715,327,388,545,170,ITC,ITC2,2,Valle d'Aosta / Vallée d'Aoste
2021-05-14,PAB,5133,2319,2814,3097,2036,ITH,ITH1,4,Provincia Autonoma Bolzano / Bozen
2021-05-21,PUG,38715,18383,20332,28721,9994,ITF,ITF4,16,Puglia
2021-03-04,MOL,850,417,433,526,324,ITF,ITF2,14,Molise
2021-03-16,PAB,1290,532,758,124,1166,ITH,ITH1,4,Provincia Autonoma Bolzano / Bozen
2021-05-13,CAM,55438,24824,30614,39442,15996,ITF,ITF3,15,Campania
2021-01-19,SIC,1448,638,810,1228,220,ITG,ITG1,19,Sicilia
2021-06-12,MOL,2963,1510,1453,2878,85,ITF,ITF2,14,Molise
2021-05-04,LIG,13623,6084,7539,5396,8227,ITC,ITC3,7,Liguria
2021-01-10,SAR,2183,750,1433,2183,0,ITG,ITG2,20,Sardegna
2021-02-17,PAT,1112,425,687,1021,91,ITH,ITH2,4,Provincia Autonoma Trento
2021-03-03,UMB,4438,1773,2665,3727,711,ITI,ITI2,10,Umbria
2021-06-11,SIC,47999,22872,25127,40514,7485,ITG,ITG1,19,Sicilia
2021-05-24,ABR,12253,5847,6406,8900,3353,ITF,ITF1,13,Abruzzo
2021-02-11,BAS,952,401,551,869,83,ITF,ITF5,17,Basilicata
2021-05-12,PAB,3791,2058,1733,3638,153,ITH,ITH1,4,Provincia Autonoma Bolzano / Bozen
2021-04-29,SIC,31571,14773,16798,22234,9337,ITG,ITG1,19,Sicilia
2021-06-04,PIE,37449,19577,17872,34526,2923,ITC,ITC1,1,Piemonte
2021-02-01,PAB,1452,440,1012,12,1440,ITH,ITH1,4,Provincia Autonoma Bolzano / Bozen
2021-01-17,LAZ,4894,2028,2866,4682,212,ITI,ITI4,12,Lazio
2021-02-24,PIE,11409,4629,6780,10904,505,ITC,ITC1,1,Piemonte
2021-03-03,SIC,14419,6431,7988,11356,3063,ITG,ITG1,19,Sicilia
2021-04-24,FVG,6675,2946,3729,5432,1243,ITH,ITH4,6,Friuli-Venezia Giulia
2021-05-19,PUG,26267,12696,13571,19846,6421,ITF,ITF4,16,Puglia
2021-06-14,MOL,1602,800,802,551,1051,ITF,ITF2,14,Molise
2021-01-31,CAM,8068,3711,4357,23,8045,ITF,ITF3,15,Campania
2021-01-19,LAZ,4769,1955,2814,4315,454,ITI,ITI4,12,Lazio
2021-03-23,PUG,10996,5539,5457,4525,6471,ITF,ITF4,16,Puglia
2021-05-09,LIG,2823,1245,1578,1113,1710,ITC,ITC3,7,Liguria
2021-06-06,FVG,9449,4614,4835,7906,1543,ITH,ITH4,6,Friuli-Venezia Giulia
2021-05-22,BAS,5488,2723,2765,1937,3551,ITF,ITF5,17,Basilicata
2021-02-26,FVG,3736,2093,1643,3588,148,ITH,ITH4,6,Friuli-Venezia Giulia
2021-03-26,BAS,1955,703,1252,1695,260,ITF,ITF5,17,Basilicata
2021-02-17,FVG,2354,999,1355,1874,480,ITH,ITH4,6,Friuli-Venezia Giulia
2021-06-03,VDA,1306,667,639,896,410,ITC,ITC2,2,Valle d'Aosta / Vallée d'Aoste
2021-01-29,PIE,5944,1887,4057,455,5489,ITC,ITC1,1,Piemonte
2021-02-24,SAR,2414,1295,1119,2224,190,ITG,ITG2,20,Sardegna
2021-04-20,MAR,10696,4995,5701,9279,1417,ITI,ITI3,11,Marche
2021-06-01,CAL,12824,5945,6879,7918,4906,ITF,ITF6,18,Calabria
2021-04-10,UMB,7474,3514,3960,7339,135,ITI,ITI2,10,Umbria
2021-05-02,PUG,21294,9652,11642,14033,7261,ITF,ITF4,16,Puglia
2021-04-23,PAB,4542,2151,2391,3251,1291,ITH,ITH1,4,Provincia Autonoma Bolzano / Bozen
2021-05-17,VDA,809,417,392,375,434,ITC,ITC2,2,Valle d'Aosta / Vallée d'Aoste
2021-01-17,UMB,54,17,37,54,0,ITI,ITI2,10,Umbria
2021-03-27,LIG,3932,1549,2383,2537,1395,ITC,ITC3,7,Liguria
2021-05-23,TOS,28376,13646,14730,25811,2565,ITI,ITI1,9,Toscana
2021-01-25,MAR,1595,558,1037,96,1499,ITI,ITI3,11,Marche
2020-12-31,UMB,322,127,195,322,0,ITI,ITI2,10,Umbria
2021-04-10,SIC,20408,9960,10448,11445,8963,ITG,ITG1,19,Sicilia
2021-01-10,PAT,84,19,65,84,0,ITH,ITH2,4,Provincia Autonoma Trento
2021-04-13,LIG,13076,5866,7210,11052,2024,ITC,ITC3,7,Liguria
2021-04-15,LOM,49410,21843,27567,35591,13819,ITC,ITC4,3,Lombardia
2021-01-17,SIC,1304,591,713,1245,59,ITG,ITG1,19,Sicilia
2021-04-16,ABR,7537,3488,4049,5620,1917,ITF,ITF1,13,Abruzzo
2021-06-20,CAM,38759,18547,20212,10861,27898,ITF,ITF3,15,Campania
2021-01-05,LOM,7823,2568,5255,7823,0,ITC,ITC4,3,Lombardia
2021-03-22,LAZ,23023,10274,12749,16350,6673,ITI,ITI4,12,Lazio
2021-03-27,CAM,21508,10241,11267,17643,3865,ITF,ITF3,15,Campania
2021-01-23,BAS,720,304,416,33,687,ITF,ITF5,17,Basilicata
2021-05-13,CAL,15904,7641,8263,11216,4688,ITF,ITF6,18,Calabria
2021-05-03,BAS,4514,2043,2471,3687,827,ITF,ITF5,17,Basilicata
2021-04-24,EMR,28612,13230,15382,14384,14228,ITH,ITH5,8,Emilia-Romagna
2020-12-29,LAZ,488,176,312,488,0,ITI,ITI4,12,Lazio
2021-01-08,MAR,1579,591,988,1579,0,ITI,ITI3,11,Marche
2021-01-11,PAB,1571,513,1058,1571,0,ITH,ITH1,4,Provincia Autonoma Bolzano / Bozen
2021-02-19,CAL,1508,681,827,1247,261,ITF,ITF6,18,Calabria
2021-05-15,VDA,1065,614,451,380,685,ITC,ITC2,2,Valle d'Aosta / Vallée d'Aoste
2021-06-06,SAR,10027,4996,5031,6375,3652,ITG,ITG2,20,Sardegna
2021-01-29,PAT,1354,332,1022,55,1299,ITH,ITH2,4,Provincia Autonoma Trento
2021-02-09,BAS,491,213,278,316,175,ITF,ITF5,17,Basilicata
2021-02-04,VDA,294,86,208,8,286,ITC,ITC2,2,Valle d'Aosta / Vallée d'Aoste
2021-03-27,LOM,32427,12371,20056,23723,8704,ITC,ITC4,3,Lombardia
2021-04-18,MAR,8820,4131,4689,7899,921,ITI,ITI3,11,Marche
2021-05-11,EMR,35783,16795,18988,28520,7263,ITH,ITH5,8,Emilia-Romagna
2021-05-30,CAL,10937,5250,5687,6784,4153,ITF,ITF6,18,Calabria
2021-04-28,VDA,1218,632,586,715,503,ITC,ITC2,2,Valle d'Aosta / Vallée d'Aoste
2021-06-01,CAM,41908,20792,21116,31482,10426,ITF,ITF3,15,Campania
2021-01-31,EMR,7698,2763,4935,241,7457,ITH,ITH5,8,Emilia-Romagna
2021-02-10,TOS,4263,1281,2982,3740,523,ITI,ITI1,9,Toscana
2021-04-03,FVG,4005,1986,2019,2675,1330,ITH,ITH4,6,Friuli-Venezia Giulia
2021-01-03,LOM,854,316,538,854,0,ITC,ITC4,3,Lombardia
2021-04-06,PAB,2250,1118,1132,2147,103,ITH,ITH1,4,Provincia Autonoma Bolzano / Bozen
2021-06-18,CAM,63663,30259,33404,33421,30242,ITF,ITF3,15,Campania
2021-03-10,CAM,15609,7719,7890,8774,6835,ITF,ITF3,15,Campania
2021-04-22,PAT,3151,1470,1681,3104,47,ITH,ITH2,4,Provincia Autonoma Trento
2021-06-15,UMB,5926,2998,2928,3898,2028,ITI,ITI2,10,Umbria
2021-05-04,TOS,18302,8208,10094,12855,5447,ITI,ITI1,9,Toscana
2021-06-13,LAZ,52541,23268,29273,27729,24812,ITI,ITI4,12,Lazio
2021-03-07,LAZ,14132,5464,8668,10539,3593,ITI,ITI4,12,Lazio
2021-06-10,FVG,10443,5479,4964,9467,976,ITH,ITH4,6,Friuli-Venezia Giulia
2021-06-15,LAZ,65009,31277,33732,33410,31599,ITI,ITI4,12,Lazio
2021-06-18,PUG,44410,21854,22556,27474,16936,ITF,ITF4,16,Puglia
2021-02-28,PIE,10816,4060,6756,10576,240,ITC,ITC1,1,Piemonte
2021-05-15,CAM,62598,29020,33578,43912,18686,ITF,ITF3,15,Campania
2021-03-17,PIE,12518,5055,7463,5224,7294,ITC,ITC1,1,Piemonte
2020-12-31,VEN,3220,1042,2178,3220,0,ITH,ITH3,5,Veneto
2021-03-11,ABR,5495,2220,3275,4357,1138,ITF,ITF1,13,Abruzzo
2021-03-24,LAZ,27450,12727,14723,21213,6237,ITI,ITI4,12,Lazio
2021-03-25,MOL,1806,730,1076,1309,497,ITF,ITF2,14,Molise
2021-03-19,FVG,3248,1348,1900,1315,1933,ITH,ITH4,6,Friuli-Venezia Giulia
2021-03-08,MOL,1379,522,857,1239,140,ITF,ITF2,14,Molise
2021-03-05,SIC,15664,6769,8895,11429,4235,ITG,ITG1,19,Sicilia
2021-06-02,ABR,9685,4693,4992,6873,2812,ITF,ITF1,13,Abruzzo
2021-04-07,PAT,2618,1016,1602,1676,942,ITH,ITH2,4,Provincia Autonoma Trento
2021-06-16,MOL,1715,870,845,925,790,ITF,ITF2,14,Molise
2021-03-21,EMR,11957,5296,6661,7352,4605,ITH,ITH5,8,Emilia-Romagna
2021-05-13,LIG,13264,6069,7195,9050,4214,ITC,ITC3,7,Liguria
2021-02-16,SIC,4199,2206,1993,3734,465,ITG,ITG1,19,Sicilia
2021-05-29,LAZ,51695,23195,28500,40931,10764,ITI,ITI4,12,Lazio
2021-04-12,VEN,14901,6333,8568,6684,8217,ITH,ITH3,5,Veneto
2021-02-19,LIG,3219,1306,1913,3043,176,ITC,ITC3,7,Liguria
2021-06-19,BAS,4447,2169,2278,2386,2061,ITF,ITF5,17,Basilicata
2021-01-02,VEN,5743,1766,3977,5743,0,ITH,ITH3,5,Veneto
2021-04-13,MOL,1630,718,912,1043,587,ITF,ITF2,14,Molise
2021-06-17,UMB,6913,3503,3410,4883,2030,ITI,ITI2,10,Umbria
2021-05-30,LIG,3276,1604,1672,1364,1912,ITC,ITC3,7,Liguria
2021-03-13,ABR,4124,1420,2704,3081,1043,ITF,ITF1,13,Abruzzo
2021-03-28,BAS,2141,742,1399,2124,17,ITF,ITF5,17,Basilicata
2021-05-17,CAL,14895,7450,7445,10187,4708,ITF,ITF6,18,Calabria
2021-06-10,PIE,40047,20915,19132,37535,2512,ITC,ITC1,1,Piemonte
2021-03-26,UMB,4604,1716,2888,4432,172,ITI,ITI2,10,Umbria
2021-03-27,MOL,2743,1273,1470,1310,1433,ITF,ITF2,14,Molise
2021-02-12,TOS,7606,2683,4923,7393,213,ITI,ITI1,9,Toscana
2021-04-08,PAB,2765,1346,1419,2562,203,ITH,ITH1,4,Provincia Autonoma Bolzano / Bozen
2021-06-10,EMR,43867,22534,21333,38538,5329,ITH,ITH5,8,Emilia-Romagna
2021-03-11,BAS,1794,928,866,835,959,ITF,ITF5,17,Basilicata
2021-01-02,UMB,304,111,193,304,0,ITI,ITI2,10,Umbria
2021-03-02,EMR,12669,4272,8397,10580,2089,ITH,ITH5,8,Emilia-Romagna
2021-01-03,PUG,2007,943,1064,2007,0,ITF,ITF4,16,Puglia
2021-04-14,SAR,8252,3903,4349,7014,1238,ITG,ITG2,20,Sardegna
2021-01-10,MAR,1741,700,1041,1741,0,ITI,ITI3,11,Marche
2021-03-29,ABR,5708,2600,3108,3069,2639,ITF,ITF1,13,Abruzzo
2021-03-30,LOM,39542,15547,23995,24769,14773,ITC,ITC4,3,Lombardia
2021-04-21,MAR,10781,4967,5814,9587,1194,ITI,ITI3,11,Marche
2021-06-02,CAL,12079,5795,6284,8814,3265,ITF,ITF6,18,Calabria
2021-03-20,FVG,3399,1408,1991,1308,2091,ITH,ITH4,6,Friuli-Venezia Giulia
2021-05-14,LIG,13105,5834,7271,8779,4326,ITC,ITC3,7,Liguria
2021-01-20,SAR,210,77,133,208,2,ITG,ITG2,20,Sardegna
2021-01-28,MAR,2086,725,1361,165,1921,ITI,ITI3,11,Marche
2021-05-18,VDA,970,484,486,353,617,ITC,ITC2,2,Valle d'Aosta / Vallée d'Aoste
2021-06-18,UMB,4673,2272,2401,1605,3068,ITI,ITI2,10,Umbria
2021-01-06,LOM,7058,2491,4567,7058,0,ITC,ITC4,3,Lombardia
2021-05-31,LIG,14634,7325,7309,9119,5515,ITC,ITC3,7,Liguria
2021-06-19,PUG,32277,16193,16084,21448,10829,ITF,ITF4,16,Puglia
2021-02-07,VDA,292,120,172,190,102,ITC,ITC2,2,Valle d'Aosta / Vallée d'Aoste
2021-04-13,VEN,14022,6321,7701,8536,5486,ITH,ITH3,5,Veneto
2021-06-03,ABR,13041,6216,6825,9269,3772,ITF,ITF1,13,Abruzzo
2021-01-13,FVG,2650,834,1816,2650,0,ITH,ITH4,6,Friuli-Venezia Giulia
2021-02-13,TOS,7786,2361,5425,7559,227,ITI,ITI1,9,Toscana
2021-03-09,LIG,5930,2753,3177,4499,1431,ITC,ITC3,7,Liguria
2021-04-06,FVG,6651,3111,3540,5501,1150,ITH,ITH4,6,Friuli-Venezia Giulia
2021-03-12,ABR,6015,1987,4028,4433,1582,ITF,ITF1,13,Abruzzo
2021-04-04,MAR,3824,1792,2032,2655,1169,ITI,ITI3,11,Marche
2021-05-16,CAL,13773,6725,7048,9964,3809,ITF,ITF6,18,Calabria
2020-12-27,FVG,262,149,113,262,0,ITH,ITH4,6,Friuli-Venezia Giulia
2021-03-26,MOL,2575,1045,1530,1933,642,ITF,ITF2,14,Molise
2021-02-20,LIG,1335,637,698,1334,1,ITC,ITC3,7,Liguria
2021-05-01,VDA,940,563,377,456,484,ITC,ITC2,2,Valle d'Aosta / Vallée d'Aoste
2021-06-20,ABR,5696,2832,2864,3553,2143,ITF,ITF1,13,Abruzzo
2021-03-03,PIE,12120,4644,7476,11301,819,ITC,ITC1,1,Piemonte
2021-03-29,SAR,4721,1827,2894,4132,589,ITG,ITG2,20,Sardegna
2021-05-13,UMB,5918,2665,3253,3841,2077,ITI,ITI2,10,Umbria
2021-03-14,ABR,1873,731,1142,1207,666,ITF,ITF1,13,Abruzzo
2021-04-14,VDA,941,430,511,717,224,ITC,ITC2,2,Valle d'Aosta / Vallée d'Aoste
2021-05-18,CAM,52129,23192,28937,32511,19618,ITF,ITF3,15,Campania
2021-04-15,SAR,11845,5539,6306,6887,4958,ITG,ITG2,20,Sardegna
2021-01-03,VEN,5157,1562,3595,5157,0,ITH,ITH3,5,Veneto
2021-02-19,UMB,743,293,450,526,217,ITI,ITI2,10,Umbria
2021-01-05,SAR,1327,446,881,1327,0,ITG,ITG2,20,Sardegna
2021-01-08,TOS,5947,1643,4304,5947,0,ITI,ITI1,9,Toscana
2021-03-20,PIE,11922,4899,7023,6024,5898,ITC,ITC1,1,Piemonte
2021-06-09,MAR,14043,7304,6739,12174,1869,ITI,ITI3,11,Marche
2021-03-04,PAB,1715,1005,710,1486,229,ITH,ITH1,4,Provincia Autonoma Bolzano / Bozen
2021-01-22,SAR,83,47,36,55,28,ITG,ITG2,20,Sardegna
2021-02-12,PAT,1010,340,670,589,421,ITH,ITH2,4,Provincia Autonoma Trento
2021-01-17,CAL,896,430,466,801,95,ITF,ITF6,18,Calabria
2021-05-16,LIG,3704,1860,1844,2144,1560,ITC,ITC3,7,Liguria
2021-05-18,LOM,88132,42132,46000,32601,55531,ITC,ITC4,3,Lombardia
2021-02-19,SIC,4907,2648,2259,4343,564,ITG,ITG1,19,Sicilia
2021-06-04,LOM,104332,54166,50166,94765,9567,ITC,ITC4,3,Lombardia
2021-02-22,LIG,3343,1476,1867,3201,142,ITC,ITC3,7,Liguria
2021-02-24,LOM,14694,5946,8748,13762,932,ITC,ITC4,3,Lombardia
2021-02-25,ABR,3043,1331,1712,2514,529,ITF,ITF1,13,Abruzzo
2021-03-01,PAT,1237,454,783,942,295,ITH,ITH2,4,Provincia Autonoma Trento
2021-03-08,SIC,13394,5865,7529,10780,2614,ITG,ITG1,19,Sicilia
2021-06-05,ABR,14591,6848,7743,10541,4050,ITF,ITF1,13,Abruzzo
2021-06-07,MAR,13157,6496,6661,10708,2449,ITI,ITI3,11,Marche
2021-01-31,LAZ,4460,1854,2606,477,3983,ITI,ITI4,12,Lazio
2021-02-05,CAM,7259,3463,3796,2132,5127,ITF,ITF3,15,Campania
2021-03-20,PAT,874,403,471,671,203,ITH,ITH2,4,Provincia Autonoma Trento
2021-03-24,CAL,7639,3487,4152,4379,3260,ITF,ITF6,18,Calabria
2021-03-03,PAT,1659,622,1037,1141,518,ITH,ITH2,4,Provincia Autonoma Trento
2021-03-14,BAS,1010,477,533,541,469,ITF,ITF5,17,Basilicata
2021-01-02,VDA,6,5,1,6,0,ITC,ITC2,2,Valle d'Aosta / Vallée d'Aoste
2021-05-11,LAZ,48193,22125,26068,31722,16471,ITI,ITI4,12,Lazio
2021-06-13,EMR,27248,14234,13014,22994,4254,ITH,ITH5,8,Emilia-Romagna
2021-03-26,VDA,498,204,294,491,7,ITC,ITC2,2,Valle d'Aosta / Vallée d'Aoste
2021-05-16,LOM,68664,32495,36169,36493,32171,ITC,ITC4,3,Lombardia
2021-05-30,SIC,35768,16170,19598,17721,18047,ITG,ITG1,19,Sicilia
2021-03-05,EMR,17853,5841,12012,14399,3454,ITH,ITH5,8,Emilia-Romagna
2021-02-05,LOM,25687,7454,18233,2417,23270,ITC,ITC4,3,Lombardia
2021-02-27,MAR,3356,1435,1921,3147,209,ITI,ITI3,11,Marche
2021-04-10,CAL,11363,5125,6238,6574,4789,ITF,ITF6,18,Calabria
2021-04-17,SAR,10082,4502,5580,5483,4599,ITG,ITG2,20,Sardegna
2021-02-18,MOL,319,74,245,306,13,ITF,ITF2,14,Molise
2021-03-31,BAS,3094,1258,1836,2312,782,ITF,ITF5,17,Basilicata
2021-05-13,SIC,47223,22143,25080,30732,16491,ITG,ITG1,19,Sicilia
2021-02-12,FVG,1193,428,765,1146,47,ITH,ITH4,6,Friuli-Venezia Giulia
2021-03-22,EMR,17648,7812,9836,10784,6864,ITH,ITH5,8,Emilia-Romagna
2021-06-17,VDA,775,422,353,626,149,ITC,ITC2,2,Valle d'Aosta / Vallée d'Aoste
2021-04-01,TOS,27024,11205,15819,16392,10632,ITI,ITI1,9,Toscana
2021-05-26,PAB,4935,2491,2444,2962,1973,ITH,ITH1,4,Provincia Autonoma Bolzano / Bozen
2021-02-22,LOM,11894,4807,7087,11589,305,ITC,ITC4,3,Lombardia
2021-04-24,LAZ,33397,15063,18334,20624,12773,ITI,ITI4,12,Lazio
2021-04-29,CAM,41324,20035,21289,24846,16478,ITF,ITF3,15,Campania
2021-06-11,PAT,7172,3413,3759,1562,5610,ITH,ITH2,4,Provincia Autonoma Trento
2021-03-15,TOS,8696,3643,5053,4253,4443,ITI,ITI1,9,Toscana
2021-01-19,CAM,1095,474,621,1092,3,ITF,ITF3,15,Campania
2021-06-05,BAS,4796,2206,2590,3853,943,ITF,ITF5,17,Basilicata
2021-01-31,SIC,4032,1927,2105,112,3920,ITG,ITG1,19,Sicilia
2021-03-08,VEN,13629,6271,7358,9560,4069,ITH,ITH3,5,Veneto
2021-03-09,MOL,1329,579,750,1177,152,ITF,ITF2,14,Molise
2021-03-03,EMR,15843,5254,10589,13366,2477,ITH,ITH5,8,Emilia-Romagna
2021-05-11,SIC,32268,15354,16914,19794,12474,ITG,ITG1,19,Sicilia
2021-06-13,PAT,3683,2033,1650,295,3388,ITH,ITH2,4,Provincia Autonoma Trento
2021-02-20,MOL,1018,441,577,998,20,ITF,ITF2,14,Molise
2021-02-17,SIC,5215,3203,2012,4547,668,ITG,ITG1,19,Sicilia
2021-05-17,ABR,11033,5037,5996,6179,4854,ITF,ITF1,13,Abruzzo
2021-02-21,CAL,615,288,327,538,77,ITF,ITF6,18,Calabria
2021-06-18,MOL,2594,1156,1438,1163,1431,ITF,ITF2,14,Molise
2021-03-19,EMR,15925,6973,8952,7956,7969,ITH,ITH5,8,Emilia-Romagna
2021-03-19,PIE,11021,4512,6509,4415,6606,ITC,ITC1,1,Piemonte
2021-03-27,PUG,12152,5707,6445,6984,5168,ITF,ITF4,16,Puglia
2021-04-05,PIE,14748,6234,8514,12191,2557,ITC,ITC1,1,Piemonte
2021-05-01,SAR,9909,4763,5146,5452,4457,ITG,ITG2,20,Sardegna
2021-01-19,VEN,1309,472,837,1159,150,ITH,ITH3,5,Veneto
2021-01-21,SAR,126,60,66,94,32,ITG,ITG2,20,Sardegna
2021-02-06,VDA,289,104,185,92,197,ITC,ITC2,2,Valle d'Aosta / Vallée d'Aoste
2021-03-12,CAM,14571,7408,7163,8488,6083,ITF,ITF3,15,Campania
2021-06-01,LIG,16147,8107,8040,10784,5363,ITC,ITC3,7,Liguria
2021-06-03,LOM,96913,49617,47296,86185,10728,ITC,ITC4,3,Lombardia
2021-06-17,SIC,40943,19072,21871,20095,20848,ITG,ITG1,19,Sicilia
2021-02-07,SAR,1118,395,723,228,890,ITG,ITG2,20,Sardegna
2021-04-28,CAL,12520,6058,6462,9662,2858,ITF,ITF6,18,Calabria
2021-03-07,UMB,845,180,665,838,7,ITI,ITI2,10,Umbria
2021-01-05,PUG,5107,2251,2856,5107,0,ITF,ITF4,16,Puglia
2020-12-27,PAB,144,65,79,144,0,ITH,ITH1,4,Provincia Autonoma Bolzano / Bozen
2021-02-04,CAL,3556,1695,1861,653,2903,ITF,ITF6,18,Calabria
2021-04-30,VDA,831,355,476,485,346,ITC,ITC2,2,Valle d'Aosta / Vallée d'Aoste
2021-05-10,LAZ,44390,20282,24108,31010,13380,ITI,ITI4,12,Lazio
2021-06-18,LIG,14878,7241,7637,9391,5487,ITC,ITC3,7,Liguria
2021-06-20,LOM,63851,31553,32298,36095,27756,ITC,ITC4,3,Lombardia
2021-04-15,PUG,32496,15163,17333,28966,3530,ITF,ITF4,16,Puglia
2021-01-20,VDA,23,8,15,23,0,ITC,ITC2,2,Valle d'Aosta / Vallée d'Aoste
2021-03-12,LOM,35259,12963,22296,25060,10199,ITC,ITC4,3,Lombardia
2021-04-03,MAR,7572,3204,4368,6903,669,ITI,ITI3,11,Marche
2021-04-07,FVG,7789,3594,4195,7007,782,ITH,ITH4,6,Friuli-Venezia Giulia
2021-05-15,CAL,27176,13004,14172,20353,6823,ITF,ITF6,18,Calabria
2021-03-29,LOM,40035,15537,24498,25205,14830,ITC,ITC4,3,Lombardia
2020-12-31,SIC,886,472,414,886,0,ITG,ITG1,19,Sicilia
2021-01-26,TOS,5393,1792,3601,220,5173,ITI,ITI1,9,Toscana
2021-03-30,ABR,5128,2262,2866,3304,1824,ITF,ITF1,13,Abruzzo
2021-03-10,LIG,5899,2861,3038,3993,1906,ITC,ITC3,7,Liguria
2021-05-06,TOS,31326,13616,17710,14174,17152,ITI,ITI1,9,Toscana
2021-06-03,CAM,72490,35134,37356,61876,10614,ITF,ITF3,15,Campania
2021-01-06,ABR,1831,664,1167,1831,0,ITF,ITF1,13,Abruzzo
2021-02-23,CAM,11003,3388,7615,10477,526,ITF,ITF3,15,Campania
2021-04-19,TOS,9090,4504,4586,8062,1028,ITI,ITI1,9,Toscana
2021-05-01,VEN,38843,18233,20610,29900,8943,ITH,ITH3,5,Veneto
2021-05-03,SAR,8184,3819,4365,6588,1596,ITG,ITG2,20,Sardegna
2021-02-02,CAL,2341,1147,1194,177,2164,ITF,ITF6,18,Calabria
2021-05-30,MOL,1828,908,920,1543,285,ITF,ITF2,14,Molise
2021-03-07,SIC,9260,3454,5806,8177,1083,ITG,ITG1,19,Sicilia
2021-04-07,EMR,26110,11889,14221,20098,6012,ITH,ITH5,8,Emilia-Romagna
2021-04-17,TOS,20532,9206,11326,18410,2122,ITI,ITI1,9,Toscana
2021-05-20,SAR,15927,7566,8361,11308,4619,ITG,ITG2,20,Sardegna
2021-01-12,PAT,505,158,347,505,0,ITH,ITH2,4,Provincia Autonoma Trento
2021-01-16,CAL,2397,1122,1275,2397,0,ITF,ITF6,18,Calabria
2021-06-11,PAB,5708,2927,2781,2239,3469,ITH,ITH1,4,Provincia Autonoma Bolzano / Bozen
2021-06-15,SIC,44865,21151,23714,27718,17147,ITG,ITG1,19,Sicilia
2021-02-09,SAR,2287,837,1450,1290,997,ITG,ITG2,20,Sardegna
2021-01-14,EMR,8130,2593,5537,8130,0,ITH,ITH5,8,Emilia-Romagna
2021-03-24,SIC,20873,9800,11073,15212,5661,ITG,ITG1,19,Sicilia
2021-02-26,SAR,2801,1109,1692,2495,306,ITG,ITG2,20,Sardegna
2021-03-20,PAB,1758,849,909,1133,625,ITH,ITH1,4,Provincia Autonoma Bolzano / Bozen
2021-05-27,LAZ,57775,26778,30997,44218,13557,ITI,ITI4,12,Lazio
2021-05-29,UMB,7845,3606,4239,6283,1562,ITI,ITI2,10,Umbria
2021-03-30,BAS,2740,1157,1583,2395,345,ITF,ITF5,17,Basilicata
2021-01-18,VDA,213,74,139,213,0,ITC,ITC2,2,Valle d'Aosta / Vallée d'Aoste
2021-02-21,CAM,5836,2241,3595,5611,225,ITF,ITF3,15,Campania
2021-03-19,PAT,2423,915,1508,1571,852,ITH,ITH2,4,Provincia Autonoma Trento
2021-01-06,BAS,294,129,165,294,0,ITF,ITF5,17,Basilicata
2021-01-24,TOS,3349,1073,2276,201,3148,ITI,ITI1,9,Toscana
2021-03-05,LAZ,19560,8661,10899,14827,4733,ITI,ITI4,12,Lazio
2021-02-16,LAZ,8359,4034,4325,7753,606,ITI,ITI4,12,Lazio
2021-04-05,PAT,35,17,18,33,2,ITH,ITH2,4,Provincia Autonoma Trento
2021-04-16,BAS,3319,1632,1687,2421,898,ITF,ITF5,17,Basilicata
2021-05-29,SIC,47147,21455,25692,23957,23190,ITG,ITG1,19,Sicilia
2021-01-07,TOS,6018,1751,4267,6018,0,ITI,ITI1,9,Toscana
2021-04-11,VDA,479,208,271,479,0,ITC,ITC2,2,Valle d'Aosta / Vallée d'Aoste
2021-06-16,PUG,40470,19902,20568,26426,14044,ITF,ITF4,16,Puglia
2021-04-05,UMB,4251,1729,2522,2196,2055,ITI,ITI2,10,Umbria
2021-04-06,MOL,1494,701,793,1151,343,ITF,ITF2,14,Molise
2021-02-22,TOS,9817,4253,5564,9540,277,ITI,ITI1,9,Toscana
2021-02-07,UMB,54,17,37,1,53,ITI,ITI2,10,Umbria
2021-02-08,MOL,334,141,193,216,118,ITF,ITF2,14,Molise
2021-05-19,MOL,2340,1205,1135,1915,425,ITF,ITF2,14,Molise
2021-06-01,SIC,38726,17621,21105,24961,13765,ITG,ITG1,19,Sicilia
2020-12-30,PAB,388,182,206,388,0,ITH,ITH1,4,Provincia Autonoma Bolzano / Bozen
2021-03-03,CAL,5041,2754,2287,3961,1080,ITF,ITF6,18,Calabria
2021-02-21,BAS,284,113,171,284,0,ITF,ITF5,17,Basilicata
2021-03-23,MOL,1642,694,948,1435,207,ITF,ITF2,14,Molise
2021-04-05,SIC,8021,3958,4063,6581,1440,ITG,ITG1,19,Sicilia
2021-01-15,PAT,595,132,463,595,0,ITH,ITH2,4,Provincia Autonoma Trento
2021-02-17,LIG,2689,1182,1507,2263,426,ITC,ITC3,7,Liguria
2021-03-17,FVG,3236,1267,1969,745,2491,ITH,ITH4,6,Friuli-Venezia Giulia
2021-03-07,BAS,889,309,580,851,38,ITF,ITF5,17,Basilicata
2021-05-13,FVG,11131,5362,5769,9077,2054,ITH,ITH4,6,Friuli-Venezia Giulia
2021-05-28,LIG,16284,8128,8156,11749,4535,ITC,ITC3,7,Liguria
2020-12-30,PUG,1,0,1,1,0,ITF,ITF4,16,Puglia
2021-01-09,BAS,557,160,397,557,0,ITF,ITF5,17,Basilicata
2021-01-05,LIG,2878,895,1983,2878,0,ITC,ITC3,7,Liguria
2021-06-09,PAB,3784,1880,1904,1310,2474,ITH,ITH1,4,Provincia Autonoma Bolzano / Bozen
2021-02-26,VEN,8294,3270,5024,7037,1257,ITH,ITH3,5,Veneto
2021-01-09,LAZ,6298,2562,3736,6298,0,ITI,ITI4,12,Lazio
2021-03-01,PAB,922,221,701,921,1,ITH,ITH1,4,Provincia Autonoma Bolzano / Bozen
2021-04-24,VEN,24747,10823,13924,15668,9079,ITH,ITH3,5,Veneto
2021-05-07,ABR,12194,5706,6488,7776,4418,ITF,ITF1,13,Abruzzo
2021-02-16,FVG,2516,1135,1381,2400,116,ITH,ITH4,6,Friuli-Venezia Giulia
2021-03-03,LIG,4580,1847,2733,3554,1026,ITC,ITC3,7,Liguria
2021-04-12,SAR,6994,3182,3812,5276,1718,ITG,ITG2,20,Sardegna
2021-01-02,SAR,60,21,39,60,0,ITG,ITG2,20,Sardegna
2021-03-15,PAB,1192,451,741,710,482,ITH,ITH1,4,Provincia Autonoma Bolzano / Bozen
2021-05-13,PIE,35649,17513,18136,20557,15092,ITC,ITC1,1,Piemonte
2021-06-08,SAR,14806,7060,7746,11317,3489,ITG,ITG2,20,Sardegna
2021-04-22,MAR,10796,4931,5865,9218,1578,ITI,ITI3,11,Marche
2021-05-20,PAT,5010,2355,2655,3375,1635,ITH,ITH2,4,Provincia Autonoma Trento
2021-02-02,PIE,10242,3509,6733,816,9426,ITC,ITC1,1,Piemonte
2021-02-28,SAR,368,169,199,142,226,ITG,ITG2,20,Sardegna
2021-02-24,MAR,3486,1515,1971,3408,78,ITI,ITI3,11,Marche
2021-03-24,PAT,2376,940,1436,1556,820,ITH,ITH2,4,Provincia Autonoma Trento
2021-03-22,PUG,9858,5037,4821,4212,5646,ITF,ITF4,16,Puglia
2021-03-31,PIE,19110,8104,11006,10416,8694,ITC,ITC1,1,Piemonte
2021-04-19,LAZ,30093,13675,16418,19414,10679,ITI,ITI4,12,Lazio
2021-04-26,SAR,6823,3265,3558,5947,876,ITG,ITG2,20,Sardegna
2021-04-27,PAB,2226,1013,1213,1150,1076,ITH,ITH1,4,Provincia Autonoma Bolzano / Bozen
2021-01-14,VEN,7063,1924,5139,7063,0,ITH,ITH3,5,Veneto
2021-01-17,PAB,2328,1044,1284,2317,11,ITH,ITH1,4,Provincia Autonoma Bolzano / Bozen
2021-01-24,PUG,1670,750,920,154,1516,ITF,ITF4,16,Puglia
2021-02-21,LAZ,6989,3180,3809,6526,463,ITI,ITI4,12,Lazio
2021-02-25,VDA,201,101,100,194,7,ITC,ITC2,2,Valle d'Aosta / Vallée d'Aoste
2021-05-27,PIE,37261,17338,19923,19156,18105,ITC,ITC1,1,Piemonte
2021-02-09,PAT,917,287,630,442,475,ITH,ITH2,4,Provincia Autonoma Trento
2021-03-12,VEN,18646,8189,10457,11903,6743,ITH,ITH3,5,Veneto
2021-06-01,LOM,93852,46051,47801,76837,17015,ITC,ITC4,3,Lombardia
2021-01-02,LOM,200,72,128,200,0,ITC,ITC4,3,Lombardia
2021-02-16,PIE,3967,1756,2211,3209,758,ITC,ITC1,1,Piemonte
2021-06-08,LOM,102250,51994,50256,88253,13997,ITC,ITC4,3,Lombardia
2021-03-15,PUG,12258,6076,6182,5755,6503,ITF,ITF4,16,Puglia
2021-02-28,LOM,7882,3253,4629,7672,210,ITC,ITC4,3,Lombardia
2021-05-03,CAL,14754,6764,7990,10544,4210,ITF,ITF6,18,Calabria
2021-01-17,PUG,1308,590,718,1239,69,ITF,ITF4,16,Puglia
2021-03-14,CAM,8617,3827,4790,4477,4140,ITF,ITF3,15,Campania
2021-02-15,MOL,144,70,74,141,3,ITF,ITF2,14,Molise
2021-03-17,PAT,2070,792,1278,1200,870,ITH,ITH2,4,Provincia Autonoma Trento
2021-04-26,LOM,87932,40920,47012,68774,19158,ITC,ITC4,3,Lombardia
2021-04-27,PUG,26641,12058,14583,21055,5586,ITF,ITF4,16,Puglia
2021-05-07,BAS,4649,2284,2365,3295,1354,ITF,ITF5,17,Basilicata
2021-05-10,CAM,35452,16384,19068,25532,9920,ITF,ITF3,15,Campania
2021-06-04,MAR,14334,7289,7045,11897,2437,ITI,ITI3,11,Marche
2021-03-21,CAL,4454,1925,2529,2734,1720,ITF,ITF6,18,Calabria
2021-04-08,MAR,7520,3285,4235,7193,327,ITI,ITI3,11,Marche
2021-04-12,SIC,18786,9123,9663,11535,7251,ITG,ITG1,19,Sicilia
2021-05-08,TOS,29148,13114,16034,13693,15455,ITI,ITI1,9,Toscana
2021-03-24,FVG,3966,1711,2255,2485,1481,ITH,ITH4,6,Friuli-Venezia Giulia
2021-03-25,ABR,5793,2662,3131,3177,2616,ITF,ITF1,13,Abruzzo
2021-02-14,SIC,1055,402,653,915,140,ITG,ITG1,19,Sicilia
2021-03-12,TOS,16973,6611,10362,13445,3528,ITI,ITI1,9,Toscana
2021-04-28,EMR,33714,15586,18128,20826,12888,ITH,ITH5,8,Emilia-Romagna
2021-01-27,ABR,1364,515,849,39,1325,ITF,ITF1,13,Abruzzo
2021-05-20,FVG,12656,6285,6371,10144,2512,ITH,ITH4,6,Friuli-Venezia Giulia
2021-06-08,CAM,51470,25035,26435,44487,6983,ITF,ITF3,15,Campania
2021-01-14,TOS,3256,1180,2076,3256,0,ITI,ITI1,9,Toscana
2021-03-07,CAL,3356,1711,1645,3265,91,ITF,ITF6,18,Calabria
2021-06-20,TOS,14440,7054,7386,8696,5744,ITI,ITI1,9,Toscana
2021-06-05,UMB,8214,3772,4442,5561,2653,ITI,ITI2,10,Umbria
2021-01-02,SIC,4841,2520,2321,4841,0,ITG,ITG1,19,Sicilia
2021-04-24,TOS,13437,6167,7270,5990,7447,ITI,ITI1,9,Toscana
2021-06-15,CAL,9564,4426,5138,6259,3305,ITF,ITF6,18,Calabria
2021-01-26,FVG,1977,647,1330,217,1760,ITH,ITH4,6,Friuli-Venezia Giulia
2021-04-26,CAM,34028,16647,17381,28405,5623,ITF,ITF3,15,Campania
2021-05-21,ABR,13018,6327,6691,8037,4981,ITF,ITF1,13,Abruzzo
2021-04-17,VEN,22414,9083,13331,15134,7280,ITH,ITH3,5,Veneto
2021-02-24,LIG,3764,1560,2204,3506,258,ITC,ITC3,7,Liguria
2021-04-20,PAB,1561,784,777,1560,1,ITH,ITH1,4,Provincia Autonoma Bolzano / Bozen
2021-01-07,VEN,8359,2317,6042,8359,0,ITH,ITH3,5,Veneto
2021-06-13,VEN,36872,19033,17839,29912,6960,ITH,ITH3,5,Veneto
2021-02-18,ABR,2288,933,1355,2158,130,ITF,ITF1,13,Abruzzo
2021-03-17,EMR,13721,5693,8028,5875,7846,ITH,ITH5,8,Emilia-Romagna
2021-05-18,VEN,26866,12500,14366,13298,13568,ITH,ITH3,5,Veneto
2021-05-30,PAT,1770,872,898,930,840,ITH,ITH2,4,Provincia Autonoma Trento
2021-01-29,LIG,3079,1064,2015,67,3012,ITC,ITC3,7,Liguria
2021-03-27,TOS,8862,4152,4710,8647,215,ITI,ITI1,9,Toscana
2021-05-13,EMR,35712,16450,19262,27933,7779,ITH,ITH5,8,Emilia-Romagna
2021-05-29,ABR,10317,4430,5887,4544,5773,ITF,ITF1,13,Abruzzo
2021-03-06,MAR,5699,2622,3077,4432,1267,ITI,ITI3,11,Marche
2021-04-03,PAT,1138,471,667,971,167,ITH,ITH2,4,Provincia Autonoma Trento
2021-06-06,UMB,7610,3903,3707,6917,693,ITI,ITI2,10,Umbria
2021-01-09,VDA,443,199,244,443,0,ITC,ITC2,2,Valle d'Aosta / Vallée d'Aoste
2021-04-29,LAZ,38632,17239,21393,25400,13232,ITI,ITI4,12,Lazio
2021-01-20,MOL,18,8,10,18,0,ITF,ITF2,14,Molise
2021-01-24,CAL,44,18,26,39,5,ITF,ITF6,18,Calabria
2021-03-03,LAZ,17834,7850,9984,13540,4294,ITI,ITI4,12,Lazio
2021-06-06,PIE,34995,18289,16706,32566,2429,ITC,ITC1,1,Piemonte
2021-03-22,VEN,18136,8174,9962,13095,5041,ITH,ITH3,5,Veneto
2021-04-30,MOL,2937,1556,1381,830,2107,ITF,ITF2,14,Molise
2021-05-11,CAM,39843,19231,20612,30463,9380,ITF,ITF3,15,Campania
2021-01-20,LIG,1551,555,996,1539,12,ITC,ITC3,7,Liguria
2021-06-18,LOM,106125,52251,53874,53776,52349,ITC,ITC4,3,Lombardia
2021-03-13,VEN,17228,7302,9926,14097,3131,ITH,ITH3,5,Veneto
2021-03-25,PUG,11428,5760,5668,5187,6241,ITF,ITF4,16,Puglia
2021-02-24,UMB,1520,565,955,1505,15,ITI,ITI2,10,Umbria
2021-02-25,MOL,541,239,302,473,68,ITF,ITF2,14,Molise
2021-03-15,EMR,13445,6242,7203,6946,6499,ITH,ITH5,8,Emilia-Romagna
2021-05-22,ABR,13101,6364,6737,8198,4903,ITF,ITF1,13,Abruzzo
2021-06-14,MAR,12615,6377,6238,9307,3308,ITI,ITI3,11,Marche
2021-04-27,SAR,7615,3550,4065,5573,2042,ITG,ITG2,20,Sardegna
2021-01-15,VEN,5875,1820,4055,5875,0,ITH,ITH3,5,Veneto
2021-03-09,PAB,1194,543,651,1192,2,ITH,ITH1,4,Provincia Autonoma Bolzano / Bozen
2021-03-26,ABR,5354,2311,3043,3279,2075,ITF,ITF1,13,Abruzzo
2021-01-17,SAR,860,277,583,859,1,ITG,ITG2,20,Sardegna
2021-02-17,PIE,4794,2157,2637,3804,990,ITC,ITC1,1,Piemonte
2021-02-24,SIC,9306,4760,4546,8746,560,ITG,ITG1,19,Sicilia
2021-03-15,SAR,2798,1318,1480,2425,373,ITG,ITG2,20,Sardegna
2021-05-30,FVG,11056,4986,6070,7472,3584,ITH,ITH4,6,Friuli-Venezia Giulia
2021-03-01,LOM,18776,8227,10549,17071,1705,ITC,ITC4,3,Lombardia
2021-02-08,PUG,3991,1610,2381,1597,2394,ITF,ITF4,16,Puglia
2021-05-31,ABR,11297,5103,6194,6954,4343,ITF,ITF1,13,Abruzzo
2021-01-21,SIC,1429,701,728,501,928,ITG,ITG1,19,Sicilia
2021-04-20,ABR,5591,2691,2900,4181,1410,ITF,ITF1,13,Abruzzo
2021-04-24,PAT,3519,1685,1834,3505,14,ITH,ITH2,4,Provincia Autonoma Trento
2021-01-26,LAZ,7961,3127,4834,725,7236,ITI,ITI4,12,Lazio
2021-02-26,PAT,1218,435,783,923,295,ITH,ITH2,4,Provincia Autonoma Trento
2021-05-01,SIC,24430,11305,13125,19276,5154,ITG,ITG1,19,Sicilia
2021-02-14,TOS,9000,2569,6431,8890,110,ITI,ITI1,9,Toscana
2021-03-26,SAR,8436,3490,4946,6910,1526,ITG,ITG2,20,Sardegna
2021-06-08,PIE,37445,19408,18037,34680,2765,ITC,ITC1,1,Piemonte
2021-05-20,VEN,44707,21195,23512,20396,24311,ITH,ITH3,5,Veneto
2021-05-22,SAR,24796,11934,12862,19699,5097,ITG,ITG2,20,Sardegna
2021-05-23,PAB,4338,2303,2035,4330,8,ITH,ITH1,4,Provincia Autonoma Bolzano / Bozen
2021-05-25,TOS,34131,16462,17669,19531,14600,ITI,ITI1,9,Toscana
2021-01-14,PAT,700,203,497,700,0,ITH,ITH2,4,Provincia Autonoma Trento
2021-02-09,VEN,5248,1890,3358,3446,1802,ITH,ITH3,5,Veneto
2021-05-10,UMB,5985,2801,3184,3832,2153,ITI,ITI2,10,Umbria
2021-03-29,TOS,9641,4812,4829,9317,324,ITI,ITI1,9,Toscana
2021-04-26,PIE,19771,8737,11034,15371,4400,ITC,ITC1,1,Piemonte
2021-02-13,BAS,799,313,486,738,61,ITF,ITF5,17,Basilicata
2020-12-28,CAL,6,2,4,6,0,ITF,ITF6,18,Calabria
2021-02-03,PAB,1503,478,1025,5,1498,ITH,ITH1,4,Provincia Autonoma Bolzano / Bozen
2021-04-02,LAZ,29254,13968,15286,21917,7337,ITI,ITI4,12,Lazio
2021-06-03,CAL,14152,6623,7529,9580,4572,ITF,ITF6,18,Calabria
2021-05-15,LOM,80914,38788,42126,47539,33375,ITC,ITC4,3,Lombardia
2021-05-24,BAS,4832,2343,2489,1102,3730,ITF,ITF5,17,Basilicata
2021-01-19,SAR,747,270,477,692,55,ITG,ITG2,20,Sardegna
2021-04-07,CAL,6546,2957,3589,3750,2796,ITF,ITF6,18,Calabria
2021-01-29,MAR,1991,730,1261,167,1824,ITI,ITI3,11,Marche
2021-02-08,VDA,223,83,140,25,198,ITC,ITC2,2,Valle d'Aosta / Vallée d'Aoste
2021-02-10,PUG,3645,1436,2209,2134,1511,ITF,ITF4,16,Puglia
2021-03-17,SAR,6560,2852,3708,4952,1608,ITG,ITG2,20,Sardegna
2021-02-09,EMR,4156,1249,2907,2309,1847,ITH,ITH5,8,Emilia-Romagna
2021-02-23,CAL,1591,753,838,1476,115,ITF,ITF6,18,Calabria
2021-04-25,ABR,9065,4621,4444,8255,810,ITF,ITF1,13,Abruzzo
2021-05-18,MAR,11059,5257,5802,7655,3404,ITI,ITI3,11,Marche
2021-02-28,PAT,242,121,121,242,0,ITH,ITH2,4,Provincia Autonoma Trento
2021-03-23,VDA,379,150,229,245,134,ITC,ITC2,2,Valle d'Aosta / Vallée d'Aoste
2021-05-08,UMB,8109,3733,4376,4908,3201,ITI,ITI2,10,Umbria
2021-05-19,VDA,993,498,495,418,575,ITC,ITC2,2,Valle d'Aosta / Vallée d'Aoste
2021-06-08,PAT,5914,2863,3051,1870,4044,ITH,ITH2,4,Provincia Autonoma Trento
2021-01-28,LAZ,8279,3165,5114,782,7497,ITI,ITI4,12,Lazio
2021-02-02,CAM,5724,2805,2919,444,5280,ITF,ITF3,15,Campania
2021-02-10,PAB,1635,604,1031,26,1609,ITH,ITH1,4,Provincia Autonoma Bolzano / Bozen
2021-05-10,SIC,28245,13577,14668,16155,12090,ITG,ITG1,19,Sicilia
2021-03-31,CAM,23175,11365,11810,19736,3439,ITF,ITF3,15,Campania
2021-05-08,LAZ,45299,20663,24636,29905,15394,ITI,ITI4,12,Lazio
2021-01-28,UMB,1248,394,854,19,1229,ITI,ITI2,10,Umbria
2021-01-29,MOL,421,136,285,6,415,ITF,ITF2,14,Molise
2021-04-26,PAT,2652,1250,1402,2558,94,ITH,ITH2,4,Provincia Autonoma Trento
2021-05-09,MOL,2051,932,1119,1955,96,ITF,ITF2,14,Molise
2021-05-13,LOM,87033,41722,45311,58265,28768,ITC,ITC4,3,Lombardia
2021-05-23,PUG,17872,8354,9518,14068,3804,ITF,ITF4,16,Puglia
2021-02-02,LOM,19866,6592,13274,497,19369,ITC,ITC4,3,Lombardia
2021-03-26,SIC,17806,8279,9527,12376,5430,ITG,ITG1,19,Sicilia
2021-06-02,BAS,5959,2804,3155,4416,1543,ITF,ITF5,17,Basilicata
2021-03-31,LOM,42038,17042,24996,26812,15226,ITC,ITC4,3,Lombardia
2021-04-23,BAS,4536,2185,2351,3536,1000,ITF,ITF5,17,Basilicata
2021-05-23,MOL,1699,863,836,1694,5,ITF,ITF2,14,Molise
2021-04-10,TOS,11720,5348,6372,10977,743,ITI,ITI1,9,Toscana
2021-04-14,EMR,27034,12836,14198,20929,6105,ITH,ITH5,8,Emilia-Romagna
2021-01-19,PAT,406,77,329,406,0,ITH,ITH2,4,Provincia Autonoma Trento
2021-01-30,BAS,705,228,477,129,576,ITF,ITF5,17,Basilicata
2021-03-01,PUG,15103,5868,9235,13732,1371,ITF,ITF4,16,Puglia
2021-02-13,ABR,854,385,469,438,416,ITF,ITF1,13,Abruzzo
2021-04-19,CAL,7849,3785,4064,6179,1670,ITF,ITF6,18,Calabria
2021-01-21,EMR,2165,729,1436,819,1346,ITH,ITH5,8,Emilia-Romagna
2021-02-11,UMB,842,349,493,837,5,ITI,ITI2,10,Umbria
2021-05-22,SIC,47972,22782,25190,28646,19326,ITG,ITG1,19,Sicilia
2021-05-22,UMB,6962,2753,4209,2642,4320,ITI,ITI2,10,Umbria
2021-02-28,SIC,7163,3062,4101,6533,630,ITG,ITG1,19,Sicilia
2021-02-28,CAM,10411,3206,7205,8511,1900,ITF,ITF3,15,Campania
2021-01-09,CAL,1930,1041,889,1930,0,ITF,ITF6,18,Calabria
2021-06-08,SIC,47465,22304,25161,40949,6516,ITG,ITG1,19,Sicilia
2021-03-18,VDA,136,43,93,99,37,ITC,ITC2,2,Valle d'Aosta / Vallée d'Aoste
2021-06-03,FVG,12223,6664,5559,10253,1970,ITH,ITH4,6,Friuli-Venezia Giulia
2021-03-04,ABR,5936,2360,3576,5014,922,ITF,ITF1,13,Abruzzo
2021-04-05,SAR,2036,784,1252,2035,1,ITG,ITG2,20,Sardegna
2021-01-31,LOM,9734,3762,5972,29,9705,ITC,ITC4,3,Lombardia
2021-02-14,CAM,3928,1923,2005,3894,34,ITF,ITF3,15,Campania
2021-02-22,PAB,526,143,383,514,12,ITH,ITH1,4,Provincia Autonoma Bolzano / Bozen
2021-03-14,LAZ,17231,6744,10487,12077,5154,ITI,ITI4,12,Lazio
2021-05-06,LIG,14489,6431,8058,6172,8317,ITC,ITC3,7,Liguria
2021-03-19,VEN,13790,5668,8122,7696,6094,ITH,ITH3,5,Veneto
2021-05-25,LOM,91061,43579,47482,44621,46440,ITC,ITC4,3,Lombardia
2021-03-04,VDA,291,139,152,42,249,ITC,ITC2,2,Valle d'Aosta / Vallée d'Aoste
2021-02-14,LOM,3578,1545,2033,2943,635,ITC,ITC4,3,Lombardia
2021-05-26,VDA,1209,587,622,576,633,ITC,ITC2,2,Valle d'Aosta / Vallée d'Aoste
2021-03-01,MOL,661,274,387,447,214,ITF,ITF2,14,Molise
2021-04-29,MAR,13247,6062,7185,7150,6097,ITI,ITI3,11,Marche
2021-01-26,LIG,2490,807,1683,19,2471,ITC,ITC3,7,Liguria
2021-01-12,LOM,20215,6697,13518,20215,0,ITC,ITC4,3,Lombardia
2021-01-26,CAM,7340,3726,3614,351,6989,ITF,ITF3,15,Campania
2021-03-10,PAT,2403,929,1474,1482,921,ITH,ITH2,4,Provincia Autonoma Trento
2021-01-19,FVG,6,2,4,6,0,ITH,ITH4,6,Friuli-Venezia Giulia
2021-03-04,BAS,1881,892,989,1085,796,ITF,ITF5,17,Basilicata
2021-04-03,MOL,1771,850,921,1736,35,ITF,ITF2,14,Molise
2021-01-09,SIC,7121,3352,3769,7121,0,ITG,ITG1,19,Sicilia
2021-02-19,TOS,8294,2953,5341,7781,513,ITI,ITI1,9,Toscana
2021-06-03,EMR,37837,18412,19425,30342,7495,ITH,ITH5,8,Emilia-Romagna
2021-06-03,PIE,34385,17699,16686,30063,4322,ITC,ITC1,1,Piemonte
2021-01-10,PUG,2348,1061,1287,2348,0,ITF,ITF4,16,Puglia
2021-02-23,EMR,8215,3219,4996,7829,386,ITH,ITH5,8,Emilia-Romagna
2021-04-20,PUG,21125,9807,11318,17662,3463,ITF,ITF4,16,Puglia
2021-05-03,SIC,23324,10797,12527,13537,9787,ITG,ITG1,19,Sicilia
2021-03-12,EMR,18303,7702,10601,11586,6717,ITH,ITH5,8,Emilia-Romagna
2020-12-27,PUG,509,252,257,509,0,ITF,ITF4,16,Puglia
2021-04-02,UMB,4312,1747,2565,3555,757,ITI,ITI2,10,Umbria
2021-04-19,CAM,30769,14829,15940,19199,11570,ITF,ITF3,15,Campania
2021-05-28,ABR,13983,6292,7691,7631,6352,ITF,ITF1,13,Abruzzo
2021-06-12,BAS,3674,1687,1987,2988,686,ITF,ITF5,17,Basilicata
2021-01-09,UMB,1745,499,1246,1745,0,ITI,ITI2,10,Umbria
2021-04-19,SIC,18241,8638,9603,12662,5579,ITG,ITG1,19,Sicilia
2021-01-09,CAM,10567,5024,5543,10567,0,ITF,ITF3,15,Campania
2021-02-28,CAL,2329,1056,1273,2176,153,ITF,ITF6,18,Calabria
2021-04-19,UMB,5019,2218,2801,2970,2049,ITI,ITI2,10,Umbria
2021-05-13,VEN,44174,21800,22374,34279,9895,ITH,ITH3,5,Veneto
2021-05-29,CAL,19223,8932,10291,9394,9829,ITF,ITF6,18,Calabria
2021-02-02,VEN,6509,1879,4630,397,6112,ITH,ITH3,5,Veneto
2021-03-13,MOL,1189,594,595,200,989,ITF,ITF2,14,Molise
2021-01-24,MAR,881,339,542,5,876,ITI,ITI3,11,Marche
2021-02-07,LIG,407,153,254,2,405,ITC,ITC3,7,Liguria
2021-03-07,FVG,2547,932,1615,2546,1,ITH,ITH4,6,Friuli-Venezia Giulia
2021-06-07,ABR,11054,5281,5773,9238,1816,ITF,ITF1,13,Abruzzo
2021-01-15,MOL,538,242,296,538,0,ITF,ITF2,14,Molise
2021-04-11,ABR,5330,2606,2724,4847,483,ITF,ITF1,13,Abruzzo
2021-05-04,MAR,10841,4788,6053,4949,5892,ITI,ITI3,11,Marche
2021-05-18,LIG,13452,6115,7337,10167,3285,ITC,ITC3,7,Liguria
2021-05-30,PAB,4759,2514,2245,752,4007,ITH,ITH1,4,Provincia Autonoma Bolzano / Bozen
2021-03-05,PAT,2247,703,1544,1680,567,ITH,ITH2,4,Provincia Autonoma Trento
2021-03-12,SIC,12772,5490,7282,10777,1995,ITG,ITG1,19,Sicilia
2021-06-09,ABR,11367,5997,5370,9688,1679,ITF,ITF1,13,Abruzzo
2021-05-15,SAR,13787,6425,7362,10354,3433,ITG,ITG2,20,Sardegna
2021-01-07,PAT,1270,310,960,1270,0,ITH,ITH2,4,Provincia Autonoma Trento
2021-05-14,VDA,960,442,518,291,669,ITC,ITC2,2,Valle d'Aosta / Vallée d'Aoste
2020-12-31,FVG,1053,384,669,1053,0,ITH,ITH4,6,Friuli-Venezia Giulia
2021-04-05,TOS,15280,6823,8457,14543,737,ITI,ITI1,9,Toscana
2021-06-15,PIE,38740,19959,18781,27010,11730,ITC,ITC1,1,Piemonte
2021-03-21,UMB,675,338,337,675,0,ITI,ITI2,10,Umbria
2021-03-31,VEN,38791,16377,22414,31298,7493,ITH,ITH3,5,Veneto
2021-02-07,TOS,2806,952,1854,886,1920,ITI,ITI1,9,Toscana
2021-03-07,PIE,11977,4658,7319,11099,878,ITC,ITC1,1,Piemonte
2021-04-03,PAB,831,364,467,22,809,ITH,ITH1,4,Provincia Autonoma Bolzano / Bozen
2021-03-25,PAB,2149,1063,1086,1706,443,ITH,ITH1,4,Provincia Autonoma Bolzano / Bozen
2021-04-14,CAL,8157,3926,4231,6710,1447,ITF,ITF6,18,Calabria
2021-05-22,LAZ,54997,26940,28057,44334,10663,ITI,ITI4,12,Lazio
2021-04-04,BAS,610,225,385,197,413,ITF,ITF5,17,Basilicata
2021-02-16,CAL,1737,733,1004,1459,278,ITF,ITF6,18,Calabria
2021-05-17,UMB,6371,3062,3309,4193,2178,ITI,ITI2,10,Umbria
2021-04-01,PUG,13856,6476,7380,7510,6346,ITF,ITF4,16,Puglia
2021-01-14,UMB,752,201,551,752,0,ITI,ITI2,10,Umbria
2021-03-20,MAR,4134,1739,2395,1048,3086,ITI,ITI3,11,Marche
2021-04-17,PAT,2207,1122,1085,2150,57,ITH,ITH2,4,Provincia Autonoma Trento
2020-12-31,PIE,3909,1334,2575,3909,0,ITC,ITC1,1,Piemonte
2021-01-26,SAR,1336,453,883,27,1309,ITG,ITG2,20,Sardegna
2021-01-27,PAB,84,28,56,1,83,ITH,ITH1,4,Provincia Autonoma Bolzano / Bozen
2021-02-03,PUG,5037,2005,3032,730,4307,ITF,ITF4,16,Puglia
2021-03-31,EMR,25270,11045,14225,19813,5457,ITH,ITH5,8,Emilia-Romagna
2021-01-22,MAR,487,167,320,194,293,ITI,ITI3,11,Marche
2021-06-17,FVG,11049,5583,5466,2234,8815,ITH,ITH4,6,Friuli-Venezia Giulia
2021-02-01,VDA,404,127,277,87,317,ITC,ITC2,2,Valle d'Aosta / Vallée d'Aoste
2021-03-19,UMB,1743,565,1178,1087,656,ITI,ITI2,10,Umbria
2021-04-19,PAT,2625,1235,1390,2603,22,ITH,ITH2,4,Provincia Autonoma Trento
2021-03-30,VDA,402,223,179,382,20,ITC,ITC2,2,Valle d'Aosta / Vallée d'Aoste
2021-03-24,CAM,17919,8368,9551,14962,2957,ITF,ITF3,15,Campania
2021-05-20,LIG,12848,5964,6884,8827,4021,ITC,ITC3,7,Liguria
2021-05-27,CAL,17562,8670,8892,9812,7750,ITF,ITF6,18,Calabria
2021-05-15,LAZ,57138,27295,29843,40645,16493,ITI,ITI4,12,Lazio
2021-05-20,CAM,60710,28069,32641,43162,17548,ITF,ITF3,15,Campania
2021-05-12,VDA,1140,549,591,470,670,ITC,ITC2,2,Valle d'Aosta / Vallée d'Aoste
2021-06-15,PAT,6220,3271,2949,1714,4506,ITH,ITH2,4,Provincia Autonoma Trento
2021-02-09,CAM,4643,2202,2441,4391,252,ITF,ITF3,15,Campania
2021-03-06,ABR,4177,1358,2819,3607,570,ITF,ITF1,13,Abruzzo
2021-03-19,LAZ,17306,7453,9853,10978,6328,ITI,ITI4,12,Lazio
2021-03-20,MOL,2321,968,1353,1000,1321,ITF,ITF2,14,Molise
2021-03-24,LOM,43228,15604,27624,31350,11878,ITC,ITC4,3,Lombardia
2021-05-18,TOS,28842,14269,14573,20016,8826,ITI,ITI1,9,Toscana
2021-05-29,CAM,67791,32247,35544,43937,23854,ITF,ITF3,15,Campania
2021-02-09,LOM,12206,3331,8875,4033,8173,ITC,ITC4,3,Lombardia
2021-03-26,EMR,23708,10116,13592,17272,6436,ITH,ITH5,8,Emilia-Romagna
2021-05-08,SAR,13087,5970,7117,10798,2289,ITG,ITG2,20,Sardegna
2021-04-22,TOS,35727,15304,20423,18287,17440,ITI,ITI1,9,Toscana
2021-03-08,PAT,1411,434,977,1057,354,ITH,ITH2,4,Provincia Autonoma Trento
2021-04-06,MAR,8877,3693,5184,8065,812,ITI,ITI3,11,Marche
2021-02-24,TOS,10371,4467,5904,10174,197,ITI,ITI1,9,Toscana
2021-03-15,FVG,3952,1809,2143,1631,2321,ITH,ITH4,6,Friuli-Venezia Giulia
2021-06-08,EMR,44592,22836,21756,37175,7417,ITH,ITH5,8,Emilia-Romagna
2021-03-22,PAT,2307,973,1334,1432,875,ITH,ITH2,4,Provincia Autonoma Trento
2021-06-04,TOS,28241,13374,14867,20490,7751,ITI,ITI1,9,Toscana
2021-01-24,PAT,547,276,271,224,323,ITH,ITH2,4,Provincia Autonoma Trento
2021-05-20,UMB,9846,4593,5253,6198,3648,ITI,ITI2,10,Umbria
2021-02-09,VDA,251,84,167,68,183,ITC,ITC2,2,Valle d'Aosta / Vallée d'Aoste
2021-03-06,PUG,16144,6125,10019,14056,2088,ITF,ITF4,16,Puglia
2021-04-03,LAZ,24781,11179,13602,18081,6700,ITI,ITI4,12,Lazio
2021-04-08,TOS,29681,12555,17126,23294,6387,ITI,ITI1,9,Toscana
2020-12-31,CAM,1490,811,679,1490,0,ITF,ITF3,15,Campania
2021-02-10,VEN,4751,1588,3163,3697,1054,ITH,ITH3,5,Veneto
2021-03-23,MAR,5789,2529,3260,2262,3527,ITI,ITI3,11,Marche
2021-06-06,CAM,62316,30977,31339,61670,646,ITF,ITF3,15,Campania
2021-01-07,CAL,2189,1067,1122,2189,0,ITF,ITF6,18,Calabria
2021-01-08,PUG,5633,2362,3271,5633,0,ITF,ITF4,16,Puglia
2021-02-13,PAB,318,79,239,312,6,ITH,ITH1,4,Provincia Autonoma Bolzano / Bozen
2021-06-13,CAL,6590,3240,3350,5561,1029,ITF,ITF6,18,Calabria
2021-06-14,PUG,41222,20166,21056,28981,12241,ITF,ITF4,16,Puglia
2021-02-06,MOL,429,179,250,29,400,ITF,ITF2,14,Molise
2021-02-26,CAM,13336,4228,9108,12001,1335,ITF,ITF3,15,Campania
2021-04-08,VEN,32325,14349,17976,24447,7878,ITH,ITH3,5,Veneto
2021-04-11,PAB,2720,1291,1429,2543,177,ITH,ITH1,4,Provincia Autonoma Bolzano / Bozen
2021-04-17,CAL,10821,5072,5749,9045,1776,ITF,ITF6,18,Calabria
2021-04-18,PUG,22577,10798,11779,21514,1063,ITF,ITF4,16,Puglia
2021-02-08,MAR,833,258,575,371,462,ITI,ITI3,11,Marche
2021-04-24,CAM,36355,17525,18830,25108,11247,ITF,ITF3,15,Campania
2021-06-17,BAS,4416,2030,2386,2100,2316,ITF,ITF5,17,Basilicata
2021-02-20,PUG,2971,1080,1891,2714,257,ITF,ITF4,16,Puglia
2021-03-27,SAR,5735,2192,3543,5313,422,ITG,ITG2,20,Sardegna
2021-05-01,CAL,16628,7934,8694,12432,4196,ITF,ITF6,18,Calabria
2021-05-11,FVG,9019,4326,4693,7217,1802,ITH,ITH4,6,Friuli-Venezia Giulia
2021-04-21,BAS,3922,1835,2087,2272,1650,ITF,ITF5,17,Basilicata
2021-05-19,MAR,11469,5272,6197,8561,2908,ITI,ITI3,11,Marche
2021-01-31,FVG,2716,837,1879,385,2331,ITH,ITH4,6,Friuli-Venezia Giulia
2021-02-15,LIG,2262,839,1423,1865,397,ITC,ITC3,7,Liguria
2021-03-05,CAL,6232,3615,2617,5659,573,ITF,ITF6,18,Calabria
2021-05-23,SAR,9966,4806,5160,7721,2245,ITG,ITG2,20,Sardegna
2021-05-24,PAB,1444,762,682,1110,334,ITH,ITH1,4,Provincia Autonoma Bolzano / Bozen
2021-05-05,ABR,11654,5585,6069,6449,5205,ITF,ITF1,13,Abruzzo
2021-02-12,SAR,2237,933,1304,2178,59,ITG,ITG2,20,Sardegna
2021-03-27,SIC,15587,7352,8235,10735,4852,ITG,ITG1,19,Sicilia
2021-04-27,PIE,22596,10212,12384,17451,5145,ITC,ITC1,1,Piemonte
2021-03-09,ABR,5167,1795,3372,4229,938,ITF,ITF1,13,Abruzzo
2021-01-03,LIG,734,230,504,734,0,ITC,ITC3,7,Liguria
2021-01-17,PIE,3518,1168,2350,2870,648,ITC,ITC1,1,Piemonte
2021-01-29,SIC,9122,4228,4894,425,8697,ITG,ITG1,19,Sicilia
2021-04-10,SAR,10491,4748,5743,8555,1936,ITG,ITG2,20,Sardegna
2021-02-20,PAB,1802,540,1262,1784,18,ITH,ITH1,4,Provincia Autonoma Bolzano / Bozen
2021-06-04,VEN,49349,25698,23651,41295,8054,ITH,ITH3,5,Veneto
2021-02-12,SIC,4585,1810,2775,4319,266,ITG,ITG1,19,Sicilia
2021-03-15,PIE,10661,4164,6497,5041,5620,ITC,ITC1,1,Piemonte
2021-02-24,VEN,8614,3678,4936,8128,486,ITH,ITH3,5,Veneto
2021-04-10,CAM,28351,13492,14859,23438,4913,ITF,ITF3,15,Campania
2021-04-18,PAB,3110,1607,1503,2100,1010,ITH,ITH1,4,Provincia Autonoma Bolzano / Bozen
2021-05-11,PIE,32049,15452,16597,18850,13199,ITC,ITC1,1,Piemonte
2021-05-23,SIC,34099,16595,17504,20071,14028,ITG,ITG1,19,Sicilia
2021-01-31,PIE,4113,1753,2360,112,4001,ITC,ITC1,1,Piemonte
2021-05-23,LOM,60746,28920,31826,26794,33952,ITC,ITC4,3,Lombardia
2021-02-12,LOM,13957,4362,9595,9025,4932,ITC,ITC4,3,Lombardia
2021-02-19,LAZ,10045,5080,4965,9214,831,ITI,ITI4,12,Lazio
2021-06-17,ABR,10677,5348,5329,7302,3375,ITF,ITF1,13,Abruzzo
2021-04-10,LOM,52703,21827,30876,40749,11954,ITC,ITC4,3,Lombardia
2021-06-06,LOM,89820,46176,43644,80602,9218,ITC,ITC4,3,Lombardia
2021-01-07,LOM,11755,3634,8121,11755,0,ITC,ITC4,3,Lombardia
2021-03-03,TOS,18227,6537,11690,14621,3606,ITI,ITI1,9,Toscana
2021-06-04,MOL,3025,1485,1540,2583,442,ITF,ITF2,14,Molise
2021-01-18,BAS,463,157,306,364,99,ITF,ITF5,17,Basilicata
2021-01-05,TOS,5249,1755,3494,5249,0,ITI,ITI1,9,Toscana
2021-04-08,MOL,1766,903,863,1564,202,ITF,ITF2,14,Molise
2021-06-10,SIC,50856,23883,26973,43806,7050,ITG,ITG1,19,Sicilia
2021-01-15,PUG,4552,1866,2686,4552,0,ITF,ITF4,16,Puglia
2021-04-19,EMR,20897,9796,11101,14624,6273,ITH,ITH5,8,Emilia-Romagna
2021-01-31,PAT,75,15,60,1,74,ITH,ITH2,4,Provincia Autonoma Trento
2021-03-31,UMB,3903,1733,2170,2216,1687,ITI,ITI2,10,Umbria
2021-01-09,EMR,9986,3451,6535,9986,0,ITH,ITH5,8,Emilia-Romagna
2021-06-15,EMR,42750,21972,20778,27916,14834,ITH,ITH5,8,Emilia-Romagna
2021-03-16,BAS,1906,801,1105,229,1677,ITF,ITF5,17,Basilicata
2021-03-07,EMR,7842,2958,4884,6322,1520,ITH,ITH5,8,Emilia-Romagna
2021-02-16,UMB,1308,655,653,1299,9,ITI,ITI2,10,Umbria
2021-05-27,SIC,47408,21763,25645,24855,22553,ITG,ITG1,19,Sicilia
2021-05-03,EMR,28694,13554,15140,17816,10878,ITH,ITH5,8,Emilia-Romagna
2021-01-07,CAM,8911,4167,4744,8911,0,ITF,ITF3,15,Campania
2021-05-27,UMB,9971,4863,5108,8653,1318,ITI,ITI2,10,Umbria
2021-01-19,TOS,1105,532,573,1105,0,ITI,ITI1,9,Toscana
2021-03-12,CAL,5150,2464,2686,4088,1062,ITF,ITF6,18,Calabria
2021-01-04,UMB,810,398,412,810,0,ITI,ITI2,10,Umbria
2021-03-05,CAM,16810,6663,10147,10147,6663,ITF,ITF3,15,Campania
2021-04-14,SIC,20113,9722,10391,11417,8696,ITG,ITG1,19,Sicilia
2021-01-14,CAL,2638,1251,1387,2638,0,ITF,ITF6,18,Calabria
2021-04-14,UMB,8157,3677,4480,6178,1979,ITI,ITI2,10,Umbria
2021-05-29,FVG,12009,5841,6168,7022,4987,ITH,ITH4,6,Friuli-Venezia Giulia
2021-06-17,LAZ,65492,31374,34118,32073,33419,ITI,ITI4,12,Lazio
2020-12-29,LIG,125,33,92,125,0,ITC,ITC3,7,Liguria
2021-01-10,PAB,2,2,0,2,0,ITH,ITH1,4,Provincia Autonoma Bolzano / Bozen
2021-06-16,PAB,3233,1760,1473,8,3225,ITH,ITH1,4,Provincia Autonoma Bolzano / Bozen
2021-03-18,ABR,3896,1651,2245,2065,1831,ITF,ITF1,13,Abruzzo
2021-01-12,LIG,2459,885,1574,2459,0,ITC,ITC3,7,Liguria
2021-02-09,FVG,1842,555,1287,1556,286,ITH,ITH4,6,Friuli-Venezia Giulia
2021-06-01,SAR,14316,6652,7664,9728,4588,ITG,ITG2,20,Sardegna
2021-02-21,SAR,1589,710,879,1559,30,ITG,ITG2,20,Sardegna
2021-04-22,LIG,13819,6197,7622,8747,5072,ITC,ITC3,7,Liguria
2021-01-21,VEN,2293,719,1574,21,2272,ITH,ITH3,5,Veneto
2021-02-02,PAT,908,240,668,191,717,ITH,ITH2,4,Provincia Autonoma Trento
2021-03-03,MAR,6645,3046,3599,5761,884,ITI,ITI3,11,Marche
2021-01-06,VDA,65,33,32,65,0,ITC,ITC2,2,Valle d'Aosta / Vallée d'Aoste
2021-04-19,SAR,10192,4620,5572,8762,1430,ITG,ITG2,20,Sardegna
2021-01-05,MAR,1571,589,982,1571,0,ITI,ITI3,11,Marche
2021-05-13,PAT,3406,1579,1827,2305,1101,ITH,ITH2,4,Provincia Autonoma Trento
2021-05-14,BAS,5907,2799,3108,3376,2531,ITF,ITF5,17,Basilicata
2021-01-09,SAR,4026,1417,2609,4026,0,ITG,ITG2,20,Sardegna
2021-02-14,LAZ,5777,2372,3405,5306,471,ITI,ITI4,12,Lazio
2021-03-24,PIE,15507,6343,9164,6380,9127,ITC,ITC1,1,Piemonte
2021-06-15,SAR,14658,6786,7872,9929,4729,ITG,ITG2,20,Sardegna
2021-03-05,VEN,13336,5020,8316,9666,3670,ITH,ITH3,5,Veneto
2021-02-18,VDA,349,153,196,261,88,ITC,ITC2,2,Valle d'Aosta / Vallée d'Aoste
2021-02-28,LAZ,10257,4012,6245,9743,514,ITI,ITI4,12,Lazio
2021-03-07,SAR,1657,750,907,1117,540,ITG,ITG2,20,Sardegna
2021-03-08,PAB,1210,534,676,1183,27,ITH,ITH1,4,Provincia Autonoma Bolzano / Bozen
2021-05-20,PIE,38509,17848,20661,13620,24889,ITC,ITC1,1,Piemonte
2021-03-31,PAT,2584,983,1601,1727,857,ITH,ITH2,4,Provincia Autonoma Trento
2021-04-12,LOM,47221,20573,26648,32887,14334,ITC,ITC4,3,Lombardia
2021-01-02,LAZ,6707,2631,4076,6707,0,ITI,ITI4,12,Lazio
2021-02-09,PIE,7392,2316,5076,722,6670,ITC,ITC1,1,Piemonte
2021-05-04,PAB,3448,1843,1605,2411,1037,ITH,ITH1,4,Provincia Autonoma Bolzano / Bozen
2021-05-11,PUG,32515,14341,18174,14106,18409,ITF,ITF4,16,Puglia
2021-03-07,CAM,11973,5404,6569,8130,3843,ITF,ITF3,15,Campania
2021-05-04,PUG,35009,14804,20205,18577,16432,ITF,ITF4,16,Puglia
2021-02-21,LOM,5050,1861,3189,5033,17,ITC,ITC4,3,Lombardia
2021-02-22,MOL,265,129,136,250,15,ITF,ITF2,14,Molise
2021-03-14,CAL,2709,1052,1657,2290,419,ITF,ITF6,18,Calabria
2021-04-07,PIE,23610,9999,13611,18147,5463,ITC,ITC1,1,Piemonte
2021-03-08,PUG,14986,6434,8552,12586,2400,ITF,ITF4,16,Puglia
2021-05-03,CAM,40765,19891,20874,28912,11853,ITF,ITF3,15,Campania
2020-12-27,MOL,50,20,30,50,0,ITF,ITF2,14,Molise
2021-04-19,LOM,60092,27340,32752,50688,9404,ITC,ITC4,3,Lombardia
2021-03-18,BAS,1350,564,786,25,1325,ITF,ITF5,17,Basilicata
2021-04-15,MAR,10376,4674,5702,9811,565,ITI,ITI3,11,Marche
2021-01-26,PAT,542,154,388,27,515,ITH,ITH2,4,Provincia Autonoma Trento
2021-06-15,LOM,95381,48556,46825,49540,45841,ITC,ITC4,3,Lombardia
2021-02-17,MAR,1785,662,1123,1668,117,ITI,ITI3,11,Marche
2021-05-06,PAT,5527,2738,2789,4748,779,ITH,ITH2,4,Provincia Autonoma Trento
2021-05-10,CAL,13113,6085,7028,7718,5395,ITF,ITF6,18,Calabria
2021-02-02,FVG,2467,806,1661,217,2250,ITH,ITH4,6,Friuli-Venezia Giulia
2021-06-17,EMR,45401,22948,22453,21431,23970,ITH,ITH5,8,Emilia-Romagna
2021-03-31,FVG,8093,3552,4541,7247,846,ITH,ITH4,6,Friuli-Venezia Giulia
2021-05-14,ABR,10602,5077,5525,5445,5157,ITF,ITF1,13,Abruzzo
2021-05-01,TOS,23314,10063,13251,14138,9176,ITI,ITI1,9,Toscana
2021-03-05,TOS,16873,6685,10188,12131,4742,ITI,ITI1,9,Toscana
2021-04-26,CAL,10192,5062,5130,7771,2421,ITF,ITF6,18,Calabria
2021-04-01,ABR,5593,2505,3088,3506,2087,ITF,ITF1,13,Abruzzo
2021-06-15,CAM,18054,8789,9265,10671,7383,ITF,ITF3,15,Campania
2021-02-21,SIC,5168,2501,2667,5062,106,ITG,ITG1,19,Sicilia
2021-06-13,TOS,24413,12250,12163,22764,1649,ITI,ITI1,9,Toscana
2021-05-30,LAZ,41154,17609,23545,33818,7336,ITI,ITI4,12,Lazio
2021-05-13,LAZ,49832,22379,27453,32090,17742,ITI,ITI4,12,Lazio
2021-05-31,MOL,2325,1114,1211,1925,400,ITF,ITF2,14,Molise
2021-05-06,PIE,33465,15786,17679,19917,13548,ITC,ITC1,1,Piemonte
2021-02-23,BAS,1901,771,1130,1763,138,ITF,ITF5,17,Basilicata
2021-05-23,PIE,28700,13130,15570,15750,12950,ITC,ITC1,1,Piemonte
2021-05-14,MOL,2644,1215,1429,1926,718,ITF,ITF2,14,Molise
2020-12-27,PAT,103,40,63,103,0,ITH,ITH2,4,Provincia Autonoma Trento
2021-02-12,PIE,6891,2215,4676,3930,2961,ITC,ITC1,1,Piemonte
2021-06-03,BAS,4918,2255,2663,3737,1181,ITF,ITF5,17,Basilicata
2021-05-25,FVG,12863,6360,6503,9552,3311,ITH,ITH4,6,Friuli-Venezia Giulia
2021-03-12,BAS,1905,980,925,805,1100,ITF,ITF5,17,Basilicata
2021-04-24,SIC,31111,14689,16422,23500,7611,ITG,ITG1,19,Sicilia
2021-03-01,PIE,12043,4846,7197,11234,809,ITC,ITC1,1,Piemonte
2021-06-14,PAB,2324,1238,1086,547,1777,ITH,ITH1,4,Provincia Autonoma Bolzano / Bozen
2021-03-13,LOM,27165,9767,17398,21076,6089,ITC,ITC4,3,Lombardia
2021-01-03,SAR,90,36,54,90,0,ITG,ITG2,20,Sardegna
2021-01-10,TOS,3001,1104,1897,3001,0,ITI,ITI1,9,Toscana
2021-06-18,VEN,52149,26027,26122,24246,27903,ITH,ITH3,5,Veneto
2021-02-05,CAL,3804,1714,2090,488,3316,ITF,ITF6,18,Calabria
2021-06-02,MOL,2805,1355,1450,2706,99,ITF,ITF2,14,Molise
2021-04-20,TOS,18157,8110,10047,12601,5556,ITI,ITI1,9,Toscana
2021-06-11,FVG,10475,5725,4750,9702,773,ITH,ITH4,6,Friuli-Venezia Giulia
2021-05-17,BAS,5539,2733,2806,3405,2134,ITF,ITF5,17,Basilicata
2021-03-03,FVG,3644,1632,2012,2371,1273,ITH,ITH4,6,Friuli-Venezia Giulia
2021-03-11,PUG,14791,6553,8238,11623,3168,ITF,ITF4,16,Puglia
2021-04-03,TOS,15012,6646,8366,13886,1126,ITI,ITI1,9,Toscana
2021-04-27,LIG,14748,6677,8071,7168,7580,ITC,ITC3,7,Liguria
2021-02-23,ABR,2782,1275,1507,2771,11,ITF,ITF1,13,Abruzzo
2021-03-18,MAR,3389,1475,1914,162,3227,ITI,ITI3,11,Marche
2021-04-29,CAL,11953,5814,6139,8389,3564,ITF,ITF6,18,Calabria
2021-01-21,VDA,33,12,21,33,0,ITC,ITC2,2,Valle d'Aosta / Vallée d'Aoste
2021-02-03,LIG,2314,790,1524,55,2259,ITC,ITC3,7,Liguria
2021-06-02,PUG,26906,13166,13740,22098,4808,ITF,ITF4,16,Puglia
2021-02-06,ABR,1610,743,867,602,1008,ITF,ITF1,13,Abruzzo
2021-04-12,CAL,6910,3355,3555,5254,1656,ITF,ITF6,18,Calabria
2021-06-01,UMB,4380,2089,2291,4225,155,ITI,ITI2,10,Umbria
2021-01-04,VDA,142,59,83,142,0,ITC,ITC2,2,Valle d'Aosta / Vallée d'Aoste
2021-05-25,EMR,25015,11176,13839,11708,13307,ITH,ITH5,8,Emilia-Romagna
2021-05-25,PIE,31124,14442,16682,15988,15136,ITC,ITC1,1,Piemonte
2021-01-19,CAL,1116,491,625,1105,11,ITF,ITF6,18,Calabria
2021-03-10,UMB,4033,1945,2088,2777,1256,ITI,ITI2,10,Umbria
2021-06-11,PIE,43274,22895,20379,40472,2802,ITC,ITC1,1,Piemonte
2021-01-27,TOS,4835,1573,3262,206,4629,ITI,ITI1,9,Toscana
2021-02-14,EMR,1403,378,1025,1283,120,ITH,ITH5,8,Emilia-Romagna
2021-03-27,VEN,32077,14016,18061,26275,5802,ITH,ITH3,5,Veneto
2021-05-23,MAR,9208,4282,4926,7537,1671,ITI,ITI3,11,Marche
2021-01-21,CAM,2092,1115,977,676,1416,ITF,ITF3,15,Campania
2021-03-28,VDA,522,212,310,521,1,ITC,ITC2,2,Valle d'Aosta / Vallée d'Aoste
2021-01-16,UMB,221,73,148,221,0,ITI,ITI2,10,Umbria
2021-03-13,PUG,10466,4134,6332,8658,1808,ITF,ITF4,16,Puglia
2021-06-03,VEN,54182,27880,26302,42245,11937,ITH,ITH3,5,Veneto
2021-05-06,MAR,12656,5822,6834,5584,7072,ITI,ITI3,11,Marche
2021-06-17,CAL,15458,7044,8414,9324,6134,ITF,ITF6,18,Calabria
2021-02-15,PAB,72,42,30,26,46,ITH,ITH1,4,Provincia Autonoma Bolzano / Bozen
2021-03-11,VDA,197,76,121,66,131,ITC,ITC2,2,Valle d'Aosta / Vallée d'Aoste
2021-04-29,LIG,15551,6974,8577,6733,8818,ITC,ITC3,7,Liguria
2021-05-01,LOM,95963,43670,52293,66757,29206,ITC,ITC4,3,Lombardia
2021-05-27,FVG,12785,6119,6666,7570,5215,ITH,ITH4,6,Friuli-Venezia Giulia
2021-01-21,LOM,5442,1592,3850,4754,688,ITC,ITC4,3,Lombardia
2021-02-12,MAR,1582,618,964,1430,152,ITI,ITI3,11,Marche
2021-03-26,CAL,7979,3775,4204,4859,3120,ITF,ITF6,18,Calabria
2021-02-02,UMB,944,274,670,32,912,ITI,ITI2,10,Umbria
2021-02-24,PUG,10039,4704,5335,9448,591,ITF,ITF4,16,Puglia
2021-04-12,LIG,12383,5475,6908,10364,2019,ITC,ITC3,7,Liguria
2021-02-08,ABR,1195,395,800,486,709,ITF,ITF1,13,Abruzzo
2021-06-02,VDA,1215,688,527,814,401,ITC,ITC2,2,Valle d'Aosta / Vallée d'Aoste
2021-06-04,PUG,52140,25239,26901,34552,17588,ITF,ITF4,16,Puglia
2021-01-19,LIG,1371,438,933,1281,90,ITC,ITC3,7,Liguria
2021-03-17,TOS,11420,4586,6834,6892,4528,ITI,ITI1,9,Toscana
2021-05-11,PAB,2844,1335,1509,1321,1523,ITH,ITH1,4,Provincia Autonoma Bolzano / Bozen
2021-05-18,PUG,28763,13385,15378,16031,12732,ITF,ITF4,16,Puglia
2021-05-19,ABR,10693,5111,5582,7654,3039,ITF,ITF1,13,Abruzzo
2021-06-19,VDA,1287,666,621,669,618,ITC,ITC2,2,Valle d'Aosta / Vallée d'Aoste
2021-02-07,LOM,7308,2822,4486,338,6970,ITC,ITC4,3,Lombardia
2021-04-14,CAM,27642,13334,14308,19073,8569,ITF,ITF3,15,Campania
2021-06-20,VEN,27767,13431,14336,12240,15527,ITH,ITH3,5,Veneto
2021-02-05,LIG,2674,986,1688,304,2370,ITC,ITC3,7,Liguria
2021-05-01,CAM,46336,22660,23676,30234,16102,ITF,ITF3,15,Campania
2021-06-08,TOS,32466,16616,15850,32034,432,ITI,ITI1,9,Toscana
2021-02-26,TOS,10080,3834,6246,8874,1206,ITI,ITI1,9,Toscana
2021-05-27,EMR,42071,18652,23419,14008,28063,ITH,ITH5,8,Emilia-Romagna
2021-02-10,MAR,1439,452,987,1080,359,ITI,ITI3,11,Marche
2021-01-14,LAZ,5487,2145,3342,5487,0,ITI,ITI4,12,Lazio
2021-02-16,EMR,5772,2446,3326,5241,531,ITH,ITH5,8,Emilia-Romagna
2021-04-26,SIC,21710,10276,11434,13637,8073,ITG,ITG1,19,Sicilia
2021-06-06,TOS,28293,13648,14645,22939,5354,ITI,ITI1,9,Toscana
2021-03-31,SAR,10272,4163,6109,7824,2448,ITG,ITG2,20,Sardegna
2021-01-19,LOM,8051,2329,5722,7583,468,ITC,ITC4,3,Lombardia
2021-02-02,SIC,5289,2483,2806,629,4660,ITG,ITG1,19,Sicilia
2021-02-08,BAS,557,193,364,151,406,ITF,ITF5,17,Basilicata
2021-01-29,PAB,1497,510,987,24,1473,ITH,ITH1,4,Provincia Autonoma Bolzano / Bozen
2021-04-07,LAZ,25638,11857,13781,18331,7307,ITI,ITI4,12,Lazio
2021-04-12,CAM,23300,10917,12383,20265,3035,ITF,ITF3,15,Campania
2021-05-25,PAT,4764,2266,2498,1866,2898,ITH,ITH2,4,Provincia Autonoma Trento
2021-05-08,PAT,3161,1725,1436,2739,422,ITH,ITH2,4,Provincia Autonoma Trento
2021-05-19,BAS,2869,1497,1372,1193,1676,ITF,ITF5,17,Basilicata
2021-01-02,CAM,3672,1962,1710,3672,0,ITF,ITF3,15,Campania
2021-03-09,VDA,206,96,110,174,32,ITC,ITC2,2,Valle d'Aosta / Vallée d'Aoste
2021-04-22,PAB,2924,1501,1423,1982,942,ITH,ITH1,4,Provincia Autonoma Bolzano / Bozen
2021-04-26,UMB,5377,2329,3048,3125,2252,ITI,ITI2,10,Umbria
2021-02-25,BAS,1787,736,1051,1741,46,ITF,ITF5,17,Basilicata
2021-02-20,VDA,251,210,41,241,10,ITC,ITC2,2,Valle d'Aosta / Vallée d'Aoste
2020-12-28,LAZ,959,412,547,959,0,ITI,ITI4,12,Lazio
2021-02-14,PAT,246,186,60,11,235,ITH,ITH2,4,Provincia Autonoma Trento
2021-04-09,UMB,6799,3164,3635,6580,219,ITI,ITI2,10,Umbria
2021-05-09,PAB,4242,2410,1832,3089,1153,ITH,ITH1,4,Provincia Autonoma Bolzano / Bozen
2021-04-29,PUG,26080,12077,14003,19418,6662,ITF,ITF4,16,Puglia
2021-04-30,ABR,12391,5803,6588,6694,5697,ITF,ITF1,13,Abruzzo
2021-01-16,LAZ,5647,2282,3365,5647,0,ITI,ITI4,12,Lazio
2021-06-17,CAM,57495,27548,29947,30791,26704,ITF,ITF3,15,Campania
2021-04-19,PIE,22543,10768,11775,18179,4364,ITC,ITC1,1,Piemonte
2021-01-14,SIC,5093,2402,2691,5093,0,ITG,ITG1,19,Sicilia
2021-04-13,ABR,5861,2744,3117,4661,1200,ITF,ITF1,13,Abruzzo
2021-04-26,LAZ,29230,13456,15774,20028,9202,ITI,ITI4,12,Lazio
2021-01-09,PIE,6184,2185,3999,6184,0,ITC,ITC1,1,Piemonte
2021-02-02,LAZ,5910,2213,3697,638,5272,ITI,ITI4,12,Lazio
2021-01-20,ABR,447,156,291,445,2,ITF,ITF1,13,Abruzzo
2021-02-19,VEN,7322,3140,4182,7118,204,ITH,ITH3,5,Veneto
2021-03-26,CAM,19853,9312,10541,16038,3815,ITF,ITF3,15,Campania
2021-02-03,MOL,731,249,482,338,393,ITF,ITF2,14,Molise
2021-01-28,FVG,2239,794,1445,354,1885,ITH,ITH4,6,Friuli-Venezia Giulia
2021-01-26,PIE,6333,1880,4453,735,5598,ITC,ITC1,1,Piemonte
2021-06-11,MAR,13689,6999,6690,11428,2261,ITI,ITI3,11,Marche
2021-02-06,BAS,903,367,536,146,757,ITF,ITF5,17,Basilicata
2021-04-27,MOL,1593,767,826,465,1128,ITF,ITF2,14,Molise
2021-05-27,PAT,4285,1989,2296,1253,3032,ITH,ITH2,4,Provincia Autonoma Trento
2021-03-24,LIG,9175,4029,5146,5888,3287,ITC,ITC3,7,Liguria
2021-05-10,EMR,33840,16125,17715,26595,7245,ITH,ITH5,8,Emilia-Romagna
2021-05-08,FVG,10266,4640,5626,5487,4779,ITH,ITH4,6,Friuli-Venezia Giulia
2020-12-31,LIG,990,353,637,990,0,ITC,ITC3,7,Liguria
2021-04-30,BAS,5284,2373,2911,4122,1162,ITF,ITF5,17,Basilicata
2021-02-21,VEN,4637,1211,3426,4632,5,ITH,ITH3,5,Veneto
2021-04-28,UMB,5349,2317,3032,2966,2383,ITI,ITI2,10,Umbria
2021-03-06,PAB,3973,2081,1892,3762,211,ITH,ITH1,4,Provincia Autonoma Bolzano / Bozen
2021-04-10,LIG,7882,3556,4326,6968,914,ITC,ITC3,7,Liguria
2021-02-04,UMB,733,226,507,25,708,ITI,ITI2,10,Umbria
2021-05-15,VEN,36176,17485,18691,26188,9988,ITH,ITH3,5,Veneto
2021-01-17,LIG,862,300,562,862,0,ITC,ITC3,7,Liguria
2021-05-02,ABR,10424,5088,5336,5214,5210,ITF,ITF1,13,Abruzzo
2021-05-25,MAR,11647,5745,5902,8717,2930,ITI,ITI3,11,Marche
2021-05-28,PAB,5681,2895,2786,3791,1890,ITH,ITH1,4,Provincia Autonoma Bolzano / Bozen
2021-01-20,BAS,84,22,62,84,0,ITF,ITF5,17,Basilicata
2021-05-15,UMB,4991,1881,3110,1826,3165,ITI,ITI2,10,Umbria
2021-05-16,MOL,1247,571,676,1065,182,ITF,ITF2,14,Molise
2021-02-17,PAB,156,51,105,139,17,ITH,ITH1,4,Provincia Autonoma Bolzano / Bozen
2021-04-21,EMR,23953,10962,12991,14207,9746,ITH,ITH5,8,Emilia-Romagna
2021-06-01,VEN,26897,13537,13360,16400,10497,ITH,ITH3,5,Veneto
2021-02-22,PUG,9630,4537,5093,9298,332,ITF,ITF4,16,Puglia
2021-05-08,PIE,34262,16262,18000,18626,15636,ITC,ITC1,1,Piemonte
2021-06-03,SAR,16344,7607,8737,10699,5645,ITG,ITG2,20,Sardegna
2021-01-02,CAL,166,94,72,166,0,ITF,ITF6,18,Calabria
2021-01-28,PIE,5591,1809,3782,384,5207,ITC,ITC1,1,Piemonte
2021-05-08,EMR,32333,15090,17243,20912,11421,ITH,ITH5,8,Emilia-Romagna
2021-05-20,LOM,94347,45604,48743,31834,62513,ITC,ITC4,3,Lombardia
2021-03-01,MAR,3724,1487,2237,3476,248,ITI,ITI3,11,Marche
2021-05-10,FVG,7937,3526,4411,6396,1541,ITH,ITH4,6,Friuli-Venezia Giulia
2021-06-20,SAR,5063,2261,2802,2708,2355,ITG,ITG2,20,Sardegna
2021-01-28,EMR,10254,3339,6915,349,9905,ITH,ITH5,8,Emilia-Romagna
2021-03-10,VEN,19037,8725,10312,13354,5683,ITH,ITH3,5,Veneto
2021-02-05,PUG,5635,2273,3362,1333,4302,ITF,ITF4,16,Puglia
2021-03-12,SAR,5980,2622,3358,4672,1308,ITG,ITG2,20,Sardegna
2021-02-14,PIE,1476,498,978,876,600,ITC,ITC1,1,Piemonte
2021-05-16,PUG,24483,11038,13445,12667,11816,ITF,ITF4,16,Puglia
2021-01-15,PAB,3282,1228,2054,3282,0,ITH,ITH1,4,Provincia Autonoma Bolzano / Bozen
2021-04-21,LAZ,33025,15007,18018,20654,12371,ITI,ITI4,12,Lazio
2021-01-07,LIG,3229,1095,2134,3229,0,ITC,ITC3,7,Liguria
2021-06-13,LIG,5616,2695,2921,5163,453,ITC,ITC3,7,Liguria
2021-04-17,LIG,7382,3216,4166,6632,750,ITC,ITC3,7,Liguria
2021-01-07,SAR,3112,1077,2035,3112,0,ITG,ITG2,20,Sardegna
2021-04-18,VDA,522,254,268,518,4,ITC,ITC2,2,Valle d'Aosta / Vallée d'Aoste
2021-04-17,MAR,11700,5315,6385,10627,1073,ITI,ITI3,11,Marche
2021-05-01,LIG,7142,3256,3886,1342,5800,ITC,ITC3,7,Liguria
2021-02-07,PIE,3088,974,2114,445,2643,ITC,ITC1,1,Piemonte
2021-06-14,VDA,306,163,143,12,294,ITC,ITC2,2,Valle d'Aosta / Vallée d'Aoste
2021-03-05,LIG,4869,2150,2719,3737,1132,ITC,ITC3,7,Liguria
2021-06-10,SAR,17809,8478,9331,11774,6035,ITG,ITG2,20,Sardegna
2021-02-19,LOM,14211,5399,8812,13488,723,ITC,ITC4,3,Lombardia
2021-04-22,MOL,1845,864,981,1066,779,ITF,ITF2,14,Molise
2021-05-31,VDA,879,395,484,500,379,ITC,ITC2,2,Valle d'Aosta / Vallée d'Aoste
2021-04-17,LOM,48478,21292,27186,37640,10838,ITC,ITC4,3,Lombardia
2021-04-26,VEN,20714,9452,11262,15575,5139,ITH,ITH3,5,Veneto
2021-06-18,PAB,3584,1882,1702,694,2890,ITH,ITH1,4,Provincia Autonoma Bolzano / Bozen
2021-06-03,LAZ,56052,28321,27731,38559,17493,ITI,ITI4,12,Lazio
2021-06-13,MAR,10437,5414,5023,9200,1237,ITI,ITI3,11,Marche
2020-12-27,MAR,204,99,105,204,0,ITI,ITI3,11,Marche
2021-05-05,BAS,4334,2048,2286,3444,890,ITF,ITF5,17,Basilicata
2021-02-17,MOL,72,32,40,57,15,ITF,ITF2,14,Molise
2021-02-26,LOM,18380,7554,10826,16516,1864,ITC,ITC4,3,Lombardia
2021-03-09,BAS,1400,713,687,794,606,ITF,ITF5,17,Basilicata
2021-04-21,SIC,22385,10742,11643,16277,6108,ITG,ITG1,19,Sicilia
2021-01-21,CAL,962,447,515,932,30,ITF,ITF6,18,Calabria
2021-01-22,PUG,1409,578,831,991,418,ITF,ITF4,16,Puglia
2021-05-28,MOL,2644,1362,1282,2097,547,ITF,ITF2,14,Molise
2021-02-28,EMR,6822,2527,4295,4977,1845,ITH,ITH5,8,Emilia-Romagna
2021-01-25,BAS,1024,429,595,74,950,ITF,ITF5,17,Basilicata
2021-04-26,EMR,27890,12932,14958,18577,9313,ITH,ITH5,8,Emilia-Romagna
2021-04-07,SIC,15414,7599,7815,8303,7111,ITG,ITG1,19,Sicilia
2021-06-03,UMB,9043,4470,4573,8762,281,ITI,ITI2,10,Umbria
2021-01-16,EMR,5628,1718,3910,5628,0,ITH,ITH5,8,Emilia-Romagna
2021-04-07,UMB,5573,2292,3281,3567,2006,ITI,ITI2,10,Umbria
2021-02-01,ABR,1632,573,1059,271,1361,ITF,ITF1,13,Abruzzo
2021-03-14,EMR,8800,3839,4961,5003,3797,ITH,ITH5,8,Emilia-Romagna
2021-01-11,BAS,183,66,117,183,0,ITF,ITF5,17,Basilicata
2021-01-14,CAM,7074,2978,4096,7074,0,ITF,ITF3,15,Campania
2021-02-23,UMB,1693,658,1035,1651,42,ITI,ITI2,10,Umbria
2021-06-03,SIC,45744,20971,24773,34248,11496,ITG,ITG1,19,Sicilia
2021-01-12,TOS,3581,1398,2183,3581,0,ITI,ITI1,9,Toscana
2021-01-08,PAB,1521,479,1042,1521,0,ITH,ITH1,4,Provincia Autonoma Bolzano / Bozen
2021-06-06,LIG,3818,2033,1785,2948,870,ITC,ITC3,7,Liguria
2021-06-10,LAZ,70919,33343,37576,37589,33330,ITI,ITI4,12,Lazio
2021-03-23,ABR,4832,2187,2645,2266,2566,ITF,ITF1,13,Abruzzo
2021-04-24,LIG,8218,3795,4423,5067,3151,ITC,ITC3,7,Liguria
2021-05-22,FVG,11540,5182,6358,7309,4231,ITH,ITH4,6,Friuli-Venezia Giulia
2020-12-31,SAR,32,16,16,32,0,ITG,ITG2,20,Sardegna
2021-04-25,VDA,849,408,441,710,139,ITC,ITC2,2,Valle d'Aosta / Vallée d'Aoste
2021-01-25,ABR,1604,632,972,17,1587,ITF,ITF1,13,Abruzzo
2021-02-26,LIG,3764,1523,2241,3436,328,ITC,ITC3,7,Liguria
2021-06-07,VDA,710,347,363,649,61,ITC,ITC2,2,Valle d'Aosta / Vallée d'Aoste
2021-06-06,MAR,12299,6074,6225,10810,1489,ITI,ITI3,11,Marche
2021-06-20,LIG,896,435,461,696,200,ITC,ITC3,7,Liguria
2021-02-27,VDA,231,85,146,124,107,ITC,ITC2,2,Valle d'Aosta / Vallée d'Aoste
2021-04-14,LAZ,29291,13273,16018,19168,10123,ITI,ITI4,12,Lazio
2021-06-11,MOL,3300,1587,1713,2001,1299,ITF,ITF2,14,Molise
2021-06-15,VEN,47309,24026,23283,29968,17341,ITH,ITH3,5,Veneto
2021-05-22,PIE,33452,15104,18348,17247,16205,ITC,ITC1,1,Piemonte
2020-12-31,LOM,713,301,412,713,0,ITC,ITC4,3,Lombardia
2021-04-15,MOL,1925,793,1132,1080,845,ITF,ITF2,14,Molise
2021-05-15,EMR,33227,14976,18251,22830,10397,ITH,ITH5,8,Emilia-Romagna
2021-05-03,FVG,7208,3285,3923,3429,3779,ITH,ITH4,6,Friuli-Venezia Giulia
2021-02-04,EMR,9940,3207,6733,1250,8690,ITH,ITH5,8,Emilia-Romagna
2021-05-22,EMR,32956,14111,18845,16900,16056,ITH,ITH5,8,Emilia-Romagna
2021-05-03,UMB,5092,2272,2820,2205,2887,ITI,ITI2,10,Umbria
2021-01-14,FVG,2584,789,1795,2584,0,ITH,ITH4,6,Friuli-Venezia Giulia
2021-04-05,LIG,3978,1753,2225,2329,1649,ITC,ITC3,7,Liguria
2021-04-18,BAS,3719,1846,1873,2352,1367,ITF,ITF5,17,Basilicata
2021-04-09,EMR,25724,11666,14058,20027,5697,ITH,ITH5,8,Emilia-Romagna
2021-01-28,SIC,9024,4270,4754,393,8631,ITG,ITG1,19,Sicilia
2021-05-11,MOL,3207,1414,1793,2957,250,ITF,ITF2,14,Molise
2021-01-23,UMB,280,100,180,2,278,ITI,ITI2,10,Umbria
2021-05-08,SIC,35582,17007,18575,25321,10261,ITG,ITG1,19,Sicilia
2021-05-27,VEN,46376,22795,23581,23281,23095,ITH,ITH3,5,Veneto
2021-02-17,PUG,4276,1746,2530,3671,605,ITF,ITF4,16,Puglia
2021-05-03,PIE,26662,12168,14494,12515,14147,ITC,ITC1,1,Piemonte
2021-04-07,CAM,24968,11982,12986,20244,4724,ITF,ITF3,15,Campania
2021-03-26,LAZ,29820,13665,16155,22973,6847,ITI,ITI4,12,Lazio
2021-05-21,PAB,6920,3802,3118,5076,1844,ITH,ITH1,4,Provincia Autonoma Bolzano / Bozen
2021-05-28,PUG,43533,20607,22926,27912,15621,ITF,ITF4,16,Puglia
2021-02-07,VEN,2315,862,1453,714,1601,ITH,ITH3,5,Veneto
2021-02-02,EMR,9485,3053,6432,527,8958,ITH,ITH5,8,Emilia-Romagna
2021-02-20,BAS,1163,532,631,1044,119,ITF,ITF5,17,Basilicata
2021-02-19,PAT,929,359,570,870,59,ITH,ITH2,4,Provincia Autonoma Trento
2021-05-31,BAS,4228,2009,2219,1721,2507,ITF,ITF5,17,Basilicata
2021-01-26,SIC,9232,4558,4674,255,8977,ITG,ITG1,19,Sicilia
2021-02-26,PIE,12293,4933,7360,11556,737,ITC,ITC1,1,Piemonte
2021-03-24,SAR,7409,3108,4301,6050,1359,ITG,ITG2,20,Sardegna
2021-01-08,ABR,1525,507,1018,1525,0,ITF,ITF1,13,Abruzzo
2021-06-08,FVG,10154,5298,4856,9791,363,ITH,ITH4,6,Friuli-Venezia Giulia
2021-01-21,UMB,610,202,408,341,269,ITI,ITI2,10,Umbria
2021-03-10,LOM,33234,12711,20523,25375,7859,ITC,ITC4,3,Lombardia
2021-04-24,PIE,27469,12422,15047,21817,5652,ITC,ITC1,1,Piemonte
2021-05-27,TOS,28308,13168,15140,13473,14835,ITI,ITI1,9,Toscana
2021-02-28,FVG,2685,1002,1683,2292,393,ITH,ITH4,6,Friuli-Venezia Giulia
2021-04-18,ABR,5814,2728,3086,4871,943,ITF,ITF1,13,Abruzzo
2021-05-11,MAR,10621,4832,5789,5677,4944,ITI,ITI3,11,Marche
2021-01-14,PIE,9766,3152,6614,9766,0,ITC,ITC1,1,Piemonte
2021-03-16,VDA,182,37,145,118,64,ITC,ITC2,2,Valle d'Aosta / Vallée d'Aoste
2021-03-31,TOS,32699,13245,19454,20538,12161,ITI,ITI1,9,Toscana
2021-05-06,LOM,89777,42176,47601,73320,16457,ITC,ITC4,3,Lombardia
2021-01-26,LOM,8338,2705,5633,349,7989,ITC,ITC4,3,Lombardia
2021-03-31,CAL,8813,4003,4810,4855,3958,ITF,ITF6,18,Calabria
2021-02-18,BAS,1070,401,669,855,215,ITF,ITF5,17,Basilicata
2021-04-09,CAL,7904,3701,4203,5016,2888,ITF,ITF6,18,Calabria
2021-04-02,CAM,21841,10514,11327,19519,2322,ITF,ITF3,15,Campania
2021-05-11,LIG,13902,6384,7518,7298,6604,ITC,ITC3,7,Liguria
2021-05-30,PUG,20885,10001,10884,15858,5027,ITF,ITF4,16,Puglia
2021-01-22,MOL,128,36,92,128,0,ITF,ITF2,14,Molise
2021-03-22,TOS,5249,2761,2488,4805,444,ITI,ITI1,9,Toscana
2021-03-24,VEN,22102,9566,12536,15300,6802,ITH,ITH3,5,Veneto
2021-05-16,PAB,2025,932,1093,1331,694,ITH,ITH1,4,Provincia Autonoma Bolzano / Bozen
2021-05-02,MOL,1893,932,961,588,1305,ITF,ITF2,14,Molise
2021-02-20,ABR,4774,1842,2932,4698,76,ITF,ITF1,13,Abruzzo
2021-03-15,MAR,4401,2026,2375,1311,3090,ITI,ITI3,11,Marche
2021-03-29,LIG,10547,4611,5936,7415,3132,ITC,ITC3,7,Liguria
2021-04-26,FVG,5460,2451,3009,3811,1649,ITH,ITH4,6,Friuli-Venezia Giulia
2021-03-06,MOL,1728,807,921,1569,159,ITF,ITF2,14,Molise
2021-06-05,CAL,20328,9524,10804,17365,2963,ITF,ITF6,18,Calabria
2021-01-31,LIG,624,270,354,9,615,ITC,ITC3,7,Liguria
2021-05-24,PUG,35852,16928,18924,24882,10970,ITF,ITF4,16,Puglia
2021-06-17,MAR,14907,7421,7486,8850,6057,ITI,ITI3,11,Marche
2021-02-15,CAM,5470,2516,2954,5297,173,ITF,ITF3,15,Campania
2021-01-12,VDA,302,72,230,302,0,ITC,ITC2,2,Valle d'Aosta / Vallée d'Aoste
2021-02-16,PUG,3380,1453,1927,2735,645,ITF,ITF4,16,Puglia
2021-05-08,ABR,10291,4870,5421,6459,3832,ITF,ITF1,13,Abruzzo
2021-01-10,CAL,931,525,406,931,0,ITF,ITF6,18,Calabria
2021-01-30,PUG,5528,2514,3014,410,5118,ITF,ITF4,16,Puglia
2021-02-03,PIE,10202,3304,6898,611,9591,ITC,ITC1,1,Piemonte
2021-02-27,LAZ,11425,4267,7158,10470,955,ITI,ITI4,12,Lazio
2021-05-26,LOM,93393,44540,48853,43567,49826,ITC,ITC4,3,Lombardia
2021-06-09,CAM,52391,25729,26662,41514,10877,ITF,ITF3,15,Campania
2021-02-15,LOM,8941,3131,5810,8524,417,ITC,ITC4,3,Lombardia
2021-03-09,MAR,5427,2290,3137,4547,880,ITI,ITI3,11,Marche
2021-04-20,CAL,7838,3954,3884,6118,1720,ITF,ITF6,18,Calabria
2021-05-10,PUG,37623,16619,21004,19710,17913,ITF,ITF4,16,Puglia
2021-02-28,MOL,832,334,498,790,42,ITF,ITF2,14,Molise
2021-03-01,CAM,12130,4247,7883,8017,4113,ITF,ITF3,15,Campania
2021-01-01,TOS,2369,787,1582,2369,0,ITI,ITI1,9,Toscana
2021-02-22,FVG,2485,1193,1292,2067,418,ITH,ITH4,6,Friuli-Venezia Giulia
2021-04-24,ABR,8726,3975,4751,7196,1530,ITF,ITF1,13,Abruzzo
2021-04-11,TOS,3645,1680,1965,3490,155,ITI,ITI1,9,Toscana
2021-03-30,SIC,14510,6749,7761,9747,4763,ITG,ITG1,19,Sicilia
2021-05-09,CAM,43195,20283,22912,32100,11095,ITF,ITF3,15,Campania
2021-01-11,LIG,2654,989,1665,2654,0,ITC,ITC3,7,Liguria
2021-04-15,EMR,29335,13978,15357,19659,9676,ITH,ITH5,8,Emilia-Romagna
2021-06-02,FVG,9400,4948,4452,9122,278,ITH,ITH4,6,Friuli-Venezia Giulia
2021-01-14,ABR,530,189,341,530,0,ITF,ITF1,13,Abruzzo
2021-03-13,SIC,12208,5386,6822,7717,4491,ITG,ITG1,19,Sicilia
2021-02-27,MOL,1366,568,798,1347,19,ITF,ITF2,14,Molise
2021-03-19,BAS,2292,994,1298,264,2028,ITF,ITF5,17,Basilicata
2021-03-06,TOS,7109,2852,4257,2914,4195,ITI,ITI1,9,Toscana
2021-03-17,UMB,3331,1313,2018,1859,1472,ITI,ITI2,10,Umbria
2021-05-24,VDA,1136,516,620,689,447,ITC,ITC2,2,Valle d'Aosta / Vallée d'Aoste
2021-06-07,MOL,1947,857,1090,1128,819,ITF,ITF2,14,Molise
2021-06-18,EMR,41306,20673,20633,15930,25376,ITH,ITH5,8,Emilia-Romagna
2021-03-10,EMR,18798,7742,11056,13154,5644,ITH,ITH5,8,Emilia-Romagna
2021-05-10,VDA,782,381,401,547,235,ITC,ITC2,2,Valle d'Aosta / Vallée d'Aoste
2021-05-20,LAZ,51174,24621,26553,37503,13671,ITI,ITI4,12,Lazio
2021-02-13,MOL,132,80,52,132,0,ITF,ITF2,14,Molise
2021-04-13,MAR,9839,4260,5579,9605,234,ITI,ITI3,11,Marche
2021-01-07,UMB,1301,387,914,1301,0,ITI,ITI2,10,Umbria
2021-01-10,CAM,8165,3736,4429,8165,0,ITF,ITF3,15,Campania
2021-02-07,FVG,1563,482,1081,385,1178,ITH,ITH4,6,Friuli-Venezia Giulia
2021-04-17,SIC,26034,13154,12880,18968,7066,ITG,ITG1,19,Sicilia
2021-01-03,PAT,492,160,332,492,0,ITH,ITH2,4,Provincia Autonoma Trento
2021-05-24,MOL,1960,852,1108,1294,666,ITF,ITF2,14,Molise
2021-03-20,SAR,5194,2074,3120,2917,2277,ITG,ITG2,20,Sardegna
2021-02-16,BAS,906,377,529,808,98,ITF,ITF5,17,Basilicata
2021-05-07,MOL,2643,1228,1415,2046,597,ITF,ITF2,14,Molise
2021-02-06,PAB,2626,1171,1455,19,2607,ITH,ITH1,4,Provincia Autonoma Bolzano / Bozen
2021-02-13,PUG,3727,1456,2271,3031,696,ITF,ITF4,16,Puglia
2021-05-18,FVG,10733,5376,5357,8661,2072,ITH,ITH4,6,Friuli-Venezia Giulia
2021-01-10,LIG,648,262,386,648,0,ITC,ITC3,7,Liguria
2021-02-12,CAL,1710,668,1042,947,763,ITF,ITF6,18,Calabria
2021-03-03,VEN,12093,4646,7447,8594,3499,ITH,ITH3,5,Veneto
2021-03-17,SIC,14975,7395,7580,9186,5789,ITG,ITG1,19,Sicilia
2021-03-20,LOM,32502,12145,20357,22655,9847,ITC,ITC4,3,Lombardia
2021-04-20,LIG,14215,6505,7710,9867,4348,ITC,ITC3,7,Liguria
2021-06-20,LAZ,38244,17413,20831,18951,19293,ITI,ITI4,12,Lazio
2021-04-03,CAM,21114,10314,10800,18733,2381,ITF,ITF3,15,Campania
2021-06-01,FVG,10068,5097,4971,7948,2120,ITH,ITH4,6,Friuli-Venezia Giulia
2021-06-11,VEN,46689,24291,22398,35656,11033,ITH,ITH3,5,Veneto
2021-05-18,PIE,32037,14765,17272,19394,12643,ITC,ITC1,1,Piemonte
2021-06-06,LAZ,57882,27895,29987,35414,22468,ITI,ITI4,12,Lazio
2021-06-13,SAR,9487,4665,4822,6227,3260,ITG,ITG2,20,Sardegna
2020-12-27,LOM,717,413,304,717,0,ITC,ITC4,3,Lombardia
2021-05-18,EMR,29075,13241,15834,18570,10505,ITH,ITH5,8,Emilia-Romagna
2021-06-16,MAR,13521,6794,6727,9156,4365,ITI,ITI3,11,Marche
2021-02-16,ABR,1917,842,1075,1905,12,ITF,ITF1,13,Abruzzo
2021-02-03,TOS,4221,1452,2769,241,3980,ITI,ITI1,9,Toscana
2021-02-07,EMR,4795,1539,3256,1734,3061,ITH,ITH5,8,Emilia-Romagna
2021-03-02,ABR,3962,1675,2287,3278,684,ITF,ITF1,13,Abruzzo
2021-02-26,LAZ,13085,5708,7377,11723,1362,ITI,ITI4,12,Lazio
2021-02-24,EMR,9351,3566,5785,8467,884,ITH,ITH5,8,Emilia-Romagna
2021-04-21,VDA,868,410,458,620,248,ITC,ITC2,2,Valle d'Aosta / Vallée d'Aoste
2021-06-10,ABR,12366,6159,6207,10205,2161,ITF,ITF1,13,Abruzzo
2021-01-05,EMR,9361,3170,6191,9361,0,ITH,ITH5,8,Emilia-Romagna
2021-06-02,MAR,11898,5937,5961,11221,677,ITI,ITI3,11,Marche
2021-01-28,BAS,904,402,502,119,785,ITF,ITF5,17,Basilicata
2021-01-15,TOS,3878,1347,2531,3878,0,ITI,ITI1,9,Toscana
2021-01-26,UMB,816,390,426,18,798,ITI,ITI2,10,Umbria
2021-04-18,MOL,1083,483,600,149,934,ITF,ITF2,14,Molise
2021-06-20,FVG,3643,1818,1825,815,2828,ITH,ITH4,6,Friuli-Venezia Giulia
2021-03-21,VDA,355,165,190,355,0,ITC,ITC2,2,Valle d'Aosta / Vallée d'Aoste
2021-04-29,EMR,44950,21134,23816,27401,17549,ITH,ITH5,8,Emilia-Romagna
2021-01-19,EMR,2045,505,1540,2028,17,ITH,ITH5,8,Emilia-Romagna
2021-02-22,MAR,3413,1499,1914,3338,75,ITI,ITI3,11,Marche
2021-02-12,UMB,671,224,447,665,6,ITI,ITI2,10,Umbria
2021-02-22,PAT,745,259,486,661,84,ITH,ITH2,4,Provincia Autonoma Trento
2021-04-04,MOL,253,141,112,238,15,ITF,ITF2,14,Molise
2021-02-26,UMB,660,253,407,652,8,ITI,ITI2,10,Umbria
2021-03-29,FVG,6988,3110,3878,5407,1581,ITH,ITH4,6,Friuli-Venezia Giulia
2021-06-06,SIC,49497,23905,25592,41676,7821,ITG,ITG1,19,Sicilia
2021-01-29,SAR,2955,1069,1886,48,2907,ITG,ITG2,20,Sardegna
2021-03-18,MOL,1156,476,680,692,464,ITF,ITF2,14,Molise
2021-01-03,PIE,3063,967,2096,3063,0,ITC,ITC1,1,Piemonte
2021-03-28,PAB,569,212,357,11,558,ITH,ITH1,4,Provincia Autonoma Bolzano / Bozen
2021-05-23,LIG,2305,1119,1186,1182,1123,ITC,ITC3,7,Liguria
2021-01-14,BAS,969,413,556,969,0,ITF,ITF5,17,Basilicata
2021-02-26,SIC,11883,5811,6072,10202,1681,ITG,ITG1,19,Sicilia
2021-06-18,TOS,30543,16112,14431,25281,5262,ITI,ITI1,9,Toscana
2021-04-22,VEN,31978,13911,18067,16234,15744,ITH,ITH3,5,Veneto
2021-01-28,ABR,1433,495,938,12,1421,ITF,ITF1,13,Abruzzo
2021-03-01,LIG,3526,1444,2082,3404,122,ITC,ITC3,7,Liguria
2021-04-03,CAL,8908,3814,5094,4289,4619,ITF,ITF6,18,Calabria
2021-05-06,SIC,29224,13925,15299,18508,10716,ITG,ITG1,19,Sicilia
2021-05-23,CAM,58738,28634,30104,37843,20895,ITF,ITF3,15,Campania
2021-05-01,LAZ,37949,17082,20867,25988,11961,ITI,ITI4,12,Lazio
2021-05-09,LOM,69688,32878,36810,56428,13260,ITC,ITC4,3,Lombardia
2021-06-09,LIG,18652,9362,9290,12096,6556,ITC,ITC3,7,Liguria
2021-02-12,CAM,6529,2861,3668,6343,186,ITF,ITF3,15,Campania
2021-04-07,BAS,1211,550,661,1173,38,ITF,ITF5,17,Basilicata
2021-01-29,LOM,13476,4126,9350,685,12791,ITC,ITC4,3,Lombardia
2021-04-17,LAZ,32358,14202,18156,20386,11972,ITI,ITI4,12,Lazio
2021-05-18,PAT,4247,2009,2238,3405,842,ITH,ITH2,4,Provincia Autonoma Trento
2021-03-29,EMR,21416,9606,11810,16766,4650,ITH,ITH5,8,Emilia-Romagna
2021-03-29,PIE,15167,6388,8779,8555,6612,ITC,ITC1,1,Piemonte
2021-01-11,ABR,1553,557,996,1553,0,ITF,ITF1,13,Abruzzo
2021-05-06,UMB,9474,4322,5152,6158,3316,ITI,ITI2,10,Umbria
2021-06-10,VDA,1002,558,444,960,42,ITC,ITC2,2,Valle d'Aosta / Vallée d'Aoste
2021-03-25,TOS,23890,10374,13516,15540,8350,ITI,ITI1,9,Toscana
2021-01-29,CAM,10052,4812,5240,47,10005,ITF,ITF3,15,Campania
2021-03-02,VDA,339,166,173,336,3,ITC,ITC2,2,Valle d'Aosta / Vallée d'Aoste
2021-04-21,ABR,6388,3100,3288,4714,1674,ITF,ITF1,13,Abruzzo
2021-01-28,CAL,2240,1111,1129,83,2157,ITF,ITF6,18,Calabria
2021-04-25,BAS,2985,1457,1528,2933,52,ITF,ITF5,17,Basilicata
2021-05-09,PUG,30624,12549,18075,15036,15588,ITF,ITF4,16,Puglia
2021-06-13,LOM,75232,40178,35054,73109,2123,ITC,ITC4,3,Lombardia
2021-01-28,SAR,2972,1046,1926,69,2903,ITG,ITG2,20,Sardegna
2021-04-12,PIE,22945,10364,12581,19955,2990,ITC,ITC1,1,Piemonte
2021-04-12,TOS,2612,1183,1429,1958,654,ITI,ITI1,9,Toscana
2021-02-21,EMR,4450,1708,2742,4010,440,ITH,ITH5,8,Emilia-Romagna
2021-03-05,LOM,28913,11925,16988,20506,8407,ITC,ITC4,3,Lombardia
2021-03-27,MAR,7380,3074,4306,5022,2358,ITI,ITI3,11,Marche
2021-05-08,CAL,18420,8382,10038,10604,7816,ITF,ITF6,18,Calabria
2021-01-02,PIE,3545,1134,2411,3545,0,ITC,ITC1,1,Piemonte
2021-03-19,CAM,11143,4974,6169,7271,3872,ITF,ITF3,15,Campania
2021-02-10,MOL,151,79,72,131,20,ITF,ITF2,14,Molise
2021-03-12,PAT,2513,938,1575,1707,806,ITH,ITH2,4,Provincia Autonoma Trento
2021-04-10,MAR,10915,4620,6295,10602,313,ITI,ITI3,11,Marche
2021-05-22,CAL,22170,10550,11620,14320,7850,ITF,ITF6,18,Calabria
2021-01-03,MAR,907,354,553,907,0,ITI,ITI3,11,Marche
2021-04-22,PUG,22998,10528,12470,18079,4919,ITF,ITF4,16,Puglia
2021-05-12,BAS,4724,2327,2397,2842,1882,ITF,ITF5,17,Basilicata
2021-05-21,MOL,2096,1050,1046,1774,322,ITF,ITF2,14,Molise
2021-06-20,PAT,1686,934,752,25,1661,ITH,ITH2,4,Provincia Autonoma Trento
2021-03-19,LOM,32420,12913,19507,19224,13196,ITC,ITC4,3,Lombardia
2021-05-13,TOS,35017,15441,19576,13839,21178,ITI,ITI1,9,Toscana
2021-01-27,MOL,674,251,423,8,666,ITF,ITF2,14,Molise
2021-03-31,SIC,14406,6673,7733,9474,4932,ITG,ITG1,19,Sicilia
2021-05-15,FVG,12643,6097,6546,7952,4691,ITH,ITH4,6,Friuli-Venezia Giulia
2021-04-03,LIG,5404,2497,2907,4461,943,ITC,ITC3,7,Liguria
2021-04-21,CAL,11561,5805,5756,8629,2932,ITF,ITF6,18,Calabria
2021-05-01,FVG,7189,3244,3945,6146,1043,ITH,ITH4,6,Friuli-Venezia Giulia
2021-06-10,UMB,7438,3710,3728,6673,765,ITI,ITI2,10,Umbria
2021-01-07,SIC,8911,4123,4788,8911,0,ITG,ITG1,19,Sicilia
2021-04-06,ABR,7680,3580,4100,5362,2318,ITF,ITF1,13,Abruzzo
2021-04-29,TOS,39315,17706,21609,19246,20069,ITI,ITI1,9,Toscana
2021-06-10,CAM,73317,35377,37940,66307,7010,ITF,ITF3,15,Campania
2021-01-21,FVG,896,345,551,1,895,ITH,ITH4,6,Friuli-Venezia Giulia
2021-03-12,LAZ,23760,10881,12879,17443,6317,ITI,ITI4,12,Lazio
2021-06-04,PAB,6457,3237,3220,4928,1529,ITH,ITH1,4,Provincia Autonoma Bolzano / Bozen
2021-02-24,PAB,1367,406,961,1355,12,ITH,ITH1,4,Provincia Autonoma Bolzano / Bozen
2021-06-08,VEN,43344,22423,20921,37274,6070,ITH,ITH3,5,Veneto
2021-01-02,PAT,502,143,359,502,0,ITH,ITH2,4,Provincia Autonoma Trento
2021-05-25,VEN,27712,13378,14334,11705,16007,ITH,ITH3,5,Veneto
2021-05-27,SAR,17457,8974,8483,12253,5204,ITG,ITG2,20,Sardegna
2021-02-14,VEN,125,56,69,112,13,ITH,ITH3,5,Veneto
2021-02-21,FVG,801,281,520,423,378,ITH,ITH4,6,Friuli-Venezia Giulia
2021-02-16,SAR,700,289,411,673,27,ITG,ITG2,20,Sardegna
2021-03-24,TOS,20010,8299,11711,10554,9456,ITI,ITI1,9,Toscana
2021-05-01,PIE,28532,12996,15536,16734,11798,ITC,ITC1,1,Piemonte
2021-02-12,PUG,4212,1672,2540,3120,1092,ITF,ITF4,16,Puglia
2021-03-08,MAR,6263,2743,3520,5261,1002,ITI,ITI3,11,Marche
2021-01-11,VDA,325,112,213,325,0,ITC,ITC2,2,Valle d'Aosta / Vallée d'Aoste
2021-01-21,PIE,6881,2314,4567,3385,3496,ITC,ITC1,1,Piemonte
2021-01-24,LIG,756,237,519,113,643,ITC,ITC3,7,Liguria
2021-03-05,SAR,5211,2605,2606,2857,2354,ITG,ITG2,20,Sardegna
2021-02-09,LAZ,8799,3769,5030,4580,4219,ITI,ITI4,12,Lazio
2021-03-27,PAB,3050,1553,1497,1543,1507,ITH,ITH1,4,Provincia Autonoma Bolzano / Bozen
2021-03-29,PAT,2472,960,1512,1737,735,ITH,ITH2,4,Provincia Autonoma Trento
2021-04-02,CAL,8259,3763,4496,4384,3875,ITF,ITF6,18,Calabria
2021-02-28,VEN,4136,1389,2747,3299,837,ITH,ITH3,5,Veneto
2021-02-23,LAZ,11093,4783,6310,10331,762,ITI,ITI4,12,Lazio
2021-03-13,PAB,2885,1459,1426,2784,101,ITH,ITH1,4,Provincia Autonoma Bolzano / Bozen
2021-04-12,PAT,3093,1409,1684,2597,496,ITH,ITH2,4,Provincia Autonoma Trento
2021-05-15,PIE,33748,15732,18016,20045,13703,ITC,ITC1,1,Piemonte
2021-01-29,PUG,6199,2662,3537,436,5763,ITF,ITF4,16,Puglia
2021-04-06,BAS,1267,461,806,1082,185,ITF,ITF5,17,Basilicata
2021-06-01,PIE,29210,14634,14576,24840,4370,ITC,ITC1,1,Piemonte
2021-03-17,VEN,14645,5992,8653,7849,6796,ITH,ITH3,5,Veneto
2021-05-27,LOM,94701,45390,49311,41362,53339,ITC,ITC4,3,Lombardia
2021-01-08,MOL,429,141,288,429,0,ITF,ITF2,14,Molise
2021-02-21,PIE,5090,2083,3007,4988,102,ITC,ITC1,1,Piemonte
2021-02-21,TOS,5105,2089,3016,4935,170,ITI,ITI1,9,Toscana
2021-03-19,SAR,7271,3051,4220,5056,2215,ITG,ITG2,20,Sardegna
2021-02-05,MAR,2154,653,1501,439,1715,ITI,ITI3,11,Marche
2021-03-19,CAL,4190,1950,2240,1900,2290,ITF,ITF6,18,Calabria
2021-03-20,PUG,8414,3878,4536,3820,4594,ITF,ITF4,16,Puglia
2021-06-14,BAS,4810,2147,2663,2102,2708,ITF,ITF5,17,Basilicata
2021-03-03,PUG,16773,6796,9977,14859,1914,ITF,ITF4,16,Puglia
2021-04-04,VDA,572,253,319,571,1,ITC,ITC2,2,Valle d'Aosta / Vallée d'Aoste
2021-05-08,CAM,56413,27128,29285,40586,15827,ITF,ITF3,15,Campania
2021-06-01,TOS,26877,13352,13525,23076,3801,ITI,ITI1,9,Toscana
2021-01-02,EMR,2375,916,1459,2375,0,ITH,ITH5,8,Emilia-Romagna
2021-04-24,LOM,75747,33570,42177,54624,21123,ITC,ITC4,3,Lombardia
2021-05-16,MAR,10898,4957,5941,6670,4228,ITI,ITI3,11,Marche
2021-01-28,CAM,8832,4121,4711,134,8698,ITF,ITF3,15,Campania
2021-02-05,PAB,3195,1181,2014,8,3187,ITH,ITH1,4,Provincia Autonoma Bolzano / Bozen
2021-03-23,BAS,1592,611,981,1422,170,ITF,ITF5,17,Basilicata
2021-06-11,PUG,46970,22995,23975,33237,13733,ITF,ITF4,16,Puglia
2021-01-14,LOM,26872,7791,19081,26872,0,ITC,ITC4,3,Lombardia
2021-01-21,PAT,352,95,257,228,124,ITH,ITH2,4,Provincia Autonoma Trento
2021-04-01,MOL,1469,667,802,743,726,ITF,ITF2,14,Molise
2021-05-30,MAR,9732,4690,5042,6743,2989,ITI,ITI3,11,Marche
2021-06-05,EMR,43969,22230,21739,37114,6855,ITH,ITH5,8,Emilia-Romagna
2021-05-01,PAT,4848,2468,2380,4812,36,ITH,ITH2,4,Provincia Autonoma Trento
2021-05-08,LOM,87689,40748,46941,65667,22022,ITC,ITC4,3,Lombardia
2021-02-09,SIC,4349,1800,2549,3315,1034,ITG,ITG1,19,Sicilia
2021-03-26,FVG,5995,2598,3397,3978,2017,ITH,ITH4,6,Friuli-Venezia Giulia
2021-05-09,ABR,9152,4087,5065,4283,4869,ITF,ITF1,13,Abruzzo
2021-02-12,LIG,1928,689,1239,896,1032,ITC,ITC3,7,Liguria
2021-03-12,FVG,4098,1692,2406,2717,1381,ITH,ITH4,6,Friuli-Venezia Giulia
2021-04-21,UMB,5318,2313,3005,3092,2226,ITI,ITI2,10,Umbria
2021-06-15,TOS,31116,16007,15109,26591,4525,ITI,ITI1,9,Toscana
2021-02-15,ABR,1794,831,963,1752,42,ITF,ITF1,13,Abruzzo
2021-03-10,TOS,18366,7402,10964,14348,4018,ITI,ITI1,9,Toscana
2021-06-10,CAL,15312,7038,8274,12537,2775,ITF,ITF6,18,Calabria
2021-04-21,CAM,30222,14722,15500,17996,12226,ITF,ITF3,15,Campania
2021-05-26,ABR,13385,5943,7442,8389,4996,ITF,ITF1,13,Abruzzo
2021-05-17,EMR,32374,15386,16988,22893,9481,ITH,ITH5,8,Emilia-Romagna
2021-01-02,FVG,1216,470,746,1216,0,ITH,ITH4,6,Friuli-Venezia Giulia
2021-01-21,LAZ,5603,2349,3254,550,5053,ITI,ITI4,12,Lazio
2021-04-15,PAB,4399,2307,2092,4136,263,ITH,ITH1,4,Provincia Autonoma Bolzano / Bozen
2021-06-14,ABR,10859,5371,5488,7491,3368,ITF,ITF1,13,Abruzzo
2021-01-12,VEN,5230,1516,3714,5230,0,ITH,ITH3,5,Veneto
2021-02-21,PAT,155,92,63,43,112,ITH,ITH2,4,Provincia Autonoma Trento
2021-03-02,UMB,3642,1346,2296,3638,4,ITI,ITI2,10,Umbria
2021-04-19,VEN,21535,8918,12617,5125,16410,ITH,ITH3,5,Veneto
2021-05-20,SIC,43470,20792,22678,27618,15852,ITG,ITG1,19,Sicilia
2021-06-20,PIE,28435,14160,14275,15341,13094,ITC,ITC1,1,Piemonte
2021-04-05,VEN,19141,8367,10774,13701,5440,ITH,ITH3,5,Veneto
2021-02-02,TOS,3743,1475,2268,196,3547,ITI,ITI1,9,Toscana
2021-03-12,PIE,13950,5184,8766,11015,2935,ITC,ITC1,1,Piemonte
2021-04-07,SAR,13544,6052,7492,7896,5648,ITG,ITG2,20,Sardegna
2021-04-12,FVG,7255,3181,4074,6124,1131,ITH,ITH4,6,Friuli-Venezia Giulia
2021-01-26,VEN,6918,2091,4827,152,6766,ITH,ITH3,5,Veneto
2021-04-24,SAR,10369,4851,5518,8030,2339,ITG,ITG2,20,Sardegna
2021-04-27,MAR,9399,4309,5090,5413,3986,ITI,ITI3,11,Marche
2021-05-15,PAT,1567,815,752,679,888,ITH,ITH2,4,Provincia Autonoma Trento
2021-03-31,LAZ,27457,13199,14258,20361,7096,ITI,ITI4,12,Lazio
2021-01-14,SAR,1105,426,679,1105,0,ITG,ITG2,20,Sardegna
2021-02-01,BAS,242,91,151,46,196,ITF,ITF5,17,Basilicata
2021-03-15,LIG,7246,3097,4149,4540,2706,ITC,ITC3,7,Liguria
2021-04-03,PUG,10554,4640,5914,6997,3557,ITF,ITF4,16,Puglia
2021-03-26,PIE,17759,6985,10774,8852,8907,ITC,ITC1,1,Piemonte
2021-05-02,PAB,2457,1288,1169,1536,921,ITH,ITH1,4,Provincia Autonoma Bolzano / Bozen
2021-06-01,PAT,4010,1874,2136,1157,2853,ITH,ITH2,4,Provincia Autonoma Trento
2021-02-13,VDA,216,196,20,215,1,ITC,ITC2,2,Valle d'Aosta / Vallée d'Aoste
2021-01-22,PAB,248,143,105,124,124,ITH,ITH1,4,Provincia Autonoma Bolzano / Bozen
2021-04-07,LOM,50571,20915,29656,34765,15806,ITC,ITC4,3,Lombardia
2021-05-06,VEN,46900,22003,24897,38428,8472,ITH,ITH3,5,Veneto
2021-01-07,LAZ,7749,2904,4845,7749,0,ITI,ITI4,12,Lazio
2021-01-17,MAR,1610,689,921,1550,60,ITI,ITI3,11,Marche
2021-05-26,BAS,4489,2260,2229,1707,2782,ITF,ITF5,17,Basilicata
