data_somministrazione,area,totale,sesso_maschile,sesso_femminile,categoria_operatori_sanitari_sociosanitari,categoria_personale_non_sanitario,categoria_ospiti_rsa,categoria_over80,prima_dose,seconda_dose,codice_NUTS1,codice_NUTS2,codice_regione_ISTAT,nome_area
2021-01-12,PUG,4198,1761,2437,3623,356,218,1,4198,0,ITF,ITF4,16,Puglia
2021-01-26,MAR,2016,746,1270,1736,194,86,0,92,1924,ITI,ITI3,11,Marche
2021-01-04,SIC,8371,4171,4200,7593,772,6,0,8371,0,ITG,ITG1,19,Sicilia
2021-02-11,PIE,5672,1815,3857,3059,1214,1399,0,2633,3039,ITC,ITC1,1,Piemonte
2021-02-01,EMR,10285,3593,6692,7422,1608,1255,0,366,9919,ITH,ITH5,8,Emilia-Romagna
2021-01-27,VDA,151,71,80,53,27,18,53,79,72,ITC,ITC2,2,Valle d'Aosta / Vallée d'Aoste
2021-01-25,CAL,1064,512,552,1021,43,0,0,156,908,ITF,ITF6,18,Calabria
2021-01-02,LIG,686,245,441,590,96,0,0,686,0,ITC,ITC3,7,Liguria
2021-01-18,CAM,942,399,543,576,193,173,0,698,244,ITF,ITF3,15,Campania
2021-01-23,LAZ,6883,2682,4201,6063,278,417,125,255,6628,ITI,ITI4,12,Lazio
2021-01-28,TOS,6266,1877,4389,5418,66,782,0,348,5918,ITI,ITI1,9,Toscana
2021-02-11,SAR,1089,404,685,543,327,218,1,979,110,ITG,ITG2,20,Sardegna
2021-01-16,PIE,7753,2631,5122,4796,1589,1368,0,7753,0,ITC,ITC1,1,Piemonte
2020-12-27,VDA,20,9,11,20,0,0,0,20,0,ITC,ITC2,2,Valle d'Aosta / Vallée d'Aoste
2021-01-30,SIC,7832,3568,4264,5445,1912,475,0,171,7661,ITG,ITG1,19,Sicilia
2021-02-07,PUG,1288,583,705,910,217,161,0,244,1044,ITF,ITF4,16,Puglia
2021-01-06,EMR,8257,2938,5319,6811,795,651,0,8257,0,ITH,ITH5,8,Emilia-Romagna
2021-01-30,UMB,1576,483,1093,841,18,716,1,43,1533,ITI,ITI2,10,Umbria
2021-01-18,FVG,1959,606,1353,1358,491,110,0,1865,94,ITH,ITH4,6,Friuli-Venezia Giulia
2021-02-05,ABR,1534,520,1014,1187,241,106,0,787,747,ITF,ITF1,13,Abruzzo
2021-02-10,BAS,428,202,226,133,147,58,90,376,52,ITF,ITF5,17,Basilicata
2021-01-12,MAR,1226,413,813,912,264,50,0,1226,0,ITI,ITI3,11,Marche
2021-01-02,TOS,3497,1097,2400,2682,15,800,0,3497,0,ITI,ITI1,9,Toscana
2021-02-04,LOM,26118,7695,18423,14825,5860,5243,190,1783,24335,ITC,ITC4,3,Lombardia
2021-01-16,SAR,1492,525,967,1282,210,0,0,1492,0,ITG,ITG2,20,Sardegna
2021-01-11,UMB,1271,336,935,878,20,373,0,1271,0,ITI,ITI2,10,Umbria
2021-02-09,TOS,4457,1452,3005,3580,388,489,0,3849,608,ITI,ITI1,9,Toscana
2021-01-06,CAL,926,500,426,822,104,0,0,926,0,ITF,ITF6,18,Calabria
2021-02-02,LIG,2534,953,1581,1831,265,438,0,223,2311,ITC,ITC3,7,Liguria
2021-01-28,VEN,9171,2652,6519,6455,1292,1424,0,166,9005,ITH,ITH3,5,Veneto
2020-12-31,PUG,1634,783,851,1546,44,44,0,1634,0,ITF,ITF4,16,Puglia
2021-02-07,MAR,1867,734,1133,1155,666,46,0,344,1523,ITI,ITI3,11,Marche
2021-01-10,BAS,77,24,53,9,68,0,0,77,0,ITF,ITF5,17,Basilicata
2021-01-08,VDA,299,130,169,240,43,16,0,299,0,ITC,ITC2,2,Valle d'Aosta / Vallée d'Aoste
2021-01-11,LAZ,5525,2103,3422,4553,403,569,0,5525,0,ITI,ITI4,12,Lazio
2021-01-04,PIE,5559,1676,3883,4587,737,235,0,5559,0,ITC,ITC1,1,Piemonte
2021-01-16,SIC,2698,1153,1545,1251,1149,298,0,2698,0,ITG,ITG1,19,Sicilia
2021-01-25,CAM,5744,2926,2818,4743,945,56,0,164,5580,ITF,ITF3,15,Campania
2021-02-01,CAL,2495,1191,1304,2044,408,43,0,247,2248,ITF,ITF6,18,Calabria
2021-01-16,LOM,15201,5677,9524,8132,5649,1241,179,15201,0,ITC,ITC4,3,Lombardia
2021-01-16,VEN,4545,1530,3015,3149,748,648,0,4545,0,ITH,ITH3,5,Veneto
2021-01-28,PAT,530,147,383,328,95,107,0,48,482,ITH,ITH2,4,Provincia Autonoma Trento
2021-01-12,MOL,336,114,222,132,75,129,0,336,0,ITF,ITF2,14,Molise
2021-01-22,BAS,66,24,42,6,60,0,0,66,0,ITF,ITF5,17,Basilicata
2021-02-05,BAS,980,440,540,509,281,190,0,62,918,ITF,ITF5,17,Basilicata
2021-01-04,SAR,591,217,374,565,26,0,0,591,0,ITG,ITG2,20,Sardegna
2021-02-03,VDA,348,114,234,157,141,49,1,13,335,ITC,ITC2,2,Valle d'Aosta / Vallée d'Aoste
2021-02-11,SIC,5324,2097,3227,2454,1983,887,0,4860,464,ITG,ITG1,19,Sicilia
2021-02-04,PIE,10186,3334,6852,6232,2199,1755,0,581,9605,ITC,ITC1,1,Piemonte
2021-01-07,MAR,1802,633,1169,1480,322,0,0,1802,0,ITI,ITI3,11,Marche
2021-01-21,LIG,831,308,523,440,193,197,1,460,371,ITC,ITC3,7,Liguria
2021-01-06,FVG,709,264,445,514,195,0,0,709,0,ITH,ITH4,6,Friuli-Venezia Giulia
2021-01-12,PAB,1527,398,1129,299,680,475,73,1527,0,ITH,ITH1,4,Provincia Autonoma Bolzano / Bozen
2021-01-24,ABR,50,22,28,49,1,0,0,6,44,ITF,ITF1,13,Abruzzo
2021-01-25,EMR,6411,2127,4284,5209,524,678,0,221,6190,ITH,ITH5,8,Emilia-Romagna
2021-02-06,FVG,1152,337,815,755,207,190,0,21,1131,ITH,ITH4,6,Friuli-Venezia Giulia
2021-01-19,MAR,225,81,144,120,20,85,0,141,84,ITI,ITI3,11,Marche
2021-01-31,MOL,268,70,198,85,19,164,0,6,262,ITF,ITF2,14,Molise
2020-12-28,LOM,103,44,59,102,1,0,0,103,0,ITC,ITC4,3,Lombardia
2021-02-04,SAR,2267,814,1453,1736,361,169,1,912,1355,ITG,ITG2,20,Sardegna
2021-01-11,SIC,5903,2590,3313,3923,1598,382,0,5903,0,ITG,ITG1,19,Sicilia
2021-02-06,UMB,396,138,258,333,47,16,0,34,362,ITI,ITI2,10,Umbria
2021-01-17,MOL,78,38,40,78,0,0,0,48,30,ITF,ITF2,14,Molise
2021-01-31,PUG,1799,821,978,1493,106,198,2,67,1732,ITF,ITF4,16,Puglia
2021-01-28,LOM,11833,3599,8234,8773,2286,744,30,662,11171,ITC,ITC4,3,Lombardia
2021-01-17,BAS,326,131,195,95,177,54,0,325,1,ITF,ITF5,17,Basilicata
2021-01-16,PAT,318,147,171,299,5,14,0,318,0,ITH,ITH2,4,Provincia Autonoma Trento
2021-01-24,PAB,12,10,2,1,11,0,0,0,12,ITH,ITH1,4,Provincia Autonoma Bolzano / Bozen
2021-01-09,TOS,4483,1596,2887,3779,144,560,0,4483,0,ITI,ITI1,9,Toscana
2021-02-06,CAM,5335,2662,2673,1988,2876,456,15,2101,3234,ITF,ITF3,15,Campania
2021-01-13,EMR,9063,2939,6124,5860,1460,1743,0,9063,0,ITH,ITH5,8,Emilia-Romagna
2020-12-28,SIC,207,124,83,205,2,0,0,207,0,ITG,ITG1,19,Sicilia
2021-01-23,PIE,4216,1321,2895,3189,522,505,0,876,3340,ITC,ITC1,1,Piemonte
2021-02-11,LAZ,6600,2762,3838,2166,333,500,3601,6402,198,ITI,ITI4,12,Lazio
2021-02-09,LIG,1482,570,912,881,371,230,0,209,1273,ITC,ITC3,7,Liguria
2021-01-03,BAS,899,344,555,788,111,0,0,899,0,ITF,ITF5,17,Basilicata
2021-01-31,MAR,1919,769,1150,1527,392,0,0,105,1814,ITI,ITI3,11,Marche
2021-01-06,CAM,7652,3748,3904,5780,1572,300,0,7652,0,ITF,ITF3,15,Campania
2021-01-23,SAR,60,22,38,60,0,0,0,0,60,ITG,ITG2,20,Sardegna
2021-01-04,LAZ,7477,2907,4570,7074,87,316,0,7477,0,ITI,ITI4,12,Lazio
2021-02-05,MOL,593,269,324,460,70,63,0,55,538,ITF,ITF2,14,Molise
2021-01-23,SIC,4129,2137,1992,3892,221,16,0,225,3904,ITG,ITG1,19,Sicilia
2021-01-09,LOM,12375,4558,7817,8133,4040,192,10,12375,0,ITC,ITC4,3,Lombardia
2021-01-25,FVG,1582,567,1015,1369,141,72,0,194,1388,ITH,ITH4,6,Friuli-Venezia Giulia
2021-01-05,ABR,1614,604,1010,1604,10,0,0,1614,0,ITF,ITF1,13,Abruzzo
2021-01-15,VDA,218,82,136,116,68,28,6,218,0,ITC,ITC2,2,Valle d'Aosta / Vallée d'Aoste
2021-01-18,UMB,588,215,373,315,149,124,0,504,84,ITI,ITI2,10,Umbria
2021-02-04,VEN,7267,2007,5260,3423,1532,2300,12,541,6726,ITH,ITH3,5,Veneto
2021-01-13,CAL,2028,1022,1006,1800,194,34,0,2028,0,ITF,ITF6,18,Calabria
2021-01-09,PAT,183,40,143,139,14,30,0,183,0,ITH,ITH2,4,Provincia Autonoma Trento
2021-01-21,TOS,1570,686,884,574,220,776,0,850,720,ITI,ITI1,9,Toscana
2021-01-30,LAZ,6637,2726,3911,5286,574,651,126,436,6201,ITI,ITI4,12,Lazio
2021-01-14,LIG,2610,926,1684,1609,573,428,0,2610,0,ITC,ITC3,7,Liguria
2021-02-04,SIC,6870,3157,3713,4412,1918,540,0,1458,5412,ITG,ITG1,19,Sicilia
2020-12-28,SAR,65,25,40,65,0,0,0,65,0,ITG,ITG2,20,Sardegna
2020-12-31,MAR,383,178,205,370,13,0,0,383,0,ITI,ITI3,11,Marche
2021-01-17,ABR,187,59,128,136,51,0,0,180,7,ITF,ITF1,13,Abruzzo
2021-01-05,MOL,449,180,269,441,8,0,0,449,0,ITF,ITF2,14,Molise
2021-02-04,PAT,961,300,661,529,38,81,313,418,543,ITH,ITH2,4,Provincia Autonoma Trento
2021-01-05,PAB,820,283,537,718,102,0,0,820,0,ITH,ITH1,4,Provincia Autonoma Bolzano / Bozen
2020-12-30,FVG,630,246,384,601,29,0,0,630,0,ITH,ITH4,6,Friuli-Venezia Giulia
2021-01-09,VEN,7924,2535,5389,5164,1184,1573,3,7924,0,ITH,ITH3,5,Veneto
2021-01-19,PUG,1220,451,769,526,119,575,0,1210,10,ITF,ITF4,16,Puglia
2021-01-29,BAS,611,228,383,274,267,70,0,62,549,ITF,ITF5,17,Basilicata
2021-02-07,MOL,66,32,34,49,1,16,0,19,47,ITF,ITF2,14,Molise
2021-01-11,CAL,2154,1040,1114,1759,392,3,0,2154,0,ITF,ITF6,18,Calabria
2021-02-06,VEN,4077,1347,2730,3007,709,361,0,705,3372,ITH,ITH3,5,Veneto
2021-02-06,PAT,572,296,276,172,96,0,304,432,140,ITH,ITH2,4,Provincia Autonoma Trento
2021-01-28,LIG,2743,935,1808,2127,310,306,0,34,2709,ITC,ITC3,7,Liguria
2020-12-27,ABR,37,19,18,34,1,2,0,37,0,ITF,ITF1,13,Abruzzo
2021-01-18,SIC,1547,645,902,720,619,208,0,1431,116,ITG,ITG1,19,Sicilia
2021-01-23,VEN,4060,1253,2807,3402,207,450,1,34,4026,ITH,ITH3,5,Veneto
2021-01-04,LOM,5975,2058,3917,4597,1197,166,15,5975,0,ITC,ITC4,3,Lombardia
2021-01-30,FVG,2270,744,1526,1475,354,441,0,269,2001,ITH,ITH4,6,Friuli-Venezia Giulia
2021-01-10,ABR,1139,409,730,1091,48,0,0,1139,0,ITF,ITF1,13,Abruzzo
2021-01-15,BAS,812,349,463,449,190,173,0,812,0,ITF,ITF5,17,Basilicata
2021-02-11,LIG,833,338,495,571,193,69,0,452,381,ITC,ITC3,7,Liguria
2021-01-26,PAB,809,291,518,670,139,0,0,1,808,ITH,ITH1,4,Provincia Autonoma Bolzano / Bozen
2021-01-06,LAZ,5095,1950,3145,4618,157,320,0,5095,0,ITI,ITI4,12,Lazio
2021-01-13,UMB,450,139,311,379,29,42,0,450,0,ITI,ITI2,10,Umbria
2021-01-10,VDA,220,71,149,172,29,19,0,220,0,ITC,ITC2,2,Valle d'Aosta / Vallée d'Aoste
2020-12-30,PIE,730,322,408,685,45,0,0,730,0,ITC,ITC1,1,Piemonte
2021-01-30,CAM,10721,5079,5642,6930,3564,227,0,39,10682,ITF,ITF3,15,Campania
2021-01-16,TOS,3248,1037,2211,2493,538,217,0,3248,0,ITI,ITI1,9,Toscana
2021-01-11,VEN,7237,2101,5136,3503,1531,1956,247,7237,0,ITH,ITH3,5,Veneto
2021-01-07,MOL,598,209,389,414,39,145,0,598,0,ITF,ITF2,14,Molise
2021-02-06,CAL,2908,1337,1571,2094,567,247,0,442,2466,ITF,ITF6,18,Calabria
2021-01-23,PAT,571,331,240,483,0,88,0,384,187,ITH,ITH2,4,Provincia Autonoma Trento
2021-02-05,VDA,294,102,192,159,82,0,53,101,193,ITC,ITC2,2,Valle d'Aosta / Vallée d'Aoste
2021-01-21,PUG,2123,900,1223,1423,173,527,0,1270,853,ITF,ITF4,16,Puglia
2021-01-27,BAS,409,173,236,149,234,26,0,112,297,ITF,ITF5,17,Basilicata
2021-01-22,ABR,118,57,61,2,4,112,0,118,0,ITF,ITF1,13,Abruzzo
2020-12-31,PAB,866,497,369,439,427,0,0,866,0,ITH,ITH1,4,Provincia Autonoma Bolzano / Bozen
2021-01-23,EMR,2441,868,1573,1897,114,430,0,439,2002,ITH,ITH5,8,Emilia-Romagna
2021-01-04,FVG,1510,559,951,1392,118,0,0,1510,0,ITH,ITH4,6,Friuli-Venezia Giulia
2021-01-30,PIE,5976,2134,3842,4365,1116,495,0,217,5759,ITC,ITC1,1,Piemonte
2021-01-16,LIG,1252,544,708,686,268,298,0,1252,0,ITC,ITC3,7,Liguria
2021-02-01,LAZ,5667,2172,3495,4782,319,559,7,351,5316,ITI,ITI4,12,Lazio
2021-02-11,TOS,5276,1970,3306,2797,2223,256,0,5068,208,ITI,ITI1,9,Toscana
2021-01-04,CAM,5823,2961,2862,4848,975,0,0,5823,0,ITF,ITF3,15,Campania
2021-02-11,LOM,14268,4398,9870,8237,3314,2689,28,8355,5913,ITC,ITC4,3,Lombardia
2021-01-30,EMR,10034,3507,6527,7556,1714,764,0,143,9891,ITH,ITH5,8,Emilia-Romagna
2021-02-07,PAB,2162,973,1189,99,397,1,1665,10,2152,ITH,ITH1,4,Provincia Autonoma Bolzano / Bozen
2021-01-21,MAR,895,252,643,459,100,336,0,585,310,ITI,ITI3,11,Marche
2021-01-16,CAM,3369,1674,1695,1355,1641,373,0,3369,0,ITF,ITF3,15,Campania
2021-02-11,VEN,3445,1057,2388,2223,820,391,11,2921,524,ITH,ITH3,5,Veneto
2020-12-30,SIC,173,101,72,156,17,0,0,173,0,ITG,ITG1,19,Sicilia
2021-02-11,PAT,993,347,646,255,70,0,668,738,255,ITH,ITH2,4,Provincia Autonoma Trento
2021-01-26,MOL,450,184,266,444,6,0,0,8,442,ITF,ITF2,14,Molise
2020-12-27,BAS,106,41,65,104,2,0,0,106,0,ITF,ITF5,17,Basilicata
2021-01-22,VDA,56,21,35,36,0,20,0,20,36,ITC,ITC2,2,Valle d'Aosta / Vallée d'Aoste
2021-02-09,PUG,3422,1386,2036,2166,648,608,0,1807,1615,ITF,ITF4,16,Puglia
2021-02-04,FVG,2729,806,1923,1721,543,465,0,36,2693,ITH,ITH4,6,Friuli-Venezia Giulia
2021-01-23,TOS,3948,1354,2594,2935,172,841,0,639,3309,ITI,ITI1,9,Toscana
2021-01-30,SAR,3862,1392,2470,2987,874,0,1,362,3500,ITG,ITG2,20,Sardegna
2021-01-15,ABR,379,149,230,223,121,35,0,379,0,ITF,ITF1,13,Abruzzo
2021-01-04,EMR,7254,2509,4745,6148,529,577,0,7254,0,ITH,ITH5,8,Emilia-Romagna
2020-12-30,PAT,6,2,4,4,1,1,0,6,0,ITH,ITH2,4,Provincia Autonoma Trento
2021-01-23,CAL,400,186,214,325,52,23,0,358,42,ITF,ITF6,18,Calabria
2021-01-11,TOS,5092,1688,3404,4360,210,522,0,5092,0,ITI,ITI1,9,Toscana
2021-01-25,SIC,7506,3692,3814,6630,806,70,0,320,7186,ITG,ITG1,19,Sicilia
2021-01-26,PUG,5348,2395,2953,4837,281,230,0,568,4780,ITF,ITF4,16,Puglia
2021-01-11,PAT,723,219,504,514,59,150,0,723,0,ITH,ITH2,4,Provincia Autonoma Trento
2021-02-11,CAM,6276,2701,3575,1859,1924,132,2361,6208,68,ITF,ITF3,15,Campania
2021-01-25,UMB,647,322,325,645,2,0,0,5,642,ITI,ITI2,10,Umbria
2021-01-23,FVG,816,324,492,768,48,0,0,4,812,ITH,ITH4,6,Friuli-Venezia Giulia
2021-02-10,ABR,947,312,635,621,210,116,0,503,444,ITF,ITF1,13,Abruzzo
2021-01-18,EMR,3125,879,2246,1667,330,1128,0,2448,677,ITH,ITH5,8,Emilia-Romagna
2021-01-18,PIE,6090,2036,4054,3219,1401,1470,0,5842,248,ITC,ITC1,1,Piemonte
2021-02-08,UMB,637,203,434,368,116,153,0,88,549,ITI,ITI2,10,Umbria
2021-02-06,LAZ,5068,2015,3053,3269,630,660,509,768,4300,ITI,ITI4,12,Lazio
2021-01-30,LOM,12066,4451,7615,9660,2239,159,8,191,11875,ITC,ITC4,3,Lombardia
2021-02-04,LIG,2686,950,1736,1772,473,441,0,235,2451,ITC,ITC3,7,Liguria
2021-01-02,PUG,2943,1295,1648,2807,113,23,0,2943,0,ITF,ITF4,16,Puglia
2021-01-08,BAS,557,220,337,262,234,61,0,557,0,ITF,ITF5,17,Basilicata
2021-01-03,ABR,471,185,286,464,7,0,0,471,0,ITF,ITF1,13,Abruzzo
2021-01-06,UMB,843,323,520,840,3,0,0,843,0,ITI,ITI2,10,Umbria
2021-01-11,CAM,4069,1869,2200,2382,1435,252,0,4069,0,ITF,ITF3,15,Campania
2021-02-04,TOS,4245,1590,2655,3166,624,455,0,955,3290,ITI,ITI1,9,Toscana
2021-01-18,SAR,904,326,578,714,190,0,0,780,124,ITG,ITG2,20,Sardegna
2021-02-11,EMR,3844,1309,2535,2370,707,530,237,3227,617,ITH,ITH5,8,Emilia-Romagna
2020-12-30,LAZ,1601,621,980,1575,0,26,0,1601,0,ITI,ITI4,12,Lazio
2021-01-17,VDA,131,56,75,49,3,20,59,131,0,ITC,ITC2,2,Valle d'Aosta / Vallée d'Aoste
2021-01-13,LAZ,5559,2063,3496,4145,402,1009,3,5559,0,ITI,ITI4,12,Lazio
2021-02-02,MAR,1193,397,796,804,296,93,0,73,1120,ITI,ITI3,11,Marche
2021-01-30,VEN,8714,2661,6053,6192,1312,1206,4,674,8040,ITH,ITH3,5,Veneto
2021-01-04,PAT,852,223,629,481,49,322,0,852,0,ITH,ITH2,4,Provincia Autonoma Trento
2021-01-18,CAL,1230,550,680,982,237,11,0,1040,190,ITF,ITF6,18,Calabria
2021-01-25,LAZ,7761,3041,4720,7006,270,363,122,421,7340,ITI,ITI4,12,Lazio
2021-01-11,LOM,15967,5309,10658,10160,5163,544,100,15967,0,ITC,ITC4,3,Lombardia
2021-01-09,LIG,1306,464,842,947,173,186,0,1306,0,ITC,ITC3,7,Liguria
2021-01-20,UMB,613,222,391,583,16,14,0,613,0,ITI,ITI2,10,Umbria
2021-01-30,PAT,383,130,253,344,8,31,0,151,232,ITH,ITH2,4,Provincia Autonoma Trento
2021-01-29,VDA,316,138,178,259,41,16,0,2,314,ITC,ITC2,2,Valle d'Aosta / Vallée d'Aoste
2021-01-04,CAL,996,492,504,969,27,0,0,996,0,ITF,ITF6,18,Calabria
2021-01-04,VEN,6724,2029,4695,5237,573,913,1,6724,0,ITH,ITH3,5,Veneto
2021-02-06,SIC,4918,2146,2772,2469,1879,570,0,1461,3457,ITG,ITG1,19,Sicilia
2021-01-02,MAR,453,139,314,444,9,0,0,453,0,ITI,ITI3,11,Marche
2021-01-11,FVG,1881,609,1272,1499,336,46,0,1881,0,ITH,ITH4,6,Friuli-Venezia Giulia
2021-02-03,BAS,666,300,366,305,189,172,0,32,634,ITF,ITF5,17,Basilicata
2021-01-07,PAB,892,317,575,613,227,0,52,892,0,ITH,ITH1,4,Provincia Autonoma Bolzano / Bozen
2021-01-14,PUG,4048,1579,2469,3152,401,495,0,4048,0,ITF,ITF4,16,Puglia
2021-01-29,ABR,1386,449,937,1290,96,0,0,74,1312,ITF,ITF1,13,Abruzzo
2021-01-07,PUG,5704,2448,3256,5149,341,214,0,5704,0,ITF,ITF4,16,Puglia
2021-02-11,FVG,1890,650,1240,1111,554,222,3,1700,190,ITH,ITH4,6,Friuli-Venezia Giulia
2021-01-01,UMB,269,102,167,268,1,0,0,269,0,ITI,ITI2,10,Umbria
2021-01-30,TOS,4548,1600,2948,3749,199,600,0,172,4376,ITI,ITI1,9,Toscana
2021-02-06,PIE,7977,2663,5314,5097,1628,1252,0,400,7577,ITC,ITC1,1,Piemonte
2021-01-14,MAR,2010,692,1318,1112,600,298,0,2010,0,ITI,ITI3,11,Marche
2021-02-06,EMR,7485,2363,5122,5274,1024,1148,39,2105,5380,ITH,ITH5,8,Emilia-Romagna
2021-01-23,LIG,799,289,510,630,126,43,0,145,654,ITC,ITC3,7,Liguria
2021-01-30,CAL,2173,1147,1026,1974,199,0,0,358,1815,ITF,ITF6,18,Calabria
2021-01-18,VEN,2689,764,1925,1210,537,934,8,2490,199,ITH,ITH3,5,Veneto
2020-12-28,LIG,75,26,49,72,3,0,0,75,0,ITC,ITC3,7,Liguria
2021-01-18,LAZ,5345,2069,3276,3411,756,725,453,4856,489,ITI,ITI4,12,Lazio
2021-01-23,CAM,3838,2029,1809,3161,609,68,0,272,3566,ITF,ITF3,15,Campania
2021-01-19,MOL,173,63,110,90,61,22,0,162,11,ITF,ITF2,14,Molise
2021-01-06,SIC,6470,3402,3068,5716,752,2,0,6470,0,ITG,ITG1,19,Sicilia
2021-02-04,CAM,7941,3427,4514,3964,3684,292,1,1308,6633,ITF,ITF3,15,Campania
2021-02-01,UMB,1260,333,927,876,32,352,0,47,1213,ITI,ITI2,10,Umbria
2021-01-11,PIE,8738,2979,5759,6051,1561,1126,0,8738,0,ITC,ITC1,1,Piemonte
2021-02-06,SAR,1967,696,1271,1541,287,139,0,567,1400,ITG,ITG2,20,Sardegna
2021-02-02,PUG,4259,1801,2458,3561,382,316,0,580,3679,ITF,ITF4,16,Puglia
2021-01-18,PAT,635,151,484,520,42,73,0,582,53,ITH,ITH2,4,Provincia Autonoma Trento
2021-02-10,VDA,227,75,152,48,43,10,126,131,96,ITC,ITC2,2,Valle d'Aosta / Vallée d'Aoste
2021-01-11,EMR,9323,3266,6057,6527,1530,1266,0,9323,0,ITH,ITH5,8,Emilia-Romagna
2021-02-09,MAR,125,42,83,78,21,26,0,47,78,ITI,ITI3,11,Marche
2021-01-23,LOM,1077,344,733,480,578,19,0,879,198,ITC,ITC4,3,Lombardia
2021-01-19,PAB,810,349,461,170,65,0,575,680,130,ITH,ITH1,4,Provincia Autonoma Bolzano / Bozen
2021-01-04,TOS,5063,1893,3170,4099,32,932,0,5063,0,ITI,ITI1,9,Toscana
2021-01-16,FVG,1231,360,871,771,212,248,0,1231,0,ITH,ITH4,6,Friuli-Venezia Giulia
2021-01-11,SAR,1180,504,676,654,526,0,0,1180,0,ITG,ITG2,20,Sardegna
2021-02-03,ABR,2061,717,1344,1541,402,118,0,419,1642,ITF,ITF1,13,Abruzzo
2021-02-10,CAM,6903,3421,3482,1944,2714,88,2157,6738,165,ITF,ITF3,15,Campania
2021-02-07,BAS,372,158,214,257,75,40,0,49,323,ITF,ITF5,17,Basilicata
2021-01-27,FVG,1269,425,844,849,356,64,0,447,822,ITH,ITH4,6,Friuli-Venezia Giulia
2021-02-02,ABR,1778,672,1106,1235,404,139,0,241,1537,ITF,ITF1,13,Abruzzo
2020-12-27,UMB,85,45,40,67,2,16,0,85,0,ITI,ITI2,10,Umbria
2021-01-25,TOS,5116,1895,3221,4153,56,907,0,246,4870,ITI,ITI1,9,Toscana
2021-01-09,MAR,1709,605,1104,1406,303,0,0,1709,0,ITI,ITI3,11,Marche
2021-02-09,PAB,316,126,190,64,23,2,227,1,315,ITH,ITH1,4,Provincia Autonoma Bolzano / Bozen
2021-01-21,MOL,6,2,4,0,6,0,0,6,0,ITF,ITF2,14,Molise
2021-02-08,PIE,6878,2350,4528,3776,1553,1549,0,664,6214,ITC,ITC1,1,Piemonte
2021-02-04,PUG,5722,2289,3433,4354,762,606,0,1128,4594,ITF,ITF4,16,Puglia
2021-01-25,SAR,588,212,376,553,35,0,0,22,566,ITG,ITG2,20,Sardegna
2021-01-29,EMR,10281,3470,6811,8063,1240,978,0,284,9997,ITH,ITH5,8,Emilia-Romagna
2021-01-01,SIC,814,436,378,739,75,0,0,814,0,ITG,ITG1,19,Sicilia
2021-01-27,UMB,838,329,509,837,1,0,0,13,825,ITI,ITI2,10,Umbria
2020-12-30,LIG,9,3,6,9,0,0,0,9,0,ITC,ITC3,7,Liguria
2021-02-04,MAR,2337,806,1531,1405,657,275,0,112,2225,ITI,ITI3,11,Marche
2021-01-07,BAS,640,319,321,306,305,29,0,640,0,ITF,ITF5,17,Basilicata
2021-01-18,LOM,8891,2904,5987,4070,3279,1426,116,7909,982,ITC,ITC4,3,Lombardia
2021-01-02,ABR,548,218,330,540,8,0,0,548,0,ITF,ITF1,13,Abruzzo
2021-01-14,PAB,1806,539,1267,476,760,285,285,1806,0,ITH,ITH1,4,Provincia Autonoma Bolzano / Bozen
2021-01-06,PAT,42,13,29,42,0,0,0,42,0,ITH,ITH2,4,Provincia Autonoma Trento
2020-12-30,TOS,325,104,221,34,10,281,0,325,0,ITI,ITI1,9,Toscana
2021-02-08,SAR,1470,533,937,998,345,126,1,855,615,ITG,ITG2,20,Sardegna
2021-01-13,PIE,10040,3214,6826,6457,2256,1327,0,10040,0,ITC,ITC1,1,Piemonte
2021-01-03,EMR,2730,934,1796,2473,87,170,0,2730,0,ITH,ITH5,8,Emilia-Romagna
2021-02-10,FVG,1353,495,858,747,487,119,0,1267,86,ITH,ITH4,6,Friuli-Venezia Giulia
2021-01-30,LIG,1624,548,1076,1208,166,250,0,21,1603,ITC,ITC3,7,Liguria
2021-01-10,EMR,7121,2660,4461,5509,1114,498,0,7121,0,ITH,ITH5,8,Emilia-Romagna
2020-12-27,CAM,720,422,298,703,17,0,0,720,0,ITF,ITF3,15,Campania
2021-01-13,SAR,573,178,395,494,79,0,0,573,0,ITG,ITG2,20,Sardegna
2021-02-08,SIC,4081,1756,2325,2341,1343,397,0,2127,1954,ITG,ITG1,19,Sicilia
2021-01-13,SIC,5203,2462,2741,3033,1729,441,0,5203,0,ITG,ITG1,19,Sicilia
2021-01-15,FVG,2028,606,1422,1283,370,375,0,2028,0,ITH,ITH4,6,Friuli-Venezia Giulia
2020-12-30,LOM,113,42,71,105,8,0,0,113,0,ITC,ITC4,3,Lombardia
2021-01-08,LAZ,7704,2885,4819,6514,392,798,0,7704,0,ITI,ITI4,12,Lazio
2021-01-21,PAB,914,426,488,719,100,68,27,138,776,ITH,ITH1,4,Provincia Autonoma Bolzano / Bozen
2021-01-08,UMB,1172,337,835,926,9,237,0,1172,0,ITI,ITI2,10,Umbria
2021-01-05,VDA,150,54,96,127,12,11,0,150,0,ITC,ITC2,2,Valle d'Aosta / Vallée d'Aoste
2021-01-25,VEN,6465,2074,4391,5059,502,903,1,169,6296,ITH,ITH3,5,Veneto
2021-01-03,CAL,6,3,3,4,2,0,0,6,0,ITF,ITF6,18,Calabria
2021-01-20,LAZ,4354,1647,2707,3250,398,420,286,2842,1512,ITI,ITI4,12,Lazio
2021-01-01,PIE,1038,395,643,922,116,0,0,1038,0,ITC,ITC1,1,Piemonte
2021-02-10,EMR,3696,1293,2403,2211,572,678,235,2677,1019,ITH,ITH5,8,Emilia-Romagna
2021-01-04,LIG,2370,782,1588,2053,226,91,0,2370,0,ITC,ITC3,7,Liguria
2021-01-31,VDA,290,90,200,231,41,18,0,58,232,ITC,ITC2,2,Valle d'Aosta / Vallée d'Aoste
2021-01-07,ABR,1603,552,1051,1566,37,0,0,1603,0,ITF,ITF1,13,Abruzzo
2021-01-09,PAB,600,317,283,75,439,74,12,600,0,ITH,ITH1,4,Provincia Autonoma Bolzano / Bozen
2021-01-13,LOM,25334,7804,17530,11839,9659,3529,307,25334,0,ITC,ITC4,3,Lombardia
2021-01-22,CAM,1522,774,748,970,344,208,0,672,850,ITF,ITF3,15,Campania
2021-01-03,FVG,312,122,190,285,26,1,0,312,0,ITH,ITH4,6,Friuli-Venezia Giulia
2021-01-21,ABR,157,47,110,10,6,141,0,157,0,ITF,ITF1,13,Abruzzo
2021-01-25,PAT,774,205,569,482,30,262,0,23,751,ITH,ITH2,4,Provincia Autonoma Trento
2021-01-29,CAL,2046,984,1062,1751,247,48,0,233,1813,ITF,ITF6,18,Calabria
2020-12-30,VEN,699,245,454,598,62,39,0,699,0,ITH,ITH3,5,Veneto
2021-02-06,TOS,4486,1536,2950,3723,575,188,0,1294,3192,ITI,ITI1,9,Toscana
2021-01-09,PUG,4854,2242,2612,4301,302,247,4,4854,0,ITF,ITF4,16,Puglia
2021-01-19,BAS,199,84,115,79,76,44,0,199,0,ITF,ITF5,17,Basilicata
2021-01-01,SAR,30,16,14,30,0,0,0,30,0,ITG,ITG2,20,Sardegna
2021-01-16,MAR,2006,723,1283,1059,662,285,0,2006,0,ITI,ITI3,11,Marche
2021-02-02,PAB,1720,498,1222,607,499,605,9,7,1713,ITH,ITH1,4,Provincia Autonoma Bolzano / Bozen
2021-02-06,LOM,14420,5319,9101,9131,3476,1743,70,847,13573,ITC,ITC4,3,Lombardia
2021-02-08,LAZ,9330,3867,5463,3785,873,918,3754,4484,4846,ITI,ITI4,12,Lazio
2021-02-03,FVG,2643,789,1854,1699,558,386,0,21,2622,ITH,ITH4,6,Friuli-Venezia Giulia
2021-01-18,LIG,1632,624,1008,1004,409,219,0,1483,149,ITC,ITC3,7,Liguria
2021-02-10,CAL,1637,746,891,974,371,292,0,534,1103,ITF,ITF6,18,Calabria
2021-02-01,PIE,8637,3051,5586,6161,1402,1074,0,577,8060,ITC,ITC1,1,Piemonte
2021-01-22,EMR,1826,476,1350,940,165,721,0,1088,738,ITH,ITH5,8,Emilia-Romagna
2021-01-13,VEN,5974,1599,4375,2790,1302,1879,3,5974,0,ITH,ITH3,5,Veneto
2021-01-15,CAL,2793,1258,1535,1690,691,412,0,2793,0,ITF,ITF6,18,Calabria
2021-01-18,TOS,1119,636,483,430,314,375,0,1021,98,ITI,ITI1,9,Toscana
2021-01-14,MOL,646,239,407,418,113,115,0,646,0,ITF,ITF2,14,Molise
2021-02-09,ABR,908,311,597,612,165,131,0,499,409,ITF,ITF1,13,Abruzzo
2021-01-06,PIE,3114,1110,2004,2368,433,313,0,3114,0,ITC,ITC1,1,Piemonte
2021-02-01,SAR,1521,603,918,891,553,77,0,223,1298,ITG,ITG2,20,Sardegna
2021-01-06,TOS,4516,1459,3057,3981,10,525,0,4516,0,ITI,ITI1,9,Toscana
2021-01-28,PUG,5460,2270,3190,4756,377,327,0,472,4988,ITF,ITF4,16,Puglia
2021-01-20,SIC,807,410,397,421,194,192,0,573,234,ITG,ITG1,19,Sicilia
2021-01-13,PAT,415,123,292,381,16,18,0,415,0,ITH,ITH2,4,Provincia Autonoma Trento
2020-12-27,EMR,968,372,596,811,131,26,0,968,0,ITH,ITH5,8,Emilia-Romagna
2021-01-08,FVG,2322,747,1575,1680,246,396,0,2322,0,ITH,ITH4,6,Friuli-Venezia Giulia
2021-02-03,UMB,725,174,551,560,37,128,0,67,658,ITI,ITI2,10,Umbria
2021-02-09,MOL,311,135,176,160,87,64,0,149,162,ITF,ITF2,14,Molise
2021-01-20,PIE,6370,2033,4337,3560,1152,1658,0,5644,726,ITC,ITC1,1,Piemonte
2021-02-03,CAM,8894,3997,4897,4733,3446,714,1,878,8016,ITF,ITF3,15,Campania
2021-01-06,SAR,1599,544,1055,1494,105,0,0,1599,0,ITG,ITG2,20,Sardegna
2021-01-25,LOM,6842,2307,4535,5374,1278,180,10,475,6367,ITC,ITC4,3,Lombardia
2021-02-01,LOM,15696,5191,10505,11319,3443,891,43,312,15384,ITC,ITC4,3,Lombardia
2021-02-02,MOL,486,155,331,295,63,128,0,163,323,ITF,ITF2,14,Molise
2021-01-28,PAB,867,307,560,584,214,69,0,10,857,ITH,ITH1,4,Provincia Autonoma Bolzano / Bozen
2021-01-22,FVG,90,30,60,89,1,0,0,0,90,ITH,ITH4,6,Friuli-Venezia Giulia
2021-02-01,VEN,8121,2421,5700,4206,1775,1895,245,161,7960,ITH,ITH3,5,Veneto
2020-12-27,CAL,275,150,125,274,1,0,0,275,0,ITF,ITF6,18,Calabria
2021-02-01,PAT,1181,321,860,759,86,336,0,91,1090,ITH,ITH2,4,Provincia Autonoma Trento
2021-01-12,VDA,302,72,230,242,49,11,0,302,0,ITC,ITC2,2,Valle d'Aosta / Vallée d'Aoste
2021-01-10,CAL,929,524,405,830,99,0,0,929,0,ITF,ITF6,18,Calabria
2021-02-06,LIG,1791,731,1060,1231,238,322,0,145,1646,ITC,ITC3,7,Liguria
2021-01-03,CAM,3836,2009,1827,3191,645,0,0,3836,0,ITF,ITF3,15,Campania
2021-01-28,MAR,1972,659,1313,1581,290,101,0,167,1805,ITI,ITI3,11,Marche
2021-01-20,SAR,210,77,133,154,56,0,0,208,2,ITG,ITG2,20,Sardegna
2021-01-01,LAZ,3553,1381,2172,3483,2,68,0,3553,0,ITI,ITI4,12,Lazio
2021-01-15,CAM,4977,2380,2597,2739,2048,190,0,4977,0,ITF,ITF3,15,Campania
2021-01-06,LOM,7041,2485,4556,5262,1741,35,3,7041,0,ITC,ITC4,3,Lombardia
2021-01-22,CAL,656,274,382,298,248,110,0,654,2,ITF,ITF6,18,Calabria
2021-01-06,VEN,8124,2379,5745,6300,1016,807,1,8124,0,ITH,ITH3,5,Veneto
2021-01-16,PUG,2501,1032,1469,1677,310,514,0,2501,0,ITF,ITF4,16,Puglia
2021-01-15,UMB,692,212,480,588,44,60,0,692,0,ITI,ITI2,10,Umbria
2021-01-26,BAS,794,350,444,479,280,35,0,101,693,ITF,ITF5,17,Basilicata
2021-01-11,LIG,2460,909,1551,1866,325,269,0,2460,0,ITC,ITC3,7,Liguria
2021-02-01,SIC,6074,2682,3392,4165,1591,318,0,301,5773,ITG,ITG1,19,Sicilia
2021-01-25,PIE,6208,1938,4270,4781,865,562,0,980,5228,ITC,ITC1,1,Piemonte
2020-12-27,FVG,262,149,113,259,3,0,0,262,0,ITH,ITH4,6,Friuli-Venezia Giulia
2021-01-27,LAZ,5767,2169,3598,4796,385,457,129,651,5116,ITI,ITI4,12,Lazio
2021-01-02,PAB,91,48,43,69,22,0,0,91,0,ITH,ITH1,4,Provincia Autonoma Bolzano / Bozen
2021-01-14,ABR,530,189,341,364,166,0,0,530,0,ITF,ITF1,13,Abruzzo
2021-01-15,EMR,7699,2392,5307,5255,1127,1317,0,7699,0,ITH,ITH5,8,Emilia-Romagna
2021-01-23,PAB,195,115,80,183,12,0,0,0,195,ITH,ITH1,4,Provincia Autonoma Bolzano / Bozen
2021-02-10,SIC,4424,1816,2608,1975,1711,738,0,3999,425,ITG,ITG1,19,Sicilia
2021-01-25,LIG,2572,835,1737,2068,221,283,0,462,2110,ITC,ITC3,7,Liguria
2021-01-27,LOM,7959,2655,5304,6053,1702,202,2,815,7144,ITC,ITC4,3,Lombardia
2021-01-29,LAZ,7413,2804,4609,6202,419,702,90,472,6941,ITI,ITI4,12,Lazio
2021-01-01,CAM,919,506,413,831,88,0,0,919,0,ITF,ITF3,15,Campania
2021-01-08,SAR,3251,1182,2069,2923,328,0,0,3251,0,ITG,ITG2,20,Sardegna
2021-01-07,VDA,275,111,164,224,46,5,0,275,0,ITC,ITC2,2,Valle d'Aosta / Vallée d'Aoste
2021-01-23,MAR,557,190,367,440,54,63,0,123,434,ITI,ITI3,11,Marche
2021-01-03,LAZ,5250,1972,3278,5125,60,65,0,5250,0,ITI,ITI4,12,Lazio
2021-01-04,MOL,314,131,183,301,13,0,0,314,0,ITF,ITF2,14,Molise
2021-01-08,CAL,2109,1014,1095,1898,211,0,0,2109,0,ITF,ITF6,18,Calabria
2021-01-20,VEN,1038,368,670,692,133,213,0,386,652,ITH,ITH3,5,Veneto
2020-12-27,PIE,912,368,544,760,76,76,0,912,0,ITC,ITC1,1,Piemonte
2021-01-15,LAZ,6223,2465,3758,4476,604,988,155,6223,0,ITI,ITI4,12,Lazio
2021-01-01,LOM,24,7,17,21,3,0,0,24,0,ITC,ITC4,3,Lombardia
2021-02-02,VDA,270,70,200,225,43,2,0,2,268,ITC,ITC2,2,Valle d'Aosta / Vallée d'Aoste
2021-01-10,UMB,1056,275,781,740,9,307,0,1056,0,ITI,ITI2,10,Umbria
2021-01-27,CAM,7731,3816,3915,5832,1629,270,0,161,7570,ITF,ITF3,15,Campania
2021-02-08,TOS,4094,1358,2736,3372,345,377,0,3635,459,ITI,ITI1,9,Toscana
2021-01-19,VDA,256,77,179,160,24,15,57,256,0,ITC,ITC2,2,Valle d'Aosta / Vallée d'Aoste
2021-01-20,PAT,288,71,217,224,16,48,0,276,12,ITH,ITH2,4,Provincia Autonoma Trento
2021-01-27,SIC,7523,3831,3692,6322,1049,152,0,188,7335,ITG,ITG1,19,Sicilia
2021-02-03,CAL,2518,1313,1205,2054,361,103,0,577,1941,ITF,ITF6,18,Calabria
2021-01-04,PUG,4502,2012,2490,4346,145,11,0,4502,0,ITF,ITF4,16,Puglia
2021-01-24,BAS,834,299,535,602,231,1,0,58,776,ITF,ITF5,17,Basilicata
2021-01-19,ABR,111,55,56,27,34,50,0,91,20,ITF,ITF1,13,Abruzzo
2020-12-27,SAR,65,34,31,65,0,0,0,65,0,ITG,ITG2,20,Sardegna
2021-02-01,FVG,2252,741,1511,1670,409,173,0,170,2082,ITH,ITH4,6,Friuli-Venezia Giulia
2021-02-03,LAZ,6274,2345,3929,4617,550,1072,35,887,5387,ITI,ITI4,12,Lazio
2021-01-20,TOS,1313,634,679,431,256,626,0,1076,237,ITI,ITI1,9,Toscana
2021-01-04,MAR,1500,563,937,1290,199,11,0,1500,0,ITI,ITI3,11,Marche
2021-01-13,LIG,2634,964,1670,1810,372,452,0,2634,0,ITC,ITC3,7,Liguria
2021-01-27,EMR,8311,2931,5380,6848,812,651,0,459,7852,ITH,ITH5,8,Emilia-Romagna
2021-01-27,PIE,4193,1452,2741,2981,655,557,0,999,3194,ITC,ITC1,1,Piemonte
2021-02-04,PAB,1839,556,1283,623,598,404,214,8,1831,ITH,ITH1,4,Provincia Autonoma Bolzano / Bozen
2021-01-08,VEN,9397,2831,6566,5974,1614,1806,3,9397,0,ITH,ITH3,5,Veneto
2021-01-20,CAL,1395,622,773,864,352,179,0,1394,1,ITF,ITF6,18,Calabria
2021-02-08,LOM,9142,2716,6426,4995,2130,1964,53,1891,7251,ITC,ITC4,3,Lombardia
2021-01-13,CAM,8012,3662,4350,4346,3082,584,0,8012,0,ITF,ITF3,15,Campania
2021-01-18,MAR,673,230,443,370,171,132,0,547,126,ITI,ITI3,11,Marche
2021-02-08,PAT,1146,318,828,543,73,237,293,341,805,ITH,ITH2,4,Provincia Autonoma Trento
2021-01-09,MOL,450,152,298,221,51,178,0,450,0,ITF,ITF2,14,Molise
2020-12-27,SIC,89,54,35,62,2,25,0,89,0,ITG,ITG1,19,Sicilia
2021-01-27,SAR,1392,489,903,1287,105,0,0,79,1313,ITG,ITG2,20,Sardegna
2021-01-22,UMB,276,105,171,273,1,2,0,32,244,ITI,ITI2,10,Umbria
2021-01-08,PAT,1440,312,1128,762,152,526,0,1440,0,ITH,ITH2,4,Provincia Autonoma Trento
2021-01-23,PUG,3022,1284,1738,2514,201,307,0,879,2143,ITF,ITF4,16,Puglia
2021-01-30,MAR,1905,668,1237,1566,339,0,0,29,1876,ITI,ITI3,11,Marche
2021-01-14,VDA,237,69,168,151,84,0,2,237,0,ITC,ITC2,2,Valle d'Aosta / Vallée d'Aoste
2021-02-04,MOL,757,295,462,501,115,141,0,76,681,ITF,ITF2,14,Molise
2021-02-08,VEN,4814,1503,3311,2718,981,1102,13,1875,2939,ITH,ITH3,5,Veneto
2021-01-15,PIE,8958,2951,6007,5492,1925,1541,0,8958,0,ITC,ITC1,1,Piemonte
2021-02-08,CAM,5108,2447,2661,1386,2118,226,1378,4305,803,ITF,ITF3,15,Campania
2021-01-22,SIC,1235,625,610,1035,82,118,0,242,993,ITG,ITG1,19,Sicilia
2021-01-28,MOL,613,217,396,430,29,154,0,17,596,ITF,ITF2,14,Molise
2021-01-27,VEN,7131,2065,5066,5200,1060,871,0,240,6891,ITH,ITH3,5,Veneto
2021-02-03,SIC,6098,2855,3243,3354,2120,624,0,755,5343,ITG,ITG1,19,Sicilia
2021-02-11,PUG,2899,1060,1839,1873,363,663,0,1628,1271,ITF,ITF4,16,Puglia
2021-01-27,PAT,732,257,475,395,34,303,0,72,660,ITH,ITH2,4,Provincia Autonoma Trento
2020-12-30,MAR,17,5,12,14,3,0,0,17,0,ITI,ITI3,11,Marche
2021-01-08,SIC,8328,3864,4464,6591,1524,213,0,8328,0,ITG,ITG1,19,Sicilia
2021-01-20,FVG,750,323,427,719,31,0,0,12,738,ITH,ITH4,6,Friuli-Venezia Giulia
2021-01-05,BAS,945,409,536,709,236,0,0,945,0,ITF,ITF5,17,Basilicata
2021-01-15,SAR,1563,573,990,1170,393,0,0,1563,0,ITG,ITG2,20,Sardegna
2021-01-08,CAM,10454,4969,5485,6713,3529,212,0,10454,0,ITF,ITF3,15,Campania
2021-02-01,LIG,2317,841,1476,1795,210,312,0,68,2249,ITC,ITC3,7,Liguria
2021-01-16,PAB,2748,1229,1519,450,360,77,1861,2748,0,ITH,ITH1,4,Provincia Autonoma Bolzano / Bozen
2021-02-08,EMR,5082,1498,3584,2750,743,1453,136,2248,2834,ITH,ITH5,8,Emilia-Romagna
2020-12-31,VDA,18,4,14,16,2,0,0,18,0,ITC,ITC2,2,Valle d'Aosta / Vallée d'Aoste
2021-01-03,UMB,267,111,156,267,0,0,0,267,0,ITI,ITI2,10,Umbria
2020-12-27,LAZ,139,66,73,139,0,0,0,139,0,ITI,ITI4,12,Lazio
2021-01-20,CAM,1257,650,607,395,761,101,0,1257,0,ITF,ITF3,15,Campania
2021-01-27,CAL,1456,733,723,1225,208,23,0,396,1060,ITF,ITF6,18,Calabria
2021-01-01,VEN,1525,470,1055,1494,30,1,0,1525,0,ITH,ITH3,5,Veneto
2021-01-26,VDA,139,48,91,115,12,12,0,0,139,ITC,ITC2,2,Valle d'Aosta / Vallée d'Aoste
2021-01-08,LOM,12587,3893,8694,8633,3704,218,32,12587,0,ITC,ITC4,3,Lombardia
2021-01-12,ABR,1804,666,1138,1470,334,0,0,1804,0,ITF,ITF1,13,Abruzzo
2021-01-11,PUG,3741,1581,2160,3203,363,175,0,3741,0,ITF,ITF4,16,Puglia
2021-01-04,PAB,469,191,278,397,72,0,0,469,0,ITH,ITH1,4,Provincia Autonoma Bolzano / Bozen
2021-01-26,ABR,1542,567,975,1513,29,0,0,29,1513,ITF,ITF1,13,Abruzzo
2021-01-31,BAS,77,24,53,75,2,0,0,0,77,ITF,ITF5,17,Basilicata
2021-01-06,LIG,1627,600,1027,1196,254,113,64,1627,0,ITC,ITC3,7,Liguria
2021-02-01,TOS,5465,1942,3523,4441,407,617,0,521,4944,ITI,ITI1,9,Toscana
2021-02-11,MAR,1987,657,1330,1155,620,212,0,1598,389,ITI,ITI3,11,Marche
2021-01-22,LAZ,3661,1442,2219,3379,90,70,122,147,3514,ITI,ITI4,12,Lazio
2021-01-20,EMR,1320,269,1051,410,143,767,0,1319,1,ITH,ITH5,8,Emilia-Romagna
2021-01-11,MAR,1176,411,765,1021,155,0,0,1176,0,ITI,ITI3,11,Marche
2021-02-10,LAZ,7765,3111,4654,2645,580,628,3912,4836,2929,ITI,ITI4,12,Lazio
2021-02-08,FVG,2352,692,1660,1397,521,434,0,91,2261,ITH,ITH4,6,Friuli-Venezia Giulia
2021-02-10,UMB,715,349,366,605,107,3,0,700,15,ITI,ITI2,10,Umbria
2021-01-16,MOL,420,166,254,270,23,127,0,420,0,ITF,ITF2,14,Molise
2021-01-30,PUG,5311,2419,2892,4571,321,416,3,360,4951,ITF,ITF4,16,Puglia
2021-01-03,SIC,4692,2454,2238,4360,332,0,0,4692,0,ITG,ITG1,19,Sicilia
2021-02-03,PIE,10145,3292,6853,6613,2299,1233,0,609,9536,ITC,ITC1,1,Piemonte
2021-01-13,TOS,4062,1398,2664,3308,349,405,0,4062,0,ITI,ITI1,9,Toscana
2021-02-03,EMR,9259,2969,6290,6130,1455,1609,65,945,8314,ITH,ITH5,8,Emilia-Romagna
2021-01-01,TOS,2368,786,1582,1716,2,650,0,2368,0,ITI,ITI1,9,Toscana
2021-01-10,LAZ,4036,1700,2336,3421,363,252,0,4036,0,ITI,ITI4,12,Lazio
2021-01-15,SIC,5078,2233,2845,2824,1775,479,0,5078,0,ITG,ITG1,19,Sicilia
2021-02-07,VDA,292,120,172,110,77,0,105,190,102,ITC,ITC2,2,Valle d'Aosta / Vallée d'Aoste
2021-01-01,PAT,206,48,158,109,11,86,0,206,0,ITH,ITH2,4,Provincia Autonoma Trento
2021-02-11,MOL,293,133,160,225,23,45,0,257,36,ITF,ITF2,14,Molise
2021-01-12,BAS,216,87,129,39,79,98,0,216,0,ITF,ITF5,17,Basilicata
2021-01-13,FVG,2651,834,1817,1822,599,230,0,2651,0,ITH,ITH4,6,Friuli-Venezia Giulia
2021-02-01,CAM,3985,1813,2172,2504,1329,152,0,110,3875,ITF,ITF3,15,Campania
2021-02-03,SAR,1117,417,700,918,180,19,0,425,692,ITG,ITG2,20,Sardegna
2021-01-31,ABR,1502,488,1014,1154,245,103,0,287,1215,ITF,ITF1,13,Abruzzo
2021-01-08,EMR,10804,3554,7250,8338,1389,1077,0,10804,0,ITH,ITH5,8,Emilia-Romagna
2021-01-08,PIE,5526,1759,3767,4076,1029,421,0,5526,0,ITC,ITC1,1,Piemonte
2021-01-29,UMB,1220,343,877,934,16,270,0,79,1141,ITI,ITI2,10,Umbria
2021-02-08,CAL,1641,650,991,1040,480,121,0,459,1182,ITF,ITF6,18,Calabria
2021-02-11,PAB,1016,398,618,208,362,104,342,235,781,ITH,ITH1,4,Provincia Autonoma Bolzano / Bozen
2021-01-20,LOM,5307,1312,3995,1939,2171,1107,90,5193,114,ITC,ITC4,3,Lombardia
2021-02-06,MAR,2431,889,1542,1396,639,396,0,521,1910,ITI,ITI3,11,Marche
2021-01-06,MAR,2181,792,1389,1738,296,147,0,2181,0,ITI,ITI3,11,Marche
2021-01-18,MOL,114,48,66,97,17,0,0,114,0,ITF,ITF2,14,Molise
2021-01-24,FVG,305,119,186,277,27,1,0,1,304,ITH,ITH4,6,Friuli-Venezia Giulia
2021-02-05,UMB,780,234,546,645,51,84,0,18,762,ITI,ITI2,10,Umbria
2021-02-01,PUG,3944,1649,2295,3428,308,208,0,374,3570,ITF,ITF4,16,Puglia
2021-01-31,CAL,1107,554,553,764,285,58,0,155,952,ITF,ITF6,18,Calabria
2021-01-12,EMR,9301,3083,6218,6301,1376,1624,0,9301,0,ITH,ITH5,8,Emilia-Romagna
2021-01-08,LIG,2685,927,1758,1911,429,345,0,2685,0,ITC,ITC3,7,Liguria
2021-01-22,PIE,3814,1232,2582,2271,649,894,0,2470,1344,ITC,ITC1,1,Piemonte
2021-01-03,VEN,5157,1563,3594,4596,312,249,0,5157,0,ITH,ITH3,5,Veneto
2021-02-07,CAM,2934,1385,1549,710,1708,226,290,2156,778,ITF,ITF3,15,Campania
2020-12-29,SIC,235,146,89,235,0,0,0,235,0,ITG,ITG1,19,Sicilia
2021-01-08,TOS,5944,1641,4303,5360,39,545,0,5944,0,ITI,ITI1,9,Toscana
2021-01-06,PAB,59,18,41,59,0,0,0,59,0,ITH,ITH1,4,Provincia Autonoma Bolzano / Bozen
2021-02-03,PAT,840,311,529,309,87,71,373,414,426,ITH,ITH2,4,Provincia Autonoma Trento
2021-02-04,BAS,1089,438,651,551,259,279,0,63,1026,ITF,ITF5,17,Basilicata
2021-02-10,LOM,12805,4140,8665,7699,2533,2480,93,6900,5905,ITC,ITC4,3,Lombardia
2021-01-30,ABR,1509,566,943,1348,114,47,0,69,1440,ITF,ITF1,13,Abruzzo
2021-02-07,FVG,1558,483,1075,863,693,2,0,384,1174,ITH,ITH4,6,Friuli-Venezia Giulia
2020-12-27,TOS,619,267,352,460,146,13,0,619,0,ITI,ITI1,9,Toscana
2021-01-22,SAR,82,46,36,45,37,0,0,54,28,ITG,ITG2,20,Sardegna
2021-02-05,PIE,9423,3068,6355,5757,2043,1623,0,634,8789,ITC,ITC1,1,Piemonte
2021-01-26,EMR,8324,3000,5324,6593,699,1032,0,218,8106,ITH,ITH5,8,Emilia-Romagna
2021-01-10,SIC,3618,1615,2003,2126,1028,464,0,3618,0,ITG,ITG1,19,Sicilia
2021-01-18,PUG,1844,770,1074,1181,217,446,0,1495,349,ITF,ITF4,16,Puglia
2021-01-03,PAT,483,158,325,409,12,62,0,483,0,ITH,ITH2,4,Provincia Autonoma Trento
2021-02-08,LIG,1647,663,984,1119,379,149,0,281,1366,ITC,ITC3,7,Liguria
2021-02-11,ABR,816,262,554,473,189,154,0,773,43,ITF,ITF1,13,Abruzzo
2021-01-24,UMB,254,104,150,254,0,0,0,1,253,ITI,ITI2,10,Umbria
2021-02-03,VEN,5923,1657,4266,2847,1339,1736,1,475,5448,ITH,ITH3,5,Veneto
2021-01-30,MOL,458,158,300,189,90,179,0,10,448,ITF,ITF2,14,Molise
2021-01-10,PIE,5207,2273,2934,3904,784,519,0,5207,0,ITC,ITC1,1,Piemonte
2021-01-24,CAM,4128,2123,2005,3140,822,166,0,383,3745,ITF,ITF3,15,Campania
2021-02-05,SAR,1897,749,1148,1214,518,164,1,433,1464,ITG,ITG2,20,Sardegna
2021-02-06,PAB,2276,1018,1258,435,371,0,1470,18,2258,ITH,ITH1,4,Provincia Autonoma Bolzano / Bozen
2020-12-27,LIG,132,54,78,85,2,45,0,132,0,ITC,ITC3,7,Liguria
2021-01-15,LOM,24279,7151,17128,10160,9909,3805,405,24279,0,ITC,ITC4,3,Lombardia
2021-01-22,TOS,2858,1062,1796,2021,81,756,0,522,2336,ITI,ITI1,9,Toscana
2021-02-01,MAR,1360,479,881,1053,226,81,0,98,1262,ITI,ITI3,11,Marche
2021-01-04,BAS,607,271,336,527,80,0,0,607,0,ITF,ITF5,17,Basilicata
2021-02-05,SIC,7098,3155,3943,3527,2719,852,0,2125,4973,ITG,ITG1,19,Sicilia
2021-01-18,PAB,1554,579,975,291,275,7,981,1549,5,ITH,ITH1,4,Provincia Autonoma Bolzano / Bozen
2021-01-22,LOM,2792,791,2001,1005,1659,122,6,2740,52,ITC,ITC4,3,Lombardia
2021-01-18,ABR,122,48,74,106,14,2,0,46,76,ITF,ITF1,13,Abruzzo
2021-01-12,FVG,2256,712,1544,1522,373,361,0,2256,0,ITH,ITH4,6,Friuli-Venezia Giulia
2021-01-22,VEN,1081,332,749,946,77,58,0,27,1054,ITH,ITH3,5,Veneto
2021-01-31,UMB,1056,276,780,765,10,281,0,25,1031,ITI,ITI2,10,Umbria
2021-01-22,PAT,1621,419,1202,872,128,621,0,313,1308,ITH,ITH2,4,Provincia Autonoma Trento
2021-01-07,EMR,10204,3381,6823,8166,971,1067,0,10204,0,ITH,ITH5,8,Emilia-Romagna
2021-02-06,PUG,3983,1677,2306,3017,488,478,0,1148,2835,ITF,ITF4,16,Puglia
2021-01-26,CAL,1803,859,944,1569,164,70,0,283,1520,ITF,ITF6,18,Calabria
2021-01-02,VDA,6,5,1,0,0,6,0,6,0,ITC,ITC2,2,Valle d'Aosta / Vallée d'Aoste
2021-01-27,LIG,1613,576,1037,1264,174,175,0,180,1433,ITC,ITC3,7,Liguria
2021-01-03,TOS,3336,1052,2284,2565,9,762,0,3336,0,ITI,ITI1,9,Toscana
2021-01-10,SAR,2183,750,1433,1632,551,0,0,2183,0,ITG,ITG2,20,Sardegna
2021-01-05,CAM,7240,3641,3599,5813,1321,106,0,7240,0,ITF,ITF3,15,Campania
2021-02-10,PIE,7188,2286,4902,3795,1485,1908,0,1308,5880,ITC,ITC1,1,Piemonte
2021-01-12,CAL,2058,1017,1041,1706,323,29,0,2058,0,ITF,ITF6,18,Calabria
2020-12-27,VEN,880,395,485,875,5,0,0,880,0,ITH,ITH3,5,Veneto
2020-12-27,LOM,701,407,294,550,137,13,1,701,0,ITC,ITC4,3,Lombardia
2021-01-06,PUG,3944,1665,2279,3183,387,374,0,3944,0,ITF,ITF4,16,Puglia
2021-01-28,VDA,290,123,167,194,88,6,2,56,234,ITC,ITC2,2,Valle d'Aosta / Vallée d'Aoste
2021-01-05,UMB,850,428,422,845,5,0,0,850,0,ITI,ITI2,10,Umbria
2021-02-11,BAS,507,224,283,163,151,3,190,506,1,ITF,ITF5,17,Basilicata
2021-02-03,TOS,4220,1453,2767,3475,240,505,0,240,3980,ITI,ITI1,9,Toscana
2021-02-07,EMR,4728,1523,3205,3635,694,389,10,1726,3002,ITH,ITH5,8,Emilia-Romagna
2021-01-16,BAS,721,304,417,265,295,161,0,721,0,ITF,ITF5,17,Basilicata
2021-01-19,CAM,1095,474,621,534,390,171,0,1092,3,ITF,ITF3,15,Campania
2021-02-10,SAR,1948,763,1185,1159,301,488,0,1429,519,ITG,ITG2,20,Sardegna
2021-01-01,LIG,144,55,89,139,5,0,0,144,0,ITC,ITC3,7,Liguria
2021-01-10,LOM,10510,3955,6555,6864,3621,8,17,10510,0,ITC,ITC4,3,Lombardia
2021-01-17,LAZ,4443,1784,2659,3120,335,177,811,4337,106,ITI,ITI4,12,Lazio
2021-01-04,ABR,1401,575,826,1396,5,0,0,1401,0,ITF,ITF1,13,Abruzzo
2021-01-15,LIG,2164,727,1437,1226,426,512,0,2164,0,ITC,ITC3,7,Liguria
2021-02-07,CAL,858,427,431,565,212,81,0,146,712,ITF,ITF6,18,Calabria
2021-02-05,LAZ,6905,2721,4184,5092,630,994,189,1128,5777,ITI,ITI4,12,Lazio
2021-01-31,CAM,8066,3710,4356,5106,2893,67,0,24,8042,ITF,ITF3,15,Campania
2021-01-23,ABR,263,114,149,223,14,26,0,57,206,ITF,ITF1,13,Abruzzo
2021-01-15,TOS,3878,1347,2531,2758,676,444,0,3878,0,ITI,ITI1,9,Toscana
2020-12-29,SAR,56,31,25,55,1,0,0,56,0,ITG,ITG2,20,Sardegna
2021-01-11,MOL,557,194,363,196,250,111,0,557,0,ITF,ITF2,14,Molise
2021-01-30,PAB,422,212,210,146,175,101,0,4,418,ITH,ITH1,4,Provincia Autonoma Bolzano / Bozen
2021-01-29,PIE,5844,1850,3994,4115,1057,672,0,453,5391,ITC,ITC1,1,Piemonte
2021-01-25,PUG,3816,1675,2141,3468,180,168,0,421,3395,ITF,ITF4,16,Puglia
2021-01-13,MAR,2105,746,1359,1408,621,76,0,2105,0,ITI,ITI3,11,Marche
2021-02-10,PAT,826,282,544,273,138,50,365,489,337,ITH,ITH2,4,Provincia Autonoma Trento
2021-02-03,LOM,24392,7601,16791,14748,5748,3758,138,840,23552,ITC,ITC4,3,Lombardia
2021-01-19,EMR,2036,500,1536,747,135,1154,0,2019,17,ITH,ITH5,8,Emilia-Romagna
2021-01-10,VEN,5019,1661,3358,3838,717,462,2,5019,0,ITH,ITH3,5,Veneto
2021-02-09,VDA,236,81,155,77,84,0,75,53,183,ITC,ITC2,2,Valle d'Aosta / Vallée d'Aoste
2020-12-31,CAM,1490,811,679,1273,216,1,0,1490,0,ITF,ITF3,15,Campania
2021-02-10,VEN,4494,1527,2967,2919,1048,522,5,3572,922,ITH,ITH3,5,Veneto
2021-01-05,LAZ,7370,2802,4568,6690,103,577,0,7370,0,ITI,ITI4,12,Lazio
2021-01-17,UMB,54,17,37,47,7,0,0,54,0,ITI,ITI2,10,Umbria
2021-01-07,CAL,2179,1061,1118,1882,297,0,0,2179,0,ITF,ITF6,18,Calabria
2020-12-27,PAT,103,40,63,76,6,21,0,103,0,ITH,ITH2,4,Provincia Autonoma Trento
2021-01-25,MAR,1595,558,1037,1425,114,56,0,97,1498,ITI,ITI3,11,Marche
2021-02-06,MOL,428,178,250,275,23,130,0,28,400,ITF,ITF2,14,Molise
2021-01-29,SAR,2943,1065,1878,2572,368,3,0,48,2895,ITG,ITG2,20,Sardegna
2021-01-10,PAT,84,19,65,53,19,12,0,84,0,ITH,ITH2,4,Provincia Autonoma Trento
2021-01-09,VDA,443,199,244,225,196,22,0,443,0,ITC,ITC2,2,Valle d'Aosta / Vallée d'Aoste
2021-01-03,PIE,3061,966,2095,2714,295,52,0,3061,0,ITC,ITC1,1,Piemonte
2021-01-17,SIC,1295,584,711,619,516,160,0,1245,50,ITG,ITG1,19,Sicilia
2021-01-31,FVG,2712,836,1876,1692,1002,18,0,385,2327,ITH,ITH4,6,Friuli-Venezia Giulia
2020-12-31,EMR,2202,775,1427,1662,214,326,0,2202,0,ITH,ITH5,8,Emilia-Romagna
2021-01-20,LIG,1184,449,735,535,330,319,0,1173,11,ITC,ITC3,7,Liguria
2021-01-23,BAS,705,298,407,480,224,1,0,33,672,ITF,ITF5,17,Basilicata
2021-01-24,LAZ,5467,2109,3358,4945,262,134,126,385,5082,ITI,ITI4,12,Lazio
2021-01-03,SAR,90,36,54,89,1,0,0,90,0,ITG,ITG2,20,Sardegna
2021-01-17,PIE,3517,1168,2349,2082,595,840,0,2869,648,ITC,ITC1,1,Piemonte
2021-01-29,SIC,9354,4317,5037,7145,1904,305,0,431,8923,ITG,ITG1,19,Sicilia
2021-01-25,PAB,461,176,285,379,81,0,1,3,458,ITH,ITH1,4,Provincia Autonoma Bolzano / Bozen
2021-01-05,FVG,1679,550,1129,1349,133,197,0,1679,0,ITH,ITH4,6,Friuli-Venezia Giulia
2021-01-11,PAB,1501,476,1025,532,645,174,150,1501,0,ITH,ITH1,4,Provincia Autonoma Bolzano / Bozen
2020-12-29,LAZ,418,150,268,418,0,0,0,418,0,ITI,ITI4,12,Lazio
2021-01-29,LOM,13224,4063,9161,10286,2373,556,9,592,12632,ITC,ITC4,3,Lombardia
2021-01-29,PAT,1349,331,1018,711,97,541,0,54,1295,ITH,ITH2,4,Provincia Autonoma Trento
2021-01-15,VEN,5864,1816,4048,2988,1376,1491,9,5864,0,ITH,ITH3,5,Veneto
2021-01-12,UMB,784,247,537,665,14,105,0,784,0,ITI,ITI2,10,Umbria
2021-01-17,SAR,860,277,583,747,113,0,0,859,1,ITG,ITG2,20,Sardegna
2021-02-10,TOS,4248,1277,2971,3527,242,479,0,3732,516,ITI,ITI1,9,Toscana
2021-01-13,PUG,4523,1721,2802,3956,337,230,0,4523,0,ITF,ITF4,16,Puglia
2021-01-31,EMR,7692,2758,4934,6164,1267,261,0,242,7450,ITH,ITH5,8,Emilia-Romagna
2021-01-21,VDA,33,12,21,0,0,33,0,33,0,ITC,ITC2,2,Valle d'Aosta / Vallée d'Aoste
2021-02-03,LIG,2051,718,1333,1478,275,298,0,149,1902,ITC,ITC3,7,Liguria
2021-01-03,LOM,852,316,536,710,137,4,1,852,0,ITC,ITC4,3,Lombardia
2020-12-30,PAB,362,168,194,321,41,0,0,362,0,ITH,ITH1,4,Provincia Autonoma Bolzano / Bozen
2021-01-12,CAM,5214,2563,2651,3439,1435,340,0,5214,0,ITF,ITF3,15,Campania
2021-02-06,ABR,1611,742,869,1168,371,72,0,602,1009,ITF,ITF1,13,Abruzzo
2021-01-11,ABR,1551,557,994,1337,166,48,0,1551,0,ITF,ITF1,13,Abruzzo
2021-01-15,PAT,572,124,448,448,32,92,0,572,0,ITH,ITH2,4,Provincia Autonoma Trento
2021-01-29,VEN,8983,2778,6205,6021,1528,1431,3,363,8620,ITH,ITH3,5,Veneto
2021-01-19,CAL,1108,488,620,852,180,76,0,1098,10,ITF,ITF6,18,Calabria
2021-01-27,TOS,4799,1552,3247,4001,74,724,0,196,4603,ITI,ITI1,9,Toscana
2020-12-30,PUG,1,0,1,1,0,0,0,1,0,ITF,ITF4,16,Puglia
2021-01-17,VEN,1931,780,1151,1583,225,120,3,1582,349,ITH,ITH3,5,Veneto
2021-01-24,SIC,4304,2250,2054,3960,341,3,0,147,4157,ITG,ITG1,19,Sicilia
2021-01-20,PAB,608,247,361,282,76,0,250,401,207,ITH,ITH1,4,Provincia Autonoma Bolzano / Bozen
2021-01-17,PAT,251,195,56,248,3,0,0,251,0,ITH,ITH2,4,Provincia Autonoma Trento
2021-01-05,CAL,1350,618,732,1256,94,0,0,1350,0,ITF,ITF6,18,Calabria
2021-01-10,FVG,2940,919,2021,1745,950,245,0,2940,0,ITH,ITH4,6,Friuli-Venezia Giulia
2021-01-22,LIG,1623,545,1078,862,269,492,0,1150,473,ITC,ITC3,7,Liguria
2021-02-07,SIC,2226,927,1299,1490,581,155,0,671,1555,ITG,ITG1,19,Sicilia
2021-01-05,SAR,1327,446,881,1283,44,0,0,1327,0,ITG,ITG2,20,Sardegna
2021-01-24,LOM,1170,452,718,791,354,24,1,508,662,ITC,ITC4,3,Lombardia
2021-01-07,UMB,1291,383,908,883,4,404,0,1291,0,ITI,ITI2,10,Umbria
2021-01-10,CAM,8166,3739,4427,5180,2889,97,0,8166,0,ITF,ITF3,15,Campania
2021-02-05,TOS,5742,2242,3500,4117,1183,442,0,1921,3821,ITI,ITI1,9,Toscana
2021-01-17,CAL,867,418,449,527,292,48,0,801,66,ITF,ITF6,18,Calabria
2021-01-16,VDA,236,80,156,127,36,22,51,236,0,ITC,ITC2,2,Valle d'Aosta / Vallée d'Aoste
2021-01-01,PUG,146,60,86,145,1,0,0,146,0,ITF,ITF4,16,Puglia
2021-01-15,MAR,1771,500,1271,985,420,366,0,1771,0,ITI,ITI3,11,Marche
2020-12-29,LOM,100,43,57,100,0,0,0,100,0,ITC,ITC4,3,Lombardia
2021-01-16,ABR,927,428,499,710,202,15,0,927,0,ITF,ITF1,13,Abruzzo
2021-01-21,BAS,30,10,20,0,30,0,0,30,0,ITF,ITF5,17,Basilicata
2021-01-12,LAZ,5391,1974,3417,4343,464,584,0,5391,0,ITI,ITI4,12,Lazio
2021-01-10,LIG,572,239,333,304,126,142,0,572,0,ITC,ITC3,7,Liguria
2021-02-11,VDA,231,107,124,53,51,0,127,222,9,ITC,ITC2,2,Valle d'Aosta / Vallée d'Aoste
2021-01-31,LAZ,4279,1783,2496,3572,339,244,124,296,3983,ITI,ITI4,12,Lazio
2021-02-05,CAM,7254,3460,3794,3444,3497,304,9,2129,5125,ITF,ITF3,15,Campania
2021-02-02,BAS,363,141,222,132,130,101,0,175,188,ITF,ITF5,17,Basilicata
2021-01-29,FVG,2411,813,1598,1855,321,235,0,262,2149,ITH,ITH4,6,Friuli-Venezia Giulia
2021-01-19,SIC,1270,521,749,520,512,238,0,1092,178,ITG,ITG1,19,Sicilia
2021-01-06,MOL,689,260,429,456,62,171,0,689,0,ITF,ITF2,14,Molise
2021-01-20,PUG,1551,544,1007,785,165,601,0,1543,8,ITF,ITF4,16,Puglia
2021-01-24,PIE,3148,956,2192,2630,372,146,0,432,2716,ITC,ITC1,1,Piemonte
2021-02-05,PAT,764,258,506,463,27,47,227,265,499,ITH,ITH2,4,Provincia Autonoma Trento
2021-01-01,PAB,1,1,0,1,0,0,0,1,0,ITH,ITH1,4,Provincia Autonoma Bolzano / Bozen
2021-02-04,ABR,1680,615,1065,1168,455,57,0,609,1071,ITF,ITF1,13,Abruzzo
2021-02-05,LOM,23618,6935,16683,13323,6216,3825,254,1847,21771,ITC,ITC4,3,Lombardia
2021-01-24,EMR,2441,882,1559,2071,120,250,0,300,2141,ITH,ITH5,8,Emilia-Romagna
2021-01-05,VEN,7328,2182,5146,5410,795,1123,0,7328,0,ITH,ITH3,5,Veneto
2021-02-05,VEN,8259,2517,5742,4152,2035,2067,5,1415,6844,ITH,ITH3,5,Veneto
2020-12-31,LAZ,5218,2095,3123,4927,12,279,0,5218,0,ITI,ITI4,12,Lazio
2021-01-05,SIC,10526,5159,5367,9073,1246,207,0,10526,0,ITG,ITG1,19,Sicilia
2021-02-01,MOL,562,201,361,301,150,111,0,14,548,ITF,ITF2,14,Molise
2021-01-02,BAS,948,379,569,848,100,0,0,948,0,ITF,ITF5,17,Basilicata
2021-01-24,SAR,90,34,56,89,1,0,0,5,85,ITG,ITG2,20,Sardegna
2021-01-05,PAT,706,231,475,494,52,160,0,706,0,ITH,ITH2,4,Provincia Autonoma Trento
2021-01-19,UMB,103,23,80,21,2,80,0,103,0,ITI,ITI2,10,Umbria
2021-02-01,PAB,1375,400,975,703,378,294,0,10,1365,ITH,ITH1,4,Provincia Autonoma Bolzano / Bozen
2021-02-10,LIG,1841,709,1132,1112,407,322,0,825,1016,ITC,ITC3,7,Liguria
2021-01-27,MAR,2117,780,1337,1751,226,140,0,122,1995,ITI,ITI3,11,Marche
2021-01-17,TOS,2485,836,1649,2002,293,190,0,1972,513,ITI,ITI1,9,Toscana
2021-01-31,SIC,4108,1958,2150,2599,1215,294,0,112,3996,ITG,ITG1,19,Sicilia
2021-01-05,EMR,9327,3164,6163,7866,696,765,0,9327,0,ITH,ITH5,8,Emilia-Romagna
2021-01-17,LOM,8042,3258,4784,5099,2776,122,45,7844,198,ITC,ITC4,3,Lombardia
2021-01-13,PAB,1316,409,907,367,588,255,106,1316,0,ITH,ITH1,4,Provincia Autonoma Bolzano / Bozen
2021-01-28,BAS,903,401,502,434,391,78,0,119,784,ITF,ITF5,17,Basilicata
2021-01-17,FVG,1720,524,1196,674,560,486,0,1720,0,ITH,ITH4,6,Friuli-Venezia Giulia
2021-01-19,LAZ,4360,1671,2689,2967,561,424,408,3907,453,ITI,ITI4,12,Lazio
2021-01-26,UMB,814,390,424,813,1,0,0,18,796,ITI,ITI2,10,Umbria
2021-01-12,PIE,9988,3387,6601,6820,1996,1172,0,9988,0,ITC,ITC1,1,Piemonte
2021-01-24,PAT,545,274,271,533,12,0,0,222,323,ITH,ITH2,4,Provincia Autonoma Trento
2021-01-12,SAR,865,408,457,504,361,0,0,865,0,ITG,ITG2,20,Sardegna
2021-01-08,PUG,5566,2335,3231,4766,475,325,0,5566,0,ITF,ITF4,16,Puglia
2021-02-05,EMR,9181,2923,6258,6136,1359,1537,149,1598,7583,ITH,ITH5,8,Emilia-Romagna
2021-01-29,LIG,2736,959,1777,2093,326,317,0,38,2698,ITC,ITC3,7,Liguria
2020-12-31,UMB,322,127,195,310,12,0,0,322,0,ITI,ITI2,10,Umbria
2021-01-17,CAM,1155,551,604,718,286,151,0,702,453,ITF,ITF3,15,Campania
2021-01-29,TOS,6133,1698,4435,5374,139,620,0,300,5833,ITI,ITI1,9,Toscana
2021-02-08,MAR,833,258,575,408,163,262,0,371,462,ITI,ITI3,11,Marche
2021-01-24,VEN,4116,1219,2897,3750,143,222,1,28,4088,ITH,ITH3,5,Veneto
2021-01-20,MOL,18,8,10,14,4,0,0,18,0,ITF,ITF2,14,Molise
2021-01-24,CAL,44,18,26,15,3,26,0,39,5,ITF,ITF6,18,Calabria
2021-01-09,ABR,1483,565,918,1430,53,0,0,1483,0,ITF,ITF1,13,Abruzzo
2021-01-05,LOM,7671,2513,5158,5710,1786,167,8,7671,0,ITC,ITC4,3,Lombardia
2021-01-14,BAS,969,413,556,402,244,323,0,969,0,ITF,ITF5,17,Basilicata
2021-01-13,MOL,474,160,314,256,74,144,0,474,0,ITF,ITF2,14,Molise
2021-01-28,ABR,1432,494,938,1369,62,1,0,12,1420,ITF,ITF1,13,Abruzzo
2021-01-10,TOS,2998,1102,1896,2432,138,428,0,2998,0,ITI,ITI1,9,Toscana
2021-01-27,PUG,4559,1924,2635,3901,262,396,0,600,3959,ITF,ITF4,16,Puglia
2021-02-05,CAL,2009,895,1114,1205,434,370,0,337,1672,ITF,ITF6,18,Calabria
2021-01-03,LIG,727,226,501,651,76,0,0,727,0,ITC,ITC3,7,Liguria
2021-01-17,EMR,2889,887,2002,1918,432,539,0,2643,246,ITH,ITH5,8,Emilia-Romagna
2021-02-07,LAZ,4667,1865,2802,3251,385,218,813,381,4286,ITI,ITI4,12,Lazio
2021-01-08,MAR,1574,588,986,1226,348,0,0,1574,0,ITI,ITI3,11,Marche
2021-02-09,BAS,488,212,276,199,235,54,0,314,174,ITF,ITF5,17,Basilicata
2021-02-08,MOL,334,141,193,206,43,85,0,216,118,ITF,ITF2,14,Molise
2021-02-04,VDA,293,85,208,167,91,34,1,7,286,ITC,ITC2,2,Valle d'Aosta / Vallée d'Aoste
2021-02-07,UMB,54,17,37,46,8,0,0,1,53,ITI,ITI2,10,Umbria
2021-01-31,PIE,4105,1748,2357,3076,654,375,0,112,3993,ITC,ITC1,1,Piemonte
2021-02-08,PAB,1,1,0,0,1,0,0,1,0,ITH,ITH1,4,Provincia Autonoma Bolzano / Bozen
2021-01-20,MAR,398,99,299,146,62,190,0,386,12,ITI,ITI3,11,Marche
2021-02-03,MAR,2124,741,1383,1344,614,166,0,119,2005,ITI,ITI3,11,Marche
2021-01-04,VDA,142,59,83,126,16,0,0,142,0,ITC,ITC2,2,Valle d'Aosta / Vallée d'Aoste
2021-01-25,MOL,319,130,189,317,2,0,0,3,316,ITF,ITF2,14,Molise
2021-01-29,CAM,10049,4811,5238,6403,3387,259,0,47,10002,ITF,ITF3,15,Campania
2021-02-08,PUG,3828,1545,2283,2833,607,388,0,1471,2357,ITF,ITF4,16,Puglia
2021-01-31,SAR,2121,750,1371,1544,576,0,1,48,2073,ITG,ITG2,20,Sardegna
2021-01-12,SIC,4542,2234,2308,2863,1484,195,0,4542,0,ITG,ITG1,19,Sicilia
2021-01-05,PIE,5376,1602,3774,4362,729,285,0,5376,0,ITC,ITC1,1,Piemonte
2021-02-05,FVG,2613,784,1829,1613,510,490,0,90,2523,ITH,ITH4,6,Friuli-Venezia Giulia
2021-01-09,BAS,559,161,398,281,211,67,0,559,0,ITF,ITF5,17,Basilicata
2021-01-28,CAL,2232,1107,1125,1920,312,0,0,84,2148,ITF,ITF6,18,Calabria
2021-01-05,LIG,2753,860,1893,2216,306,231,0,2753,0,ITC,ITC3,7,Liguria
2021-01-26,LAZ,7601,2906,4695,6589,256,631,125,371,7230,ITI,ITI4,12,Lazio
2021-01-21,CAM,2091,1114,977,1378,638,75,0,676,1415,ITF,ITF3,15,Campania
2021-01-05,TOS,5244,1755,3489,4354,11,879,0,5244,0,ITI,ITI1,9,Toscana
2021-01-15,PUG,4506,1843,2663,3549,399,558,0,4506,0,ITF,ITF4,16,Puglia
2021-01-19,PIE,6308,2075,4233,3571,1291,1446,0,6295,13,ITC,ITC1,1,Piemonte
2021-01-03,MAR,896,348,548,759,137,0,0,896,0,ITI,ITI3,11,Marche
2021-01-31,PAT,74,15,59,55,13,6,0,0,74,ITH,ITH2,4,Provincia Autonoma Trento
2021-01-09,EMR,9872,3425,6447,7641,1332,899,0,9872,0,ITH,ITH5,8,Emilia-Romagna
2020-12-31,VEN,3219,1044,2175,2699,268,252,0,3219,0,ITH,ITH3,5,Veneto
2021-02-02,UMB,942,274,668,713,17,212,0,32,910,ITI,ITI2,10,Umbria
2021-01-30,VDA,436,202,234,232,192,12,0,13,423,ITC,ITC2,2,Valle d'Aosta / Vallée d'Aoste
2021-01-31,VEN,4679,1540,3139,3646,669,360,4,385,4294,ITH,ITH3,5,Veneto
2021-02-08,ABR,1197,396,801,710,223,264,0,491,706,ITF,ITF1,13,Abruzzo
2021-02-03,PAB,1445,457,988,615,441,321,68,5,1440,ITH,ITH1,4,Provincia Autonoma Bolzano / Bozen
2020-12-28,CAL,6,2,4,6,0,0,0,6,0,ITF,ITF6,18,Calabria
2021-01-27,MOL,674,251,423,436,29,209,0,8,666,ITF,ITF2,14,Molise
2021-02-07,LOM,7010,2740,4270,4994,1766,233,17,309,6701,ITC,ITC4,3,Lombardia
2021-01-19,SAR,747,270,477,423,164,160,0,692,55,ITG,ITG2,20,Sardegna
2020-12-31,PAT,1594,438,1156,817,108,669,0,1594,0,ITH,ITH2,4,Provincia Autonoma Trento
2021-01-29,MAR,1991,730,1261,1479,438,74,0,168,1823,ITI,ITI3,11,Marche
2021-02-10,PUG,3197,1250,1947,2201,232,764,0,1735,1462,ITF,ITF4,16,Puglia
2021-01-07,SIC,9172,4239,4933,7694,1268,210,0,9172,0,ITG,ITG1,19,Sicilia
2021-02-05,LIG,2165,813,1352,1433,421,311,0,143,2022,ITC,ITC3,7,Liguria
2021-01-21,FVG,892,345,547,861,31,0,0,0,892,ITH,ITH4,6,Friuli-Venezia Giulia
2021-01-13,BAS,915,386,529,573,194,148,0,915,0,ITF,ITF5,17,Basilicata
2021-02-10,MAR,1439,452,987,881,343,215,0,1080,359,ITI,ITI3,11,Marche
2021-01-14,LAZ,5217,1960,3257,3872,450,811,84,5217,0,ITI,ITI4,12,Lazio
2021-01-09,FVG,2517,841,1676,1519,405,593,0,2517,0,ITH,ITH4,6,Friuli-Venezia Giulia
2021-01-07,PIE,5370,1731,3639,4145,884,341,0,5370,0,ITC,ITC1,1,Piemonte
2021-01-15,PAB,3026,1119,1907,532,898,336,1260,3026,0,ITH,ITH1,4,Provincia Autonoma Bolzano / Bozen
2021-02-02,SIC,5536,2621,2915,3151,1956,429,0,632,4904,ITG,ITG1,19,Sicilia
2021-01-19,LOM,7788,2271,5517,3027,2920,1728,113,7312,476,ITC,ITC4,3,Lombardia
2021-01-19,PAT,402,77,325,324,42,36,0,402,0,ITH,ITH2,4,Provincia Autonoma Trento
2021-01-28,UMB,1240,392,848,891,4,345,0,19,1221,ITI,ITI2,10,Umbria
2021-01-25,VDA,147,65,82,125,16,6,0,0,147,ITC,ITC2,2,Valle d'Aosta / Vallée d'Aoste
2021-01-07,SAR,3097,1073,2024,2706,391,0,0,3097,0,ITG,ITG2,20,Sardegna
2021-02-08,BAS,552,190,362,431,74,47,0,148,404,ITF,ITF5,17,Basilicata
2021-01-02,UMB,301,110,191,301,0,0,0,301,0,ITI,ITI2,10,Umbria
2021-01-31,TOS,2964,1090,1874,2381,135,448,0,103,2861,ITI,ITI1,9,Toscana
2021-01-03,PUG,2003,941,1062,1793,67,143,0,2003,0,ITF,ITF4,16,Puglia
2021-01-11,VDA,325,112,213,238,57,30,0,325,0,ITC,ITC2,2,Valle d'Aosta / Vallée d'Aoste
2021-02-07,PIE,3084,973,2111,1647,662,775,0,445,2639,ITC,ITC1,1,Piemonte
2021-01-10,MAR,1737,699,1038,1462,275,0,0,1737,0,ITI,ITI3,11,Marche
2021-01-24,LIG,750,233,517,626,64,60,0,113,637,ITC,ITC3,7,Liguria
2021-01-27,ABR,1364,515,849,1301,63,0,0,39,1325,ITF,ITF1,13,Abruzzo
2021-01-02,CAM,3674,1963,1711,3167,507,0,0,3674,0,ITF,ITF3,15,Campania
2021-02-09,LAZ,8391,3483,4908,3258,581,548,4004,4570,3821,ITI,ITI4,12,Lazio
2021-01-19,VEN,1309,472,837,724,255,324,6,1160,149,ITH,ITH3,5,Veneto
2021-01-15,MOL,538,242,296,398,59,81,0,538,0,ITF,ITF2,14,Molise
2021-01-29,PUG,6150,2647,3503,5428,434,288,0,431,5719,ITF,ITF4,16,Puglia
2021-01-09,CAL,1916,1036,880,1529,387,0,0,1916,0,ITF,ITF6,18,Calabria
2021-02-04,EMR,9587,3121,6466,6210,1748,1522,107,1176,8411,ITH,ITH5,8,Emilia-Romagna
2021-01-08,MOL,429,141,288,244,65,120,0,429,0,ITF,ITF2,14,Molise
2020-12-27,MAR,200,97,103,184,12,4,0,200,0,ITI,ITI3,11,Marche
2021-02-06,VDA,288,103,185,169,45,0,74,91,197,ITC,ITC2,2,Valle d'Aosta / Vallée d'Aoste
2021-02-07,SAR,1116,394,722,975,141,0,0,227,889,ITG,ITG2,20,Sardegna
2021-01-14,SIC,5249,2513,2736,3045,1945,259,0,5249,0,ITG,ITG1,19,Sicilia
2021-01-22,PUG,1403,574,829,872,158,373,0,987,416,ITF,ITF4,16,Puglia
2020-12-29,LIG,118,32,86,87,10,21,0,118,0,ITC,ITC3,7,Liguria
2021-02-02,LAZ,5772,2133,3639,4712,486,571,3,501,5271,ITI,ITI4,12,Lazio
2021-01-28,CAM,8829,4122,4707,6213,2269,347,0,134,8695,ITF,ITF3,15,Campania
2021-02-04,CAL,3108,1506,1602,2407,479,222,0,644,2464,ITF,ITF6,18,Calabria
2021-02-09,FVG,1839,550,1289,1046,507,286,0,1552,287,ITH,ITH4,6,Friuli-Venezia Giulia
2020-12-27,PAB,143,65,78,136,6,0,1,143,0,ITH,ITH1,4,Provincia Autonoma Bolzano / Bozen
2021-01-25,BAS,1019,426,593,660,358,1,0,74,945,ITF,ITF5,17,Basilicata
2021-01-20,ABR,447,156,291,147,96,204,0,445,2,ITF,ITF1,13,Abruzzo
2021-01-31,LOM,9508,3641,5867,7273,2141,87,7,32,9476,ITC,ITC4,3,Lombardia
2021-02-03,MOL,731,249,482,391,160,180,0,338,393,ITF,ITF2,14,Molise
2021-01-28,FVG,2232,792,1440,1753,287,192,0,351,1881,ITH,ITH4,6,Friuli-Venezia Giulia
2021-01-26,PIE,6323,1875,4448,4720,875,728,0,734,5589,ITC,ITC1,1,Piemonte
2021-01-16,EMR,5591,1716,3875,3654,841,1096,0,5591,0,ITH,ITH5,8,Emilia-Romagna
2021-01-06,VDA,65,33,32,29,18,18,0,65,0,ITC,ITC2,2,Valle d'Aosta / Vallée d'Aoste
2020-12-31,SIC,877,469,408,827,50,0,0,877,0,ITG,ITG1,19,Sicilia
2021-02-07,VEN,2312,860,1452,1924,336,50,2,713,1599,ITH,ITH3,5,Veneto
2021-01-14,UMB,749,200,549,696,36,17,0,749,0,ITI,ITI2,10,Umbria
2021-01-26,SAR,1336,453,883,1296,40,0,0,27,1309,ITG,ITG2,20,Sardegna
2021-02-03,PUG,5018,1994,3024,4355,479,184,0,726,4292,ITF,ITF4,16,Puglia
2020-12-31,PIE,3879,1318,2561,3387,358,134,0,3879,0,ITC,ITC1,1,Piemonte
2021-01-27,PAB,84,28,56,54,30,0,0,1,83,ITH,ITH1,4,Provincia Autonoma Bolzano / Bozen
2021-01-02,LAZ,6703,2629,4074,6267,78,358,0,6703,0,ITI,ITI4,12,Lazio
2021-01-12,TOS,3581,1398,2183,2944,283,354,0,3581,0,ITI,ITI1,9,Toscana
2021-01-22,MAR,487,167,320,315,85,87,0,194,293,ITI,ITI3,11,Marche
2021-01-26,SIC,9474,4663,4811,8346,874,254,0,234,9240,ITG,ITG1,19,Sicilia
2021-01-12,LOM,19499,6504,12995,10803,7198,1340,158,19499,0,ITC,ITC4,3,Lombardia
2021-01-08,PAB,1475,468,1007,747,466,166,96,1475,0,ITH,ITH1,4,Provincia Autonoma Bolzano / Bozen
2021-01-21,LAZ,5220,2098,3122,4755,108,232,125,196,5024,ITI,ITI4,12,Lazio
2021-01-08,ABR,1525,507,1018,1487,38,0,0,1525,0,ITF,ITF1,13,Abruzzo
2021-01-02,FVG,1217,471,746,1150,67,0,0,1217,0,ITH,ITH4,6,Friuli-Venezia Giulia
2021-01-12,VEN,5229,1516,3713,2249,1063,1737,180,5229,0,ITH,ITH3,5,Veneto
2021-01-21,UMB,607,200,407,426,13,168,0,338,269,ITI,ITI2,10,Umbria
2021-01-16,CAL,2394,1120,1274,1664,489,241,0,2394,0,ITF,ITF6,18,Calabria
2021-01-12,PAT,494,158,336,397,43,54,0,494,0,ITH,ITH2,4,Provincia Autonoma Trento
2020-12-27,MOL,50,20,30,29,4,17,0,50,0,ITF,ITF2,14,Molise
2021-01-10,PUG,2340,1057,1283,2027,112,201,0,2340,0,ITF,ITF4,16,Puglia
2021-01-26,PAT,498,138,360,398,16,84,0,26,472,ITH,ITH2,4,Provincia Autonoma Trento
2021-01-17,LIG,676,274,402,433,126,117,0,676,0,ITC,ITC3,7,Liguria
2020-12-31,SAR,32,16,16,28,4,0,0,32,0,ITG,ITG2,20,Sardegna
2021-01-20,BAS,84,22,62,0,84,0,0,84,0,ITF,ITF5,17,Basilicata
2021-02-09,CAM,4628,2192,2436,1148,2137,6,1337,4376,252,ITF,ITF3,15,Campania
2020-12-27,PUG,506,249,257,401,42,63,0,506,0,ITF,ITF4,16,Puglia
2021-01-18,VDA,213,74,139,29,111,27,46,213,0,ITC,ITC2,2,Valle d'Aosta / Vallée d'Aoste
2021-02-01,BAS,242,91,151,89,105,48,0,46,196,ITF,ITF5,17,Basilicata
2021-01-28,EMR,10221,3334,6887,8053,1046,1122,0,353,9868,ITH,ITH5,8,Emilia-Romagna
2021-01-24,TOS,3347,1072,2275,2601,37,709,0,199,3148,ITI,ITI1,9,Toscana
2021-01-06,BAS,294,129,165,143,115,36,0,294,0,ITF,ITF5,17,Basilicata
2021-01-09,CAM,10564,5023,5541,6759,3536,269,0,10564,0,ITF,ITF3,15,Campania
2021-01-07,LAZ,7719,2891,4828,6877,276,566,0,7719,0,ITI,ITI4,12,Lazio
2020-12-31,LOM,713,300,413,656,57,0,0,713,0,ITC,ITC4,3,Lombardia
2021-01-21,SIC,1327,646,681,1000,190,137,0,498,829,ITG,ITG1,19,Sicilia
2021-01-07,LOM,11554,3593,7961,8084,2804,594,72,11554,0,ITC,ITC4,3,Lombardia
2021-01-03,PAB,34,12,22,26,7,0,1,34,0,ITH,ITH1,4,Provincia Autonoma Bolzano / Bozen
2021-01-28,SAR,2952,1039,1913,2538,414,0,0,69,2883,ITG,ITG2,20,Sardegna
2021-01-18,BAS,462,157,305,361,57,44,0,363,99,ITF,ITF5,17,Basilicata
2021-01-13,ABR,1253,440,813,1103,150,0,0,1253,0,ITF,ITF1,13,Abruzzo
2021-01-07,FVG,2089,718,1371,1758,221,110,0,2089,0,ITH,ITH4,6,Friuli-Venezia Giulia
2021-01-09,LAZ,6286,2556,3730,5108,558,620,0,6286,0,ITI,ITI4,12,Lazio
2021-01-16,UMB,221,73,148,146,32,43,0,221,0,ITI,ITI2,10,Umbria
2021-01-02,PIE,3539,1134,2405,3072,414,53,0,3539,0,ITC,ITC1,1,Piemonte
2021-02-10,MOL,96,39,57,90,4,2,0,76,20,ITF,ITF2,14,Molise
2021-02-09,VEN,4972,1811,3161,3016,1060,876,20,3340,1632,ITH,ITH3,5,Veneto
2021-01-21,LOM,5176,1527,3649,1809,3178,187,2,4490,686,ITC,ITC4,3,Lombardia
2021-01-14,PAT,690,199,491,469,19,202,0,690,0,ITH,ITH2,4,Provincia Autonoma Trento
2021-01-02,SAR,60,21,39,60,0,0,0,60,0,ITG,ITG2,20,Sardegna
2021-02-02,PIE,10125,3479,6646,6800,2025,1300,0,764,9361,ITC,ITC1,1,Piemonte
2021-01-13,VDA,337,110,227,166,143,28,0,337,0,ITC,ITC2,2,Valle d'Aosta / Vallée d'Aoste
2021-01-19,LIG,1175,398,777,573,349,253,0,1090,85,ITC,ITC3,7,Liguria
2021-02-04,LAZ,6043,2280,3763,4460,619,892,72,940,5103,ITI,ITI4,12,Lazio
2021-01-07,CAM,8904,4162,4742,6309,2263,332,0,8904,0,ITF,ITF3,15,Campania
2021-01-19,TOS,1104,531,573,392,221,491,0,1104,0,ITI,ITI1,9,Toscana
2021-01-04,UMB,809,397,412,808,1,0,0,809,0,ITI,ITI2,10,Umbria
2021-01-14,VEN,7047,1923,5124,3222,1399,2409,17,7047,0,ITH,ITH3,5,Veneto
2021-02-08,VDA,220,82,138,28,128,0,64,22,198,ITC,ITC2,2,Valle d'Aosta / Vallée d'Aoste
2021-01-10,MOL,270,72,198,82,19,169,0,270,0,ITF,ITF2,14,Molise
2021-01-24,PUG,1660,744,916,1279,233,148,0,146,1514,ITF,ITF4,16,Puglia
2021-01-14,CAL,2556,1214,1342,1962,591,3,0,2556,0,ITF,ITF6,18,Calabria
2021-01-17,PAB,2269,1024,1245,54,236,19,1960,2257,12,ITH,ITH1,4,Provincia Autonoma Bolzano / Bozen
2021-02-09,EMR,4086,1221,2865,2213,479,1181,213,2254,1832,ITH,ITH5,8,Emilia-Romagna
2021-02-09,PAT,900,281,619,441,70,73,316,428,472,ITH,ITH2,4,Provincia Autonoma Trento
2021-01-02,LOM,199,72,127,177,22,0,0,199,0,ITC,ITC4,3,Lombardia
2021-02-02,SAR,1479,653,826,985,494,0,0,241,1238,ITG,ITG2,20,Sardegna
2021-01-02,VEN,5740,1765,3975,4796,398,544,2,5740,0,ITH,ITH3,5,Veneto
2020-12-31,TOS,786,196,590,97,7,682,0,786,0,ITI,ITI1,9,Toscana
2021-01-02,PAT,498,142,356,334,25,139,0,498,0,ITH,ITH2,4,Provincia Autonoma Trento
2021-01-17,PUG,1295,586,709,818,148,329,0,1226,69,ITF,ITF4,16,Puglia
2021-02-02,CAM,5722,2804,2918,3640,1728,354,0,443,5279,ITF,ITF3,15,Campania
2021-02-10,PAB,1522,541,981,406,534,1,581,26,1496,ITH,ITH1,4,Provincia Autonoma Bolzano / Bozen
2021-01-28,LAZ,7954,2998,4956,6810,496,514,134,459,7495,ITI,ITI4,12,Lazio
2021-01-07,LIG,2936,1015,1921,2144,434,358,0,2936,0,ITC,ITC3,7,Liguria
2021-02-09,CAL,2091,886,1205,1377,483,231,0,941,1150,ITF,ITF6,18,Calabria
2021-01-30,BAS,698,225,473,298,275,125,0,126,572,ITF,ITF5,17,Basilicata
2021-01-29,MOL,421,136,285,227,85,109,0,6,415,ITF,ITF2,14,Molise
2021-01-21,PIE,6704,2257,4447,4676,857,1171,0,3218,3486,ITC,ITC1,1,Piemonte
2021-01-29,PAB,1487,508,979,855,335,295,2,23,1464,ITH,ITH1,4,Provincia Autonoma Bolzano / Bozen
2021-02-11,UMB,840,348,492,733,102,5,0,834,6,ITI,ITI2,10,Umbria
2021-01-21,EMR,2142,724,1418,1274,219,649,0,801,1341,ITH,ITH5,8,Emilia-Romagna
2021-02-02,VEN,6391,1836,4555,2967,1291,1970,163,383,6008,ITH,ITH3,5,Veneto
2021-02-02,LOM,19267,6398,12869,13026,4566,1597,78,477,18790,ITC,ITC4,3,Lombardia
2021-02-07,LIG,398,150,248,146,69,183,0,3,395,ITC,ITC3,7,Liguria
2021-01-24,MAR,879,338,541,762,117,0,0,17,862,ITI,ITI3,11,Marche
2021-01-14,TOS,3254,1179,2075,2459,475,320,0,3254,0,ITI,ITI1,9,Toscana
2021-01-02,SIC,4871,2532,2339,4311,560,0,0,4871,0,ITG,ITG1,19,Sicilia
2021-01-21,SAR,126,60,66,60,66,0,0,94,32,ITG,ITG2,20,Sardegna
2020-12-28,LAZ,516,228,288,515,1,0,0,516,0,ITI,ITI4,12,Lazio
2021-01-26,FVG,1970,647,1323,1438,152,380,0,212,1758,ITH,ITH4,6,Friuli-Venezia Giulia
2021-02-05,MAR,2133,650,1483,1309,418,406,0,440,1693,ITI,ITI3,11,Marche
2021-01-16,LAZ,5339,2069,3270,3347,460,1062,470,5339,0,ITI,ITI4,12,Lazio
2021-01-07,VEN,8357,2320,6037,5463,1087,1807,0,8357,0,ITH,ITH3,5,Veneto
2021-01-14,FVG,2586,787,1799,1606,550,430,0,2586,0,ITH,ITH4,6,Friuli-Venezia Giulia
2021-01-02,EMR,2347,903,1444,2071,79,197,0,2347,0,ITH,ITH5,8,Emilia-Romagna
2021-01-21,CAL,958,444,514,735,108,115,0,929,29,ITF,ITF6,18,Calabria
2021-01-07,PAT,1269,310,959,649,64,556,0,1269,0,ITH,ITH2,4,Provincia Autonoma Trento
2021-01-10,PAB,2,2,0,1,1,0,0,2,0,ITH,ITH1,4,Provincia Autonoma Bolzano / Bozen
2021-01-09,PIE,6181,2184,3997,4486,1127,568,0,6181,0,ITC,ITC1,1,Piemonte
2020-12-31,FVG,1053,384,669,1011,42,0,0,1053,0,ITH,ITH4,6,Friuli-Venezia Giulia
2021-01-05,PUG,5097,2244,2853,4704,290,98,5,5097,0,ITF,ITF4,16,Puglia
2021-02-05,PAB,2788,1035,1753,640,677,394,1077,6,2782,ITH,ITH1,4,Provincia Autonoma Bolzano / Bozen
2021-01-12,LIG,2170,804,1366,1560,270,340,0,2170,0,ITC,ITC3,7,Liguria
2021-01-21,PAT,349,93,256,289,44,16,0,227,122,ITH,ITH2,4,Provincia Autonoma Trento
2021-01-28,SIC,9309,4391,4918,7449,1565,295,0,412,8897,ITG,ITG1,19,Sicilia
2021-01-14,LOM,25907,7580,18327,11313,9518,4617,459,25907,0,ITC,ITC4,3,Lombardia
2021-02-07,TOS,2805,953,1852,2348,300,157,0,884,1921,ITI,ITI1,9,Toscana
2021-01-23,UMB,277,100,177,276,1,0,0,2,275,ITI,ITI2,10,Umbria
2021-01-20,VDA,23,8,15,0,0,6,17,23,0,ITC,ITC2,2,Valle d'Aosta / Vallée d'Aoste
2021-02-02,PAT,881,237,644,461,95,165,160,188,693,ITH,ITH2,4,Provincia Autonoma Trento
2021-01-21,VEN,2292,719,1573,1987,164,141,0,23,2269,ITH,ITH3,5,Veneto
2021-01-26,TOS,5391,1791,3600,4356,84,951,0,218,5173,ITI,ITI1,9,Toscana
2021-02-09,SIC,4355,1823,2532,2226,1489,640,0,3351,1004,ITG,ITG1,19,Sicilia
2021-01-05,MAR,1562,586,976,1436,126,0,0,1562,0,ITI,ITI3,11,Marche
2021-01-09,SAR,4025,1416,2609,3180,845,0,0,4025,0,ITG,ITG2,20,Sardegna
2021-02-01,ABR,1632,573,1059,1384,247,1,0,271,1361,ITF,ITF1,13,Abruzzo
2021-02-06,BAS,900,366,534,544,188,168,0,144,756,ITF,ITF5,17,Basilicata
2021-02-02,EMR,9299,2986,6313,6148,1553,1548,50,483,8816,ITH,ITH5,8,Emilia-Romagna
2021-01-06,ABR,1830,664,1166,1546,151,133,0,1830,0,ITF,ITF1,13,Abruzzo
2021-01-11,BAS,183,66,117,78,64,41,0,183,0,ITF,ITF5,17,Basilicata
2021-01-14,CAM,7073,2977,4096,3707,3022,344,0,7073,0,ITF,ITF3,15,Campania
2021-02-09,PIE,7219,2280,4939,4124,1343,1752,0,717,6502,ITC,ITC1,1,Piemonte
2021-01-26,LIG,2392,775,1617,1879,262,251,0,153,2239,ITC,ITC3,7,Liguria
2021-02-02,CAL,2005,993,1012,1623,307,75,0,170,1835,ITF,ITF6,18,Calabria
2020-12-31,LIG,948,334,614,713,54,153,28,948,0,ITC,ITC3,7,Liguria
2021-02-01,VDA,397,124,273,268,60,69,0,81,316,ITC,ITC2,2,Valle d'Aosta / Vallée d'Aoste
2021-01-26,CAM,7294,3701,3593,5739,1333,222,0,352,6942,ITF,ITF3,15,Campania
2021-01-19,FVG,4,1,3,4,0,0,0,4,0,ITH,ITH4,6,Friuli-Venezia Giulia
2021-01-09,SIC,7325,3424,3901,5034,1835,456,0,7325,0,ITG,ITG1,19,Sicilia
2021-02-09,SAR,2283,836,1447,1306,479,497,1,1287,996,ITG,ITG2,20,Sardegna
2021-01-14,PIE,9759,3150,6609,6174,2102,1483,0,9759,0,ITC,ITC1,1,Piemonte
2021-02-04,UMB,732,226,506,692,20,20,0,25,707,ITI,ITI2,10,Umbria
2021-01-14,EMR,8085,2572,5513,5330,1153,1602,0,8085,0,ITH,ITH5,8,Emilia-Romagna
2021-02-02,TOS,3720,1464,2256,3020,279,421,0,174,3546,ITI,ITI1,9,Toscana
2021-01-26,LOM,8272,2685,5587,6530,1532,203,7,321,7951,ITC,ITC4,3,Lombardia
2021-01-25,ABR,1603,632,971,1583,20,0,0,20,1583,ITF,ITF1,13,Abruzzo
2021-02-02,FVG,2460,806,1654,1650,394,416,0,216,2244,ITH,ITH4,6,Friuli-Venezia Giulia
2021-01-26,VEN,6899,2080,4819,5307,631,961,0,153,6746,ITH,ITH3,5,Veneto
2021-01-02,CAL,165,94,71,165,0,0,0,165,0,ITF,ITF6,18,Calabria
2021-01-28,PIE,5442,1770,3672,4019,852,571,0,349,5093,ITC,ITC1,1,Piemonte
2021-01-22,MOL,126,35,91,21,32,73,0,126,0,ITF,ITF2,14,Molise
2021-01-14,SAR,1105,426,679,885,220,0,0,1105,0,ITG,ITG2,20,Sardegna
2021-02-09,LOM,10776,2987,7789,5117,2194,3391,74,3330,7446,ITC,ITC4,3,Lombardia
2021-02-05,PUG,5445,2189,3256,4419,523,503,0,1191,4254,ITF,ITF4,16,Puglia
2021-01-09,UMB,1719,492,1227,888,10,821,0,1719,0,ITI,ITI2,10,Umbria
2021-01-22,PAB,241,138,103,129,24,85,3,124,117,ITH,ITH1,4,Provincia Autonoma Bolzano / Bozen
2021-01-07,TOS,6013,1750,4263,5308,30,675,0,6013,0,ITI,ITI1,9,Toscana
2021-01-31,LIG,617,264,353,382,101,134,0,7,610,ITC,ITC3,7,Liguria
2021-01-17,MAR,1598,682,916,964,588,46,0,1549,49,ITI,ITI3,11,Marche
