data_somministrazione,area,totale,sesso_maschile,sesso_femminile,prima_dose,seconda_dose,codice_NUTS1,codice_NUTS2,codice_regione_ISTAT,nome_area
2021-04-11,CAM,17523,8606,8917,15441,2082,ITF,ITF3,15,Campania
2021-05-24,FVG,11394,5516,5878,7782,3612,ITH,ITH4,6,Friuli-Venezia Giulia
2021-06-04,BAS,4831,2286,2545,3785,1046,ITF,ITF5,17,Basilicata
2021-02-22,ABR,2642,1173,1469,2612,30,ITF,ITF1,13,Abruzzo
2021-06-02,UMB,3944,1895,2049,3904,40,ITI,ITI2,10,Umbria
2021-02-13,FVG,566,179,387,560,6,ITH,ITH4,6,Friuli-Venezia Giulia
2021-02-18,LAZ,10017,4975,5042,9208,809,ITI,ITI4,12,Lazio
2021-02-21,PUG,2177,474,1703,2115,62,ITF,ITF4,16,Puglia
2021-04-28,CAM,36441,17644,18797,26689,9752,ITF,ITF3,15,Campania
2021-01-18,CAM,958,399,559,714,244,ITF,ITF3,15,Campania
2021-06-01,PUG,34693,17346,17347,21863,12830,ITF,ITF4,16,Puglia
2021-02-24,BAS,1803,743,1060,1734,69,ITF,ITF5,17,Basilicata
2021-05-15,PUG,43513,18944,24569,23525,19988,ITF,ITF4,16,Puglia
2021-05-26,EMR,33211,14725,18486,10297,22914,ITH,ITH5,8,Emilia-Romagna
2021-04-26,LIG,10554,4980,5574,7918,2636,ITC,ITC3,7,Liguria
2021-05-12,LAZ,47526,21564,25962,30894,16632,ITI,ITI4,12,Lazio
2021-06-17,VEN,50764,25453,25311,25955,24809,ITH,ITH3,5,Veneto
2021-06-12,EMR,40328,21327,19001,35438,4890,ITH,ITH5,8,Emilia-Romagna
2021-06-12,PAT,5356,2688,2668,471,4885,ITH,ITH2,4,Provincia Autonoma Trento
2021-03-09,VEN,16542,7446,9096,10218,6324,ITH,ITH3,5,Veneto
2021-04-05,MAR,5690,2357,3333,4421,1269,ITI,ITI3,11,Marche
2021-02-05,ABR,1534,521,1013,788,746,ITF,ITF1,13,Abruzzo
2021-03-04,EMR,16450,5350,11100,13433,3017,ITH,ITH5,8,Emilia-Romagna
2021-02-19,MOL,169,93,76,167,2,ITF,ITF2,14,Molise
2021-01-16,LIG,1278,557,721,1278,0,ITC,ITC3,7,Liguria
2021-05-16,ABR,9577,4138,5439,5764,3813,ITF,ITF1,13,Abruzzo
2021-05-31,VEN,31577,16203,15374,21677,9900,ITH,ITH3,5,Veneto
2021-02-01,LAZ,5676,2178,3498,354,5322,ITI,ITI4,12,Lazio
2021-03-02,FVG,4219,1519,2700,2720,1499,ITH,ITH4,6,Friuli-Venezia Giulia
2021-03-21,PAT,129,69,60,129,0,ITH,ITH2,4,Provincia Autonoma Trento
2021-06-03,PUG,50236,24375,25861,31007,19229,ITF,ITF4,16,Puglia
2021-06-04,ABR,15595,7370,8225,10907,4688,ITF,ITF1,13,Abruzzo
2021-02-22,BAS,1790,773,1017,1737,53,ITF,ITF5,17,Basilicata
2021-02-20,UMB,282,100,182,258,24,ITI,ITI2,10,Umbria
2021-05-24,PIE,28970,13420,15550,17019,11951,ITC,ITC1,1,Piemonte
2021-06-19,SAR,15382,7528,7854,9218,6164,ITG,ITG2,20,Sardegna
2021-02-02,LIG,2676,1006,1670,134,2542,ITC,ITC3,7,Liguria
2021-05-18,ABR,12113,5660,6453,7731,4382,ITF,ITF1,13,Abruzzo
2021-03-22,PAB,1144,523,621,1139,5,ITH,ITH1,4,Provincia Autonoma Bolzano / Bozen
2021-04-15,VDA,810,377,433,671,139,ITC,ITC2,2,Valle d'Aosta / Vallée d'Aoste
2021-05-24,EMR,29929,13708,16221,18453,11476,ITH,ITH5,8,Emilia-Romagna
2021-06-05,LOM,102094,52786,49308,92342,9752,ITC,ITC4,3,Lombardia
2021-02-13,EMR,3628,1085,2543,3030,598,ITH,ITH5,8,Emilia-Romagna
2021-02-24,ABR,3305,1441,1864,3129,176,ITF,ITF1,13,Abruzzo
2021-03-19,MAR,3834,1598,2236,338,3496,ITI,ITI3,11,Marche
2021-03-26,VEN,29574,13139,16435,24113,5461,ITH,ITH3,5,Veneto
2021-04-30,CAL,14955,7336,7619,10606,4349,ITF,ITF6,18,Calabria
2021-03-09,UMB,4092,2003,2089,2801,1291,ITI,ITI2,10,Umbria
2021-03-10,MOL,1737,720,1017,1687,50,ITF,ITF2,14,Molise
2021-03-28,SAR,4646,1839,2807,4566,80,ITG,ITG2,20,Sardegna
2021-03-04,FVG,3451,1597,1854,2792,659,ITH,ITH4,6,Friuli-Venezia Giulia
2021-03-02,PIE,11202,4506,6696,10386,816,ITC,ITC1,1,Piemonte
2021-03-14,LOM,14873,5348,9525,11590,3283,ITC,ITC4,3,Lombardia
2021-01-04,SAR,592,217,375,592,0,ITG,ITG2,20,Sardegna
2021-06-01,MOL,2598,1322,1276,2490,108,ITF,ITF2,14,Molise
2021-04-28,LIG,14443,6519,7924,6459,7984,ITC,ITC3,7,Liguria
2021-03-10,PUG,14808,6612,8196,11685,3123,ITF,ITF4,16,Puglia
2021-06-12,FVG,8068,4627,3441,6915,1153,ITH,ITH4,6,Friuli-Venezia Giulia
2021-02-04,LIG,2817,986,1831,179,2638,ITC,ITC3,7,Liguria
2021-04-02,TOS,31971,13560,18411,23944,8027,ITI,ITI1,9,Toscana
2021-05-24,PAT,4383,2012,2371,1361,3022,ITH,ITH2,4,Provincia Autonoma Trento
2021-03-17,MAR,3428,1494,1934,107,3321,ITI,ITI3,11,Marche
2021-03-28,VEN,31293,13602,17691,27679,3614,ITH,ITH3,5,Veneto
2021-05-15,LIG,7253,3234,4019,4299,2954,ITC,ITC3,7,Liguria
2021-05-31,SIC,37883,17043,20840,21570,16313,ITG,ITG1,19,Sicilia
2021-06-19,VEN,48395,24637,23758,25933,22462,ITH,ITH3,5,Veneto
2021-01-13,LAZ,5694,2151,3543,5694,0,ITI,ITI4,12,Lazio
2021-02-21,LIG,869,491,378,865,4,ITC,ITC3,7,Liguria
2021-02-23,LOM,11813,4802,7011,11482,331,ITC,ITC4,3,Lombardia
2021-03-02,PAT,1306,440,866,930,376,ITH,ITH2,4,Provincia Autonoma Trento
2021-03-21,FVG,2672,1000,1672,2263,409,ITH,ITH4,6,Friuli-Venezia Giulia
2021-06-24,TOS,29234,14483,14751,19634,9600,ITI,ITI1,9,Toscana
2021-01-18,CAL,1288,583,705,1052,236,ITF,ITF6,18,Calabria
2021-04-23,LAZ,37691,18097,19594,22417,15274,ITI,ITI4,12,Lazio
2021-06-10,PAT,6119,2977,3142,1915,4204,ITH,ITH2,4,Provincia Autonoma Trento
2021-03-29,PUG,13438,6502,6936,6697,6741,ITF,ITF4,16,Puglia
2021-06-12,PIE,42456,22375,20081,39839,2617,ITC,ITC1,1,Piemonte
2021-03-05,PAB,1839,625,1214,1397,442,ITH,ITH1,4,Provincia Autonoma Bolzano / Bozen
2021-05-17,CAM,49297,21658,27639,24099,25198,ITF,ITF3,15,Campania
2021-06-23,BAS,3309,1557,1752,2433,876,ITF,ITF5,17,Basilicata
2021-01-09,TOS,4485,1596,2889,4485,0,ITI,ITI1,9,Toscana
2021-02-06,CAM,5340,2665,2675,2102,3238,ITF,ITF3,15,Campania
2021-04-13,VDA,373,171,202,329,44,ITC,ITC2,2,Valle d'Aosta / Vallée d'Aoste
2021-02-28,MAR,2836,1251,1585,2830,6,ITI,ITI3,11,Marche
2021-04-11,CAL,4179,1898,2281,2236,1943,ITF,ITF6,18,Calabria
2021-04-14,VEN,15906,6896,9010,9279,6627,ITH,ITH3,5,Veneto
2021-05-27,PAB,6085,3200,2885,4075,2010,ITH,ITH1,4,Provincia Autonoma Bolzano / Bozen
2021-05-31,UMB,5804,2837,2967,4920,884,ITI,ITI2,10,Umbria
2021-03-12,PUG,14274,6433,7841,10346,3928,ITF,ITF4,16,Puglia
2021-04-16,SAR,14442,6488,7954,9099,5343,ITG,ITG2,20,Sardegna
2021-01-04,VEN,6735,2033,4702,6735,0,ITH,ITH3,5,Veneto
2021-03-27,VDA,333,164,169,302,31,ITC,ITC2,2,Valle d'Aosta / Vallée d'Aoste
2021-06-08,MAR,13914,7013,6901,11303,2611,ITI,ITI3,11,Marche
2021-05-14,UMB,5334,2512,2822,3519,1815,ITI,ITI2,10,Umbria
2021-06-13,PAB,3618,2018,1600,427,3191,ITH,ITH1,4,Provincia Autonoma Bolzano / Bozen
2021-06-20,PUG,20846,10500,10346,13797,7049,ITF,ITF4,16,Puglia
2021-05-25,PAB,3837,1990,1847,2952,885,ITH,ITH1,4,Provincia Autonoma Bolzano / Bozen
2021-04-16,LAZ,34428,15693,18735,22339,12089,ITI,ITI4,12,Lazio
2021-06-21,EMR,37038,18725,18313,16218,20820,ITH,ITH5,8,Emilia-Romagna
2021-04-18,CAL,5845,2794,3051,4929,916,ITF,ITF6,18,Calabria
2021-04-08,BAS,764,348,416,754,10,ITF,ITF5,17,Basilicata
2021-01-27,VDA,151,71,80,79,72,ITC,ITC2,2,Valle d'Aosta / Vallée d'Aoste
2021-02-06,PAT,574,298,276,433,141,ITH,ITH2,4,Provincia Autonoma Trento
2021-03-26,TOS,20668,9383,11285,14901,5767,ITI,ITI1,9,Toscana
2021-04-20,VDA,933,430,503,739,194,ITC,ITC2,2,Valle d'Aosta / Vallée d'Aoste
2021-04-22,BAS,5036,2346,2690,3433,1603,ITF,ITF5,17,Basilicata
2021-01-23,LAZ,7214,2869,4345,585,6629,ITI,ITI4,12,Lazio
2021-03-30,EMR,23344,10339,13005,18303,5041,ITH,ITH5,8,Emilia-Romagna
2021-01-06,LAZ,5124,1962,3162,5124,0,ITI,ITI4,12,Lazio
2021-01-10,VDA,220,71,149,220,0,ITC,ITC2,2,Valle d'Aosta / Vallée d'Aoste
2021-02-23,PAT,1112,395,717,899,213,ITH,ITH2,4,Provincia Autonoma Trento
2021-03-09,TOS,11128,4566,6562,5576,5552,ITI,ITI1,9,Toscana
2021-03-24,MAR,7033,2983,4050,3365,3668,ITI,ITI3,11,Marche
2021-03-28,FVG,4936,2354,2582,4778,158,ITH,ITH4,6,Friuli-Venezia Giulia
2021-04-05,PUG,12738,6183,6555,12205,533,ITF,ITF4,16,Puglia
2020-12-27,VDA,20,9,11,20,0,ITC,ITC2,2,Valle d'Aosta / Vallée d'Aoste
2021-03-19,PUG,7961,3653,4308,3415,4546,ITF,ITF4,16,Puglia
2021-01-07,MOL,598,209,389,598,0,ITF,ITF2,14,Molise
2021-01-11,VEN,7240,2102,5138,7240,0,ITH,ITH3,5,Veneto
2021-06-01,MAR,12067,6160,5907,9972,2095,ITI,ITI3,11,Marche
2021-02-28,LIG,1058,580,478,1049,9,ITC,ITC3,7,Liguria
2021-05-07,UMB,10130,4707,5423,6919,3211,ITI,ITI2,10,Umbria
2021-06-20,PAB,4952,2695,2257,367,4585,ITH,ITH1,4,Provincia Autonoma Bolzano / Bozen
2021-01-18,FVG,1961,606,1355,1867,94,ITH,ITH4,6,Friuli-Venezia Giulia
2021-03-03,ABR,4633,1891,2742,3727,906,ITF,ITF1,13,Abruzzo
2021-03-10,MAR,5666,2400,3266,4529,1137,ITI,ITI3,11,Marche
2021-05-24,CAM,31319,15116,16203,16203,15116,ITF,ITF3,15,Campania
2021-01-04,FVG,1507,558,949,1507,0,ITH,ITH4,6,Friuli-Venezia Giulia
2021-04-09,TOS,24593,10579,14014,21184,3409,ITI,ITI1,9,Toscana
2021-05-17,PAT,4293,2122,2171,3942,351,ITH,ITH2,4,Provincia Autonoma Trento
2021-02-13,CAM,5508,2550,2958,5291,217,ITF,ITF3,15,Campania
2021-02-21,MAR,376,141,235,375,1,ITI,ITI3,11,Marche
2021-04-04,CAL,1760,884,876,1261,499,ITF,ITF6,18,Calabria
2021-04-21,VEN,32322,13178,19144,16263,16059,ITH,ITH3,5,Veneto
2021-02-07,PAB,2362,1058,1304,14,2348,ITH,ITH1,4,Provincia Autonoma Bolzano / Bozen
2021-02-12,MOL,332,150,182,208,124,ITF,ITF2,14,Molise
2021-02-25,SIC,9866,5155,4711,8703,1163,ITG,ITG1,19,Sicilia
2021-03-28,PIE,16062,6901,9161,8440,7622,ITC,ITC1,1,Piemonte
2021-04-23,SAR,12862,5741,7121,7387,5475,ITG,ITG2,20,Sardegna
2021-05-22,VEN,34763,16674,18089,13358,21405,ITH,ITH3,5,Veneto
2021-02-11,VEN,4012,1238,2774,3384,628,ITH,ITH3,5,Veneto
2021-04-08,ABR,7394,3336,4058,5065,2329,ITF,ITF1,13,Abruzzo
2021-06-05,SIC,59908,28495,31413,49333,10575,ITG,ITG1,19,Sicilia
2021-04-23,CAM,32315,15518,16797,23167,9148,ITF,ITF3,15,Campania
2021-05-10,SAR,9738,4340,5398,7201,2537,ITG,ITG2,20,Sardegna
2021-01-28,VEN,9210,2662,6548,172,9038,ITH,ITH3,5,Veneto
2021-04-22,ABR,6729,3249,3480,4999,1730,ITF,ITF1,13,Abruzzo
2021-01-30,SAR,3863,1392,2471,362,3501,ITG,ITG2,20,Sardegna
2021-03-14,SIC,8773,3927,4846,4937,3836,ITG,ITG1,19,Sicilia
2021-04-11,PIE,20827,9319,11508,18666,2161,ITC,ITC1,1,Piemonte
2021-05-18,PAB,3342,1753,1589,2156,1186,ITH,ITH1,4,Provincia Autonoma Bolzano / Bozen
2021-01-04,EMR,7315,2527,4788,7315,0,ITH,ITH5,8,Emilia-Romagna
2021-01-04,PIE,5564,1679,3885,5564,0,ITC,ITC1,1,Piemonte
2021-04-23,LOM,73444,33286,40158,56903,16541,ITC,ITC4,3,Lombardia
2021-06-17,TOS,32405,16559,15846,26959,5446,ITI,ITI1,9,Toscana
2021-04-28,PIE,26047,11739,14308,16013,10034,ITC,ITC1,1,Piemonte
2021-01-18,PIE,6167,2048,4119,5918,249,ITC,ITC1,1,Piemonte
2021-03-22,ABR,4344,1908,2436,2373,1971,ITF,ITF1,13,Abruzzo
2021-05-10,LOM,85257,40877,44380,63685,21572,ITC,ITC4,3,Lombardia
2021-02-11,SIC,5236,2060,3176,4773,463,ITG,ITG1,19,Sicilia
2021-01-30,LOM,12308,4563,7745,154,12154,ITC,ITC4,3,Lombardia
2021-02-06,FVG,1154,338,816,22,1132,ITH,ITH4,6,Friuli-Venezia Giulia
2021-02-17,BAS,1135,493,642,1059,76,ITF,ITF5,17,Basilicata
2021-02-25,LAZ,12680,5536,7144,11602,1078,ITI,ITI4,12,Lazio
2021-04-14,PAT,3117,1464,1653,2380,737,ITH,ITH2,4,Provincia Autonoma Trento
2021-02-04,TOS,4253,1594,2659,961,3292,ITI,ITI1,9,Toscana
2021-02-23,FVG,2643,1277,1366,2463,180,ITH,ITH4,6,Friuli-Venezia Giulia
2021-03-28,PAT,751,294,457,749,2,ITH,ITH2,4,Provincia Autonoma Trento
2021-06-07,CAL,17007,7903,9104,13799,3208,ITF,ITF6,18,Calabria
2021-01-19,MAR,230,85,145,142,88,ITI,ITI3,11,Marche
2021-05-28,BAS,3612,1807,1805,949,2663,ITF,ITF5,17,Basilicata
2021-06-05,LAZ,65872,32480,33392,43174,22698,ITI,ITI4,12,Lazio
2021-02-14,PUG,786,347,439,662,124,ITF,ITF4,16,Puglia
2021-05-15,TOS,29350,13852,15498,23568,5782,ITI,ITI1,9,Toscana
2021-05-19,EMR,33702,14956,18746,18537,15165,ITH,ITH5,8,Emilia-Romagna
2021-02-02,MAR,1193,398,795,72,1121,ITI,ITI3,11,Marche
2021-06-09,VDA,1027,535,492,991,36,ITC,ITC2,2,Valle d'Aosta / Vallée d'Aoste
2021-06-11,BAS,4224,1975,2249,3195,1029,ITF,ITF5,17,Basilicata
2021-05-25,PUG,34564,16122,18442,21068,13496,ITF,ITF4,16,Puglia
2021-01-04,PAT,870,227,643,870,0,ITH,ITH2,4,Provincia Autonoma Trento
2021-03-01,VDA,181,66,115,147,34,ITC,ITC2,2,Valle d'Aosta / Vallée d'Aoste
2021-03-15,MOL,832,338,494,587,245,ITF,ITF2,14,Molise
2021-04-28,TOS,19123,8183,10940,3832,15291,ITI,ITI1,9,Toscana
2021-05-13,MAR,12602,5694,6908,7103,5499,ITI,ITI3,11,Marche
2021-05-17,FVG,8798,4084,4714,6314,2484,ITH,ITH4,6,Friuli-Venezia Giulia
2021-03-02,VEN,11485,4622,6863,8176,3309,ITH,ITH3,5,Veneto
2021-03-09,FVG,4009,1722,2287,1262,2747,ITH,ITH4,6,Friuli-Venezia Giulia
2021-04-12,MAR,8566,3771,4795,8082,484,ITI,ITI3,11,Marche
2021-05-24,CAL,17712,8840,8872,10017,7695,ITF,ITF6,18,Calabria
2021-01-09,LIG,1335,481,854,1335,0,ITC,ITC3,7,Liguria
2021-02-15,VDA,264,136,128,229,35,ITC,ITC2,2,Valle d'Aosta / Vallée d'Aoste
2021-03-18,UMB,2967,1172,1795,1705,1262,ITI,ITI2,10,Umbria
2021-06-02,EMR,24078,12054,12024,19113,4965,ITH,ITH5,8,Emilia-Romagna
2021-04-19,LIG,12817,5613,7204,9000,3817,ITC,ITC3,7,Liguria
2021-02-12,PAB,730,217,513,482,248,ITH,ITH1,4,Provincia Autonoma Bolzano / Bozen
2021-03-23,PIE,13088,5462,7626,6843,6245,ITC,ITC1,1,Piemonte
2021-04-19,PUG,27631,12839,14792,24588,3043,ITF,ITF4,16,Puglia
2021-04-10,PAB,5391,2664,2727,4803,588,ITH,ITH1,4,Provincia Autonoma Bolzano / Bozen
2021-06-07,CAM,55692,26765,28927,51691,4001,ITF,ITF3,15,Campania
2021-04-06,UMB,5294,2170,3124,2905,2389,ITI,ITI2,10,Umbria
2021-05-20,MAR,12376,5818,6558,7679,4697,ITI,ITI3,11,Marche
2021-01-10,ABR,1139,409,730,1139,0,ITF,ITF1,13,Abruzzo
2021-05-30,VDA,865,429,436,694,171,ITC,ITC2,2,Valle d'Aosta / Vallée d'Aoste
2021-06-14,CAL,13989,6337,7652,9355,4634,ITF,ITF6,18,Calabria
2021-01-16,PIE,7771,2630,5141,7771,0,ITC,ITC1,1,Piemonte
2021-02-11,SAR,1315,490,825,1204,111,ITG,ITG2,20,Sardegna
2021-01-23,PAT,577,334,243,388,189,ITH,ITH2,4,Provincia Autonoma Trento
2021-01-30,SIC,7696,3539,4157,168,7528,ITG,ITG1,19,Sicilia
2021-03-28,UMB,1096,442,654,1072,24,ITI,ITI2,10,Umbria
2021-04-28,FVG,7284,3218,4066,3796,3488,ITH,ITH4,6,Friuli-Venezia Giulia
2021-04-29,ABR,12671,5850,6821,9576,3095,ITF,ITF1,13,Abruzzo
2021-06-05,LIG,8089,4115,3974,4937,3152,ITC,ITC3,7,Liguria
2021-01-30,UMB,1590,490,1100,44,1546,ITI,ITI2,10,Umbria
2021-04-09,LIG,12449,5557,6892,10683,1766,ITC,ITC3,7,Liguria
2021-05-03,PAT,4258,2196,2062,4104,154,ITH,ITH2,4,Provincia Autonoma Trento
2021-06-05,TOS,28411,13590,14821,20802,7609,ITI,ITI1,9,Toscana
2020-12-31,PAB,913,519,394,913,0,ITH,ITH1,4,Provincia Autonoma Bolzano / Bozen
2021-02-04,LOM,27806,8105,19701,2010,25796,ITC,ITC4,3,Lombardia
2021-03-28,SIC,10955,5144,5811,6944,4011,ITG,ITG1,19,Sicilia
2021-06-25,ABR,10742,5286,5456,4788,5954,ITF,ITF1,13,Abruzzo
2021-03-04,CAL,5483,3191,2292,4686,797,ITF,ITF6,18,Calabria
2021-02-20,LAZ,9206,4274,4932,8436,770,ITI,ITI4,12,Lazio
2021-02-25,CAM,12425,4478,7947,11237,1188,ITF,ITF3,15,Campania
2021-03-31,LIG,11923,5273,6650,9153,2770,ITC,ITC3,7,Liguria
2021-04-24,PUG,29326,13353,15973,25380,3946,ITF,ITF4,16,Puglia
2021-04-09,LOM,52325,22347,29978,36334,15991,ITC,ITC4,3,Lombardia
2021-06-12,CAL,12880,6133,6747,10484,2396,ITF,ITF6,18,Calabria
2021-05-31,LAZ,51439,22830,28609,31790,19649,ITI,ITI4,12,Lazio
2021-01-10,BAS,77,24,53,77,0,ITF,ITF5,17,Basilicata
2021-01-15,ABR,379,149,230,379,0,ITF,ITF1,13,Abruzzo
2021-02-07,MAR,1870,734,1136,344,1526,ITI,ITI3,11,Marche
2021-04-20,BAS,4033,1920,2113,2202,1831,ITF,ITF5,17,Basilicata
2021-01-11,TOS,5094,1691,3403,5094,0,ITI,ITI1,9,Toscana
2021-04-11,EMR,15276,6933,8343,12228,3048,ITH,ITH5,8,Emilia-Romagna
2021-04-19,PAB,1871,858,1013,1689,182,ITH,ITH1,4,Provincia Autonoma Bolzano / Bozen
2021-05-28,VDA,975,414,561,563,412,ITC,ITC2,2,Valle d'Aosta / Vallée d'Aoste
2021-05-24,SAR,13867,6728,7139,8481,5386,ITG,ITG2,20,Sardegna
2021-02-17,VDA,327,144,183,227,100,ITC,ITC2,2,Valle d'Aosta / Vallée d'Aoste
2021-04-21,TOS,29609,12669,16940,17519,12090,ITI,ITI1,9,Toscana
2021-04-23,VEN,31202,13821,17381,22494,8708,ITH,ITH3,5,Veneto
2021-06-15,PAB,1999,1156,843,468,1531,ITH,ITH1,4,Provincia Autonoma Bolzano / Bozen
2021-01-23,FVG,816,324,492,4,812,ITH,ITH4,6,Friuli-Venezia Giulia
2021-02-13,SAR,1456,565,891,1454,2,ITG,ITG2,20,Sardegna
2021-02-23,TOS,7722,3325,4397,7561,161,ITI,ITI1,9,Toscana
2021-04-04,LAZ,17534,8105,9429,12268,5266,ITI,ITI4,12,Lazio
2021-04-09,CAM,30038,14147,15891,23909,6129,ITF,ITF3,15,Campania
2021-04-05,MOL,391,189,202,292,99,ITF,ITF2,14,Molise
2021-05-05,PAT,4987,2579,2408,4690,297,ITH,ITH2,4,Provincia Autonoma Trento
2021-06-03,TOS,31981,15408,16573,27434,4547,ITI,ITI1,9,Toscana
2021-06-05,CAM,77025,37282,39743,71004,6021,ITF,ITF3,15,Campania
2021-01-08,BAS,554,219,335,554,0,ITF,ITF5,17,Basilicata
2021-03-29,MOL,2033,835,1198,1547,486,ITF,ITF2,14,Molise
2021-02-16,VEN,6643,2870,3773,6467,176,ITH,ITH3,5,Veneto
2021-04-04,LOM,7611,3230,4381,3716,3895,ITC,ITC4,3,Lombardia
2021-01-31,MOL,268,70,198,6,262,ITF,ITF2,14,Molise
2021-02-11,EMR,4254,1415,2839,3413,841,ITH,ITH5,8,Emilia-Romagna
2021-04-27,ABR,9084,4368,4716,6617,2467,ITF,ITF1,13,Abruzzo
2021-06-14,CAM,36687,17713,18974,18713,17974,ITF,ITF3,15,Campania
2021-03-15,BAS,2356,983,1373,524,1832,ITF,ITF5,17,Basilicata
2021-05-29,SAR,17996,8650,9346,13403,4593,ITG,ITG2,20,Sardegna
2021-01-16,PAT,319,148,171,319,0,ITH,ITH2,4,Provincia Autonoma Trento
2021-01-17,BAS,328,133,195,327,1,ITF,ITF5,17,Basilicata
2021-05-05,FVG,9751,4259,5492,6283,3468,ITH,ITH4,6,Friuli-Venezia Giulia
2021-02-18,SAR,1878,732,1146,1814,64,ITG,ITG2,20,Sardegna
2021-04-04,SIC,6810,3323,3487,5518,1292,ITG,ITG1,19,Sicilia
2021-01-23,PIE,4257,1325,2932,879,3378,ITC,ITC1,1,Piemonte
2021-04-17,PAB,5233,2599,2634,5189,44,ITH,ITH1,4,Provincia Autonoma Bolzano / Bozen
2021-01-07,PAB,918,327,591,918,0,ITH,ITH1,4,Provincia Autonoma Bolzano / Bozen
2021-01-14,PUG,4072,1590,2482,4072,0,ITF,ITF4,16,Puglia
2021-03-21,PIE,10727,4741,5986,4194,6533,ITC,ITC1,1,Piemonte
2021-01-07,PUG,5717,2459,3258,5717,0,ITF,ITF4,16,Puglia
2021-01-31,MAR,1918,769,1149,103,1815,ITI,ITI3,11,Marche
2021-04-02,LOM,41168,16843,24325,26719,14449,ITC,ITC4,3,Lombardia
2021-04-17,PUG,39937,18929,21008,36369,3568,ITF,ITF4,16,Puglia
2021-02-25,CAL,2885,1552,1333,2290,595,ITF,ITF6,18,Calabria
2021-05-29,VEN,32975,16659,16316,25318,7657,ITH,ITH3,5,Veneto
2020-12-28,LIG,80,30,50,80,0,ITC,ITC3,7,Liguria
2021-01-25,FVG,1583,567,1016,194,1389,ITH,ITH4,6,Friuli-Venezia Giulia
2021-02-19,PUG,4732,2011,2721,4340,392,ITF,ITF4,16,Puglia
2021-04-27,BAS,4727,2242,2485,4402,325,ITF,ITF5,17,Basilicata
2021-06-03,LIG,15473,7668,7805,9134,6339,ITC,ITC3,7,Liguria
2021-03-23,FVG,3887,1681,2206,1746,2141,ITH,ITH4,6,Friuli-Venezia Giulia
2021-04-07,LIG,13666,6100,7566,11377,2289,ITC,ITC3,7,Liguria
2021-03-15,ABR,3684,1448,2236,1876,1808,ITF,ITF1,13,Abruzzo
2021-04-07,MAR,7812,3436,4376,7477,335,ITI,ITI3,11,Marche
2021-02-10,VDA,248,77,171,141,107,ITC,ITC2,2,Valle d'Aosta / Vallée d'Aoste
2021-01-17,ABR,188,59,129,181,7,ITF,ITF1,13,Abruzzo
2021-02-09,MAR,124,42,82,46,78,ITI,ITI3,11,Marche
2021-02-23,LIG,3806,1559,2247,3697,109,ITC,ITC3,7,Liguria
2021-05-12,UMB,6495,3025,3470,4349,2146,ITI,ITI2,10,Umbria
2021-06-22,PUG,40228,19497,20731,18591,21637,ITF,ITF4,16,Puglia
2021-02-07,MOL,66,32,34,19,47,ITF,ITF2,14,Molise
2021-05-18,MOL,1645,877,768,990,655,ITF,ITF2,14,Molise
2021-05-19,PIE,33125,15293,17832,22015,11110,ITC,ITC1,1,Piemonte
2021-02-13,SIC,2976,1122,1854,2721,255,ITG,ITG1,19,Sicilia
2021-05-24,LOM,89497,43475,46022,49513,39984,ITC,ITC4,3,Lombardia
2021-03-22,MOL,1148,440,708,905,243,ITF,ITF2,14,Molise
2021-02-18,EMR,7039,2892,4147,6456,583,ITH,ITH5,8,Emilia-Romagna
2021-05-04,BAS,4137,1991,2146,3614,523,ITF,ITF5,17,Basilicata
2021-03-14,PIE,8205,3336,4869,5308,2897,ITC,ITC1,1,Piemonte
2021-04-09,SAR,12303,5470,6833,7951,4352,ITG,ITG2,20,Sardegna
2021-03-08,BAS,1459,712,747,846,613,ITF,ITF5,17,Basilicata
2021-06-24,FVG,10568,5342,5226,1877,8691,ITH,ITH4,6,Friuli-Venezia Giulia
2021-05-10,PIE,28935,13952,14983,15830,13105,ITC,ITC1,1,Piemonte
2021-06-06,PAB,4530,2176,2354,855,3675,ITH,ITH1,4,Provincia Autonoma Bolzano / Bozen
2021-05-24,SIC,35681,17295,18386,15703,19978,ITG,ITG1,19,Sicilia
2021-01-30,PIE,5980,2136,3844,218,5762,ITC,ITC1,1,Piemonte
2021-02-26,PAB,1526,551,975,1496,30,ITH,ITH1,4,Provincia Autonoma Bolzano / Bozen
2021-03-05,PUG,17683,7166,10517,15380,2303,ITF,ITF4,16,Puglia
2021-02-11,LOM,17071,5007,12064,9702,7369,ITC,ITC4,3,Lombardia
2021-04-07,TOS,35819,15459,20360,28571,7248,ITI,ITI1,9,Toscana
2021-01-06,CAL,931,502,429,931,0,ITF,ITF6,18,Calabria
2021-02-26,PUG,13762,5054,8708,12728,1034,ITF,ITF4,16,Puglia
2020-12-31,PUG,1634,782,852,1634,0,ITF,ITF4,16,Puglia
2021-02-16,LIG,2426,956,1470,2004,422,ITC,ITC3,7,Liguria
2021-03-16,FVG,3155,1288,1867,1074,2081,ITH,ITH4,6,Friuli-Venezia Giulia
2021-06-16,BAS,4590,2082,2508,2136,2454,ITF,ITF5,17,Basilicata
2021-05-12,FVG,10863,5031,5832,9458,1405,ITH,ITH4,6,Friuli-Venezia Giulia
2021-05-27,LIG,16863,8642,8221,12725,4138,ITC,ITC3,7,Liguria
2021-02-25,VEN,7898,3339,4559,7293,605,ITH,ITH3,5,Veneto
2021-03-09,PAT,1582,590,992,938,644,ITH,ITH2,4,Provincia Autonoma Trento
2021-03-23,UMB,3797,1685,2112,2168,1629,ITI,ITI2,10,Umbria
2021-05-04,ABR,10748,5049,5699,7132,3616,ITF,ITF1,13,Abruzzo
2021-05-17,LAZ,44495,20362,24133,35930,8565,ITI,ITI4,12,Lazio
2021-05-27,MAR,13730,6816,6914,9429,4301,ITI,ITI3,11,Marche
2021-06-07,EMR,40378,20723,19655,34131,6247,ITH,ITH5,8,Emilia-Romagna
2021-06-17,PAT,6574,3449,3125,2108,4466,ITH,ITH2,4,Provincia Autonoma Trento
2021-02-11,CAM,6279,2704,3575,6213,66,ITF,ITF3,15,Campania
2021-03-08,ABR,5148,1693,3455,4178,970,ITF,ITF1,13,Abruzzo
2021-03-31,MAR,7373,3085,4288,4349,3024,ITI,ITI3,11,Marche
2021-04-14,LIG,13067,5666,7401,10864,2203,ITC,ITC3,7,Liguria
2021-02-03,VDA,351,114,237,14,337,ITC,ITC2,2,Valle d'Aosta / Vallée d'Aoste
2021-04-09,VEN,31191,13759,17432,22847,8344,ITH,ITH3,5,Veneto
2021-04-16,CAL,10212,4978,5234,8627,1585,ITF,ITF6,18,Calabria
2021-06-01,PAB,3557,2316,1241,2085,1472,ITH,ITH1,4,Provincia Autonoma Bolzano / Bozen
2021-02-08,UMB,637,203,434,88,549,ITI,ITI2,10,Umbria
2021-04-11,SAR,5394,2443,2951,4274,1120,ITG,ITG2,20,Sardegna
2021-06-24,PIE,38674,19325,19349,18723,19951,ITC,ITC1,1,Piemonte
2021-02-18,CAL,1836,836,1000,1610,226,ITF,ITF6,18,Calabria
2021-04-01,VDA,776,394,382,764,12,ITC,ITC2,2,Valle d'Aosta / Vallée d'Aoste
2021-06-05,VEN,46673,24043,22630,38652,8021,ITH,ITH3,5,Veneto
2021-01-24,ABR,50,22,28,6,44,ITF,ITF1,13,Abruzzo
2021-02-06,LAZ,6161,2493,3668,840,5321,ITI,ITI4,12,Lazio
2021-03-16,PIE,10523,4269,6254,4463,6060,ITC,ITC1,1,Piemonte
2021-05-19,UMB,9421,4212,5209,5674,3747,ITI,ITI2,10,Umbria
2021-06-07,SAR,12556,6142,6414,9554,3002,ITG,ITG2,20,Sardegna
2021-06-15,PUG,42036,20553,21483,22536,19500,ITF,ITF4,16,Puglia
2021-06-08,PUG,38910,18918,19992,21221,17689,ITF,ITF4,16,Puglia
2021-05-12,PIE,31900,15197,16703,18997,12903,ITC,ITC1,1,Piemonte
2021-02-19,PAB,2252,512,1740,2241,11,ITH,ITH1,4,Provincia Autonoma Bolzano / Bozen
2021-05-29,LIG,6863,3251,3612,3993,2870,ITC,ITC3,7,Liguria
2021-05-31,LOM,95611,47385,48226,79440,16171,ITC,ITC4,3,Lombardia
2021-06-21,CAL,15052,6907,8145,7721,7331,ITF,ITF6,18,Calabria
2021-02-04,SAR,2272,816,1456,916,1356,ITG,ITG2,20,Sardegna
2021-03-01,ABR,3478,1385,2093,2727,751,ITF,ITF1,13,Abruzzo
2021-04-02,SAR,8991,3548,5443,5750,3241,ITG,ITG2,20,Sardegna
2021-02-06,UMB,396,138,258,34,362,ITI,ITI2,10,Umbria
2021-03-14,PAT,108,65,43,21,87,ITH,ITH2,4,Provincia Autonoma Trento
2021-05-17,SIC,31898,15378,16520,19230,12668,ITG,ITG1,19,Sicilia
2021-06-12,TOS,29380,15145,14235,24993,4387,ITI,ITI1,9,Toscana
2021-03-21,SIC,15217,7340,7877,11248,3969,ITG,ITG1,19,Sicilia
2021-04-16,TOS,28954,12887,16067,22046,6908,ITI,ITI1,9,Toscana
2021-06-18,ABR,10117,4976,5141,6653,3464,ITF,ITF1,13,Abruzzo
2021-03-26,LOM,41280,15689,25591,28145,13135,ITC,ITC4,3,Lombardia
2021-01-04,CAL,1065,527,538,1065,0,ITF,ITF6,18,Calabria
2021-02-06,SIC,4694,2093,2601,1466,3228,ITG,ITG1,19,Sicilia
2021-05-22,LOM,70555,33825,36730,32421,38134,ITC,ITC4,3,Lombardia
2021-02-11,LAZ,7001,3013,3988,6467,534,ITI,ITI4,12,Lazio
2021-05-20,MOL,2660,1370,1290,2474,186,ITF,ITF2,14,Molise
2021-02-09,LIG,1937,689,1248,257,1680,ITC,ITC3,7,Liguria
2021-04-11,LAZ,19154,8469,10685,13273,5881,ITI,ITI4,12,Lazio
2021-04-16,CAM,34322,16560,17762,23657,10665,ITF,ITF3,15,Campania
2021-05-19,FVG,12016,5928,6088,9678,2338,ITH,ITH4,6,Friuli-Venezia Giulia
2021-06-09,BAS,4423,2072,2351,3999,424,ITF,ITF5,17,Basilicata
2021-06-13,PUG,21382,10695,10687,16213,5169,ITF,ITF4,16,Puglia
2021-04-23,CAL,12989,6369,6620,9451,3538,ITF,ITF6,18,Calabria
2021-01-06,CAM,7652,3749,3903,7652,0,ITF,ITF3,15,Campania
2021-02-13,LAZ,6611,2627,3984,6194,417,ITI,ITI4,12,Lazio
2021-04-13,BAS,2113,1051,1062,1295,818,ITF,ITF5,17,Basilicata
2021-05-29,LOM,88261,42395,45866,42238,46023,ITC,ITC4,3,Lombardia
2021-02-18,LOM,14049,4924,9125,13013,1036,ITC,ITC4,3,Lombardia
2021-03-07,PAT,22,6,16,22,0,ITH,ITH2,4,Provincia Autonoma Trento
2021-03-01,BAS,548,284,264,382,166,ITF,ITF5,17,Basilicata
2021-03-29,MAR,5862,2567,3295,3436,2426,ITI,ITI3,11,Marche
2021-01-09,PAT,190,40,150,190,0,ITH,ITH2,4,Provincia Autonoma Trento
2021-01-13,CAL,2044,1031,1013,2044,0,ITF,ITF6,18,Calabria
2021-02-24,VDA,183,82,101,164,19,ITC,ITC2,2,Valle d'Aosta / Vallée d'Aoste
2021-05-31,EMR,29720,13743,15977,18259,11461,ITH,ITH5,8,Emilia-Romagna
2021-03-02,SIC,14665,6304,8361,11892,2773,ITG,ITG1,19,Sicilia
2021-05-30,ABR,8612,4094,4518,5398,3214,ITF,ITF1,13,Abruzzo
2021-03-09,SAR,5547,2742,2805,4818,729,ITG,ITG2,20,Sardegna
2021-01-04,SIC,8252,4120,4132,8252,0,ITG,ITG1,19,Sicilia
2021-04-03,ABR,5160,2257,2903,3563,1597,ITF,ITF1,13,Abruzzo
2021-01-28,LIG,2847,971,1876,39,2808,ITC,ITC3,7,Liguria
2021-02-11,PIE,6764,2107,4657,3006,3758,ITC,ITC1,1,Piemonte
2021-05-05,SAR,10159,4645,5514,8149,2010,ITG,ITG2,20,Sardegna
2021-01-18,SIC,1447,586,861,1295,152,ITG,ITG1,19,Sicilia
2021-01-23,VEN,4051,1246,2805,31,4020,ITH,ITH3,5,Veneto
2021-01-26,PAB,810,291,519,1,809,ITH,ITH1,4,Provincia Autonoma Bolzano / Bozen
2021-04-09,PIE,25851,11388,14463,21344,4507,ITC,ITC1,1,Piemonte
2021-06-24,CAM,64594,31012,33582,12701,51893,ITF,ITF3,15,Campania
2021-03-21,VEN,11980,4752,7228,8518,3462,ITH,ITH3,5,Veneto
2021-04-28,SIC,29211,13700,15511,20131,9080,ITG,ITG1,19,Sicilia
2020-12-30,PIE,730,322,408,730,0,ITC,ITC1,1,Piemonte
2021-03-16,CAM,8086,3519,4567,3772,4314,ITF,ITF3,15,Campania
2021-03-24,PAB,2063,998,1065,2050,13,ITH,ITH1,4,Provincia Autonoma Bolzano / Bozen
2021-06-05,PIE,36913,18913,18000,32456,4457,ITC,ITC1,1,Piemonte
2021-04-28,LOM,95662,43640,52022,68780,26882,ITC,ITC4,3,Lombardia
2021-06-22,TOS,30922,15539,15383,22795,8127,ITI,ITI1,9,Toscana
2021-02-25,PIE,12218,5252,6966,11671,547,ITC,ITC1,1,Piemonte
2021-06-24,LOM,105833,54800,51033,77758,28075,ITC,ITC4,3,Lombardia
2021-03-16,LAZ,13546,5740,7806,7102,6444,ITI,ITI4,12,Lazio
2021-03-16,LOM,25484,10113,15371,16417,9067,ITC,ITC4,3,Lombardia
2021-01-23,EMR,2448,871,1577,443,2005,ITH,ITH5,8,Emilia-Romagna
2021-05-12,LOM,87458,41736,45722,59912,27546,ITC,ITC4,3,Lombardia
2021-01-21,MAR,917,261,656,591,326,ITI,ITI3,11,Marche
2021-05-30,BAS,2773,1419,1354,922,1851,ITF,ITF5,17,Basilicata
2021-04-09,PAT,2739,1162,1577,1539,1200,ITH,ITH2,4,Provincia Autonoma Trento
2021-05-02,VDA,765,345,420,605,160,ITC,ITC2,2,Valle d'Aosta / Vallée d'Aoste
2021-05-07,EMR,35262,16958,18304,23411,11851,ITH,ITH5,8,Emilia-Romagna
2021-05-17,TOS,29681,14804,14877,20810,8871,ITI,ITI1,9,Toscana
2021-02-18,FVG,3218,1492,1726,2811,407,ITH,ITH4,6,Friuli-Venezia Giulia
2021-04-03,BAS,1808,748,1060,1471,337,ITF,ITF5,17,Basilicata
2021-05-01,MAR,9318,3924,5394,3576,5742,ITI,ITI3,11,Marche
2021-01-22,VDA,56,21,35,20,36,ITC,ITC2,2,Valle d'Aosta / Vallée d'Aoste
2021-02-11,PAT,1133,365,768,796,337,ITH,ITH2,4,Provincia Autonoma Trento
2021-03-21,TOS,3293,1627,1666,1860,1433,ITI,ITI1,9,Toscana
2021-02-09,PUG,3840,1570,2270,2168,1672,ITF,ITF4,16,Puglia
2021-03-09,LAZ,21949,9904,12045,16750,5199,ITI,ITI4,12,Lazio
2021-01-08,VDA,299,130,169,299,0,ITC,ITC2,2,Valle d'Aosta / Vallée d'Aoste
2021-01-23,TOS,3966,1360,2606,640,3326,ITI,ITI1,9,Toscana
2021-02-25,PAT,1641,643,998,1200,441,ITH,ITH2,4,Provincia Autonoma Trento
2021-01-11,LAZ,5542,2109,3433,5542,0,ITI,ITI4,12,Lazio
2021-04-02,FVG,6590,2925,3665,4752,1838,ITH,ITH4,6,Friuli-Venezia Giulia
2021-05-20,PUG,33530,15207,18323,21192,12338,ITF,ITF4,16,Puglia
2021-06-14,UMB,5362,2742,2620,3362,2000,ITI,ITI2,10,Umbria
2020-12-30,PAT,7,3,4,7,0,ITH,ITH2,4,Provincia Autonoma Trento
2021-03-06,VDA,22,4,18,22,0,ITC,ITC2,2,Valle d'Aosta / Vallée d'Aoste
2021-05-03,TOS,11933,5510,6423,10615,1318,ITI,ITI1,9,Toscana
2021-06-05,PAT,4080,1915,2165,751,3329,ITH,ITH2,4,Provincia Autonoma Trento
2021-01-25,CAM,5746,2927,2819,163,5583,ITF,ITF3,15,Campania
2021-03-24,PUG,13452,6401,7051,6146,7306,ITF,ITF4,16,Puglia
2021-01-12,MOL,336,114,222,336,0,ITF,ITF2,14,Molise
2021-01-16,VEN,4611,1542,3069,4611,0,ITH,ITH3,5,Veneto
2021-02-01,CAL,2516,1199,1317,244,2272,ITF,ITF6,18,Calabria
2021-03-10,PAB,1268,529,739,1125,143,ITH,ITH1,4,Provincia Autonoma Bolzano / Bozen
2021-01-26,PUG,5362,2397,2965,571,4791,ITF,ITF4,16,Puglia
2021-03-23,CAM,15740,7443,8297,13227,2513,ITF,ITF3,15,Campania
2021-03-14,VEN,15176,5942,9234,14282,894,ITH,ITH3,5,Veneto
2021-05-06,PAB,5181,2747,2434,2613,2568,ITH,ITH1,4,Provincia Autonoma Bolzano / Bozen
2021-05-12,CAL,16389,7992,8397,10908,5481,ITF,ITF6,18,Calabria
2021-02-05,BAS,986,443,543,64,922,ITF,ITF5,17,Basilicata
2021-03-05,MAR,6171,2856,3315,4703,1468,ITI,ITI3,11,Marche
2021-04-16,FVG,6917,2997,3920,4993,1924,ITH,ITH4,6,Friuli-Venezia Giulia
2021-05-06,PUG,39539,17290,22249,19864,19675,ITF,ITF4,16,Puglia
2021-05-19,CAM,51098,22554,28544,34534,16564,ITF,ITF3,15,Campania
2021-02-24,MOL,666,278,388,333,333,ITF,ITF2,14,Molise
2021-05-22,PAT,3256,1596,1660,924,2332,ITH,ITH2,4,Provincia Autonoma Trento
2021-05-26,CAL,18659,9279,9380,10394,8265,ITF,ITF6,18,Calabria
2021-01-06,FVG,710,264,446,710,0,ITH,ITH4,6,Friuli-Venezia Giulia
2021-01-07,MAR,1808,636,1172,1808,0,ITI,ITI3,11,Marche
2021-01-21,LIG,1106,385,721,675,431,ITC,ITC3,7,Liguria
2021-03-02,SAR,3061,1640,1421,1908,1153,ITG,ITG2,20,Sardegna
2021-05-16,BAS,4972,2468,2504,2859,2113,ITF,ITF5,17,Basilicata
2021-03-30,CAL,6212,2666,3546,3471,2741,ITF,ITF6,18,Calabria
2021-04-02,PIE,20142,8303,11839,11715,8427,ITC,ITC1,1,Piemonte
2021-04-28,SAR,9024,4282,4742,5321,3703,ITG,ITG2,20,Sardegna
2021-02-12,ABR,1229,568,661,1039,190,ITF,ITF1,13,Abruzzo
2021-01-18,SAR,904,326,578,780,124,ITG,ITG2,20,Sardegna
2021-05-29,PIE,32781,15222,17559,20623,12158,ITC,ITC1,1,Piemonte
2021-06-24,SAR,19166,9203,9963,8213,10953,ITG,ITG2,20,Sardegna
2021-02-23,SIC,8685,4590,4095,8219,466,ITG,ITG1,19,Sicilia
2021-05-23,ABR,9881,4696,5185,7189,2692,ITF,ITF1,13,Abruzzo
2021-02-18,PIE,4791,2094,2697,4361,430,ITC,ITC1,1,Piemonte
2021-03-16,SAR,4374,1949,2425,3452,922,ITG,ITG2,20,Sardegna
2021-03-17,PAB,581,213,368,580,1,ITH,ITH1,4,Provincia Autonoma Bolzano / Bozen
2021-03-09,SIC,13081,5702,7379,10882,2199,ITG,ITG1,19,Sicilia
2021-05-10,VEN,36461,17046,19415,26600,9861,ITH,ITH3,5,Veneto
2021-06-06,ABR,11022,5255,5767,8832,2190,ITF,ITF1,13,Abruzzo
2021-04-16,PIE,28403,13213,15190,23417,4986,ITC,ITC1,1,Piemonte
2021-05-05,CAM,51168,24855,26313,44786,6382,ITF,ITF3,15,Campania
2021-05-13,PAB,2994,1355,1639,1064,1930,ITH,ITH1,4,Provincia Autonoma Bolzano / Bozen
2021-01-11,SIC,5805,2558,3247,5805,0,ITG,ITG1,19,Sicilia
2021-01-30,VEN,8747,2672,6075,693,8054,ITH,ITH3,5,Veneto
2021-04-10,ABR,8773,4057,4716,6265,2508,ITF,ITF1,13,Abruzzo
2021-01-12,PUG,4215,1772,2443,4215,0,ITF,ITF4,16,Puglia
2021-02-16,LOM,9505,3073,6432,9057,448,ITC,ITC4,3,Lombardia
2021-03-02,CAM,12761,4558,8203,8416,4345,ITF,ITF3,15,Campania
2021-05-20,PAB,4723,2334,2389,3254,1469,ITH,ITH1,4,Provincia Autonoma Bolzano / Bozen
2021-01-11,CAL,2164,1046,1118,2164,0,ITF,ITF6,18,Calabria
2020-12-27,ABR,37,19,18,37,0,ITF,ITF1,13,Abruzzo
2021-01-25,CAL,1072,514,558,147,925,ITF,ITF6,18,Calabria
2021-06-10,LOM,101529,51678,49851,87180,14349,ITC,ITC4,3,Lombardia
2021-06-24,SIC,41396,19153,22243,17139,24257,ITG,ITG1,19,Sicilia
2021-01-15,BAS,813,350,463,813,0,ITF,ITF5,17,Basilicata
2021-02-11,LIG,1979,767,1212,1103,876,ITC,ITC3,7,Liguria
2021-03-02,LOM,22803,9698,13105,19769,3034,ITC,ITC4,3,Lombardia
2021-05-05,CAL,13602,6511,7091,8493,5109,ITF,ITF6,18,Calabria
2021-03-23,SAR,6413,2879,3534,5335,1078,ITG,ITG2,20,Sardegna
2021-05-22,LIG,6645,3218,3427,4962,1683,ITC,ITC3,7,Liguria
2021-06-07,SIC,49511,23356,26155,41618,7893,ITG,ITG1,19,Sicilia
2021-01-16,TOS,3271,1046,2225,3271,0,ITI,ITI1,9,Toscana
2021-03-20,ABR,4792,2198,2594,2621,2171,ITF,ITF1,13,Abruzzo
2021-04-16,EMR,29222,13763,15459,20386,8836,ITH,ITH5,8,Emilia-Romagna
2021-01-06,EMR,8287,2955,5332,8287,0,ITH,ITH5,8,Emilia-Romagna
2021-04-26,TOS,10151,4943,5208,7598,2553,ITI,ITI1,9,Toscana
2021-04-03,VDA,676,341,335,661,15,ITC,ITC2,2,Valle d'Aosta / Vallée d'Aoste
2021-04-04,VEN,7776,3530,4246,6627,1149,ITH,ITH3,5,Veneto
2021-02-13,UMB,115,28,87,112,3,ITI,ITI2,10,Umbria
2021-03-20,VDA,208,86,122,172,36,ITC,ITC2,2,Valle d'Aosta / Vallée d'Aoste
2021-03-30,LAZ,26789,12953,13836,19640,7149,ITI,ITI4,12,Lazio
2021-06-19,PIE,39662,20030,19632,23076,16586,ITC,ITC1,1,Piemonte
2021-01-02,TOS,3497,1096,2401,3497,0,ITI,ITI1,9,Toscana
2021-04-30,EMR,36601,16786,19815,21808,14793,ITH,ITH5,8,Emilia-Romagna
2021-05-24,UMB,9054,4509,4545,8177,877,ITI,ITI2,10,Umbria
2021-04-18,UMB,1530,680,850,600,930,ITI,ITI2,10,Umbria
2021-01-11,UMB,1315,346,969,1315,0,ITI,ITI2,10,Umbria
2021-03-28,EMR,13499,6025,7474,9629,3870,ITH,ITH5,8,Emilia-Romagna
2021-04-07,PUG,15550,6992,8558,8875,6675,ITF,ITF4,16,Puglia
2020-12-27,BAS,106,41,65,106,0,ITF,ITF5,17,Basilicata
2021-01-26,MOL,450,184,266,8,442,ITF,ITF2,14,Molise
2021-02-04,FVG,2725,808,1917,35,2690,ITH,ITH4,6,Friuli-Venezia Giulia
2021-05-15,MAR,13966,6376,7590,8077,5889,ITI,ITI3,11,Marche
2021-05-05,UMB,7206,3296,3910,3904,3302,ITI,ITI2,10,Umbria
2021-05-06,MOL,2679,1214,1465,2081,598,ITF,ITF2,14,Molise
2021-06-11,VDA,1047,483,564,764,283,ITC,ITC2,2,Valle d'Aosta / Vallée d'Aoste
2021-04-18,LAZ,23808,10577,13231,16158,7650,ITI,ITI4,12,Lazio
2021-03-20,BAS,1294,573,721,281,1013,ITF,ITF5,17,Basilicata
2021-01-25,SIC,7418,3675,3743,295,7123,ITG,ITG1,19,Sicilia
2021-06-10,LIG,18150,9365,8785,12540,5610,ITC,ITC3,7,Liguria
2021-02-19,MAR,1965,713,1252,1830,135,ITI,ITI3,11,Marche
2021-04-30,FVG,7330,3235,4095,3693,3637,ITH,ITH4,6,Friuli-Venezia Giulia
2021-06-13,ABR,9691,4859,4832,7857,1834,ITF,ITF1,13,Abruzzo
2021-01-25,UMB,648,323,325,5,643,ITI,ITI2,10,Umbria
2021-05-05,SIC,26289,12194,14095,16672,9617,ITG,ITG1,19,Sicilia
2021-03-19,LIG,5296,2234,3062,2150,3146,ITC,ITC3,7,Liguria
2021-05-19,SIC,42658,20651,22007,28319,14339,ITG,ITG1,19,Sicilia
2021-02-04,PIE,10206,3341,6865,588,9618,ITC,ITC1,1,Piemonte
2021-03-02,LIG,4074,1689,2385,3764,310,ITC,ITC3,7,Liguria
2021-03-26,PAT,3229,1256,1973,2619,610,ITH,ITH2,4,Provincia Autonoma Trento
2021-01-11,CAM,4070,1871,2199,4070,0,ITF,ITF3,15,Campania
2021-03-31,PAB,1832,694,1138,821,1011,ITH,ITH1,4,Provincia Autonoma Bolzano / Bozen
2020-12-28,LOM,107,47,60,107,0,ITC,ITC4,3,Lombardia
2021-03-02,CAL,4366,2489,1877,3611,755,ITF,ITF6,18,Calabria
2021-05-24,VEN,33019,16402,16617,8020,24999,ITH,ITH3,5,Veneto
2021-06-24,LIG,10733,5225,5508,6536,4197,ITC,ITC3,7,Liguria
2021-03-16,CAL,3848,1889,1959,2188,1660,ITF,ITF6,18,Calabria
2021-03-06,BAS,1357,536,821,760,597,ITF,ITF5,17,Basilicata
2021-04-02,LIG,11774,5210,6564,9287,2487,ITC,ITC3,7,Liguria
2021-05-12,SAR,11136,5261,5875,7997,3139,ITG,ITG2,20,Sardegna
2021-04-21,LOM,71738,32523,39215,57128,14610,ITC,ITC4,3,Lombardia
2021-05-23,VDA,999,465,534,658,341,ITC,ITC2,2,Valle d'Aosta / Vallée d'Aoste
2021-01-11,LOM,16256,5378,10878,16256,0,ITC,ITC4,3,Lombardia
2021-02-25,EMR,9250,3499,5751,8296,954,ITH,ITH5,8,Emilia-Romagna
2021-03-07,TOS,5647,2357,3290,2104,3543,ITI,ITI1,9,Toscana
2021-06-19,PAT,3097,1695,1402,255,2842,ITH,ITH2,4,Provincia Autonoma Trento
2021-01-28,LOM,12223,3703,8520,801,11422,ITC,ITC4,3,Lombardia
2021-01-29,VDA,318,138,180,2,316,ITC,ITC2,2,Valle d'Aosta / Vallée d'Aoste
2021-04-30,PIE,31813,14313,17500,18478,13335,ITC,ITC1,1,Piemonte
2021-05-19,LAZ,47114,21626,25488,37015,10099,ITI,ITI4,12,Lazio
2021-06-19,EMR,35964,18001,17963,16640,19324,ITH,ITH5,8,Emilia-Romagna
2021-04-04,UMB,59,20,39,23,36,ITI,ITI2,10,Umbria
2021-01-29,ABR,1387,449,938,74,1313,ITF,ITF1,13,Abruzzo
2021-03-11,EMR,17453,7306,10147,11602,5851,ITH,ITH5,8,Emilia-Romagna
2021-04-22,VDA,1068,450,618,685,383,ITC,ITC2,2,Valle d'Aosta / Vallée d'Aoste
2021-06-07,UMB,6939,3426,3513,6248,691,ITI,ITI2,10,Umbria
2021-05-09,VDA,574,287,287,444,130,ITC,ITC2,2,Valle d'Aosta / Vallée d'Aoste
2021-01-04,LAZ,7484,2909,4575,7484,0,ITI,ITI4,12,Lazio
2021-02-06,EMR,7581,2401,5180,2110,5471,ITH,ITH5,8,Emilia-Romagna
2021-03-16,UMB,3539,1454,2085,1912,1627,ITI,ITI2,10,Umbria
2021-03-17,MOL,908,385,523,576,332,ITF,ITF2,14,Molise
2021-05-27,PUG,40486,19101,21385,23279,17207,ITF,ITF4,16,Puglia
2021-06-24,LAZ,62147,29360,32787,28775,33372,ITI,ITI4,12,Lazio
2021-06-07,LAZ,62090,28987,33103,32997,29093,ITI,ITI4,12,Lazio
2021-06-25,MOL,3193,1567,1626,1485,1708,ITF,ITF2,14,Molise
2021-02-27,UMB,1658,354,1304,1642,16,ITI,ITI2,10,Umbria
2021-04-21,LIG,14246,6433,7813,8919,5327,ITC,ITC3,7,Liguria
2020-12-28,SAR,65,25,40,65,0,ITG,ITG2,20,Sardegna
2020-12-31,MAR,390,183,207,390,0,ITI,ITI3,11,Marche
2021-02-11,CAL,2333,1042,1291,1082,1251,ITF,ITF6,18,Calabria
2021-05-09,BAS,4683,2339,2344,2989,1694,ITF,ITF5,17,Basilicata
2021-06-08,MOL,2885,1593,1292,2189,696,ITF,ITF2,14,Molise
2021-01-26,MAR,2018,746,1272,91,1927,ITI,ITI3,11,Marche
2021-03-09,CAL,6371,3277,3094,5390,981,ITF,ITF6,18,Calabria
2021-05-17,VEN,26476,12973,13503,16463,10013,ITH,ITH3,5,Veneto
2021-03-26,LIG,9326,4021,5305,6171,3155,ITC,ITC3,7,Liguria
2021-03-28,LOM,20480,7816,12664,14317,6163,ITC,ITC4,3,Lombardia
2021-04-11,SIC,15362,7590,7772,8332,7030,ITG,ITG1,19,Sicilia
2021-05-22,TOS,26005,12651,13354,21725,4280,ITI,ITI1,9,Toscana
2021-02-06,VEN,4095,1354,2741,709,3386,ITH,ITH3,5,Veneto
2021-04-14,LOM,47152,21015,26137,34186,12966,ITC,ITC4,3,Lombardia
2021-02-20,CAL,1429,763,666,1110,319,ITF,ITF6,18,Calabria
2021-05-26,LAZ,47450,21789,25661,35355,12095,ITI,ITI4,12,Lazio
2021-01-02,LIG,691,245,446,691,0,ITC,ITC3,7,Liguria
2021-01-04,LOM,6099,2102,3997,6099,0,ITC,ITC4,3,Lombardia
2021-01-30,FVG,2276,745,1531,270,2006,ITH,ITH4,6,Friuli-Venezia Giulia
2021-03-04,LAZ,19406,8713,10693,14388,5018,ITI,ITI4,12,Lazio
2021-04-21,PAT,2910,1359,1551,2860,50,ITH,ITH2,4,Provincia Autonoma Trento
2021-05-05,TOS,30123,13445,16678,15647,14476,ITI,ITI1,9,Toscana
2021-06-12,LAZ,63720,29019,34701,34384,29336,ITI,ITI4,12,Lazio
2021-04-24,PAB,5104,2449,2655,4619,485,ITH,ITH1,4,Provincia Autonoma Bolzano / Bozen
2021-02-05,VDA,294,102,192,101,193,ITC,ITC2,2,Valle d'Aosta / Vallée d'Aoste
2021-02-07,PUG,1579,669,910,253,1326,ITF,ITF4,16,Puglia
2021-05-19,SAR,16408,8157,8251,12760,3648,ITG,ITG2,20,Sardegna
2021-01-21,PUG,2132,904,1228,1271,861,ITF,ITF4,16,Puglia
2021-01-22,ABR,118,57,61,118,0,ITF,ITF1,13,Abruzzo
2021-02-22,VDA,316,94,222,213,103,ITC,ITC2,2,Valle d'Aosta / Vallée d'Aoste
2021-03-28,CAM,15554,7504,8050,13929,1625,ITF,ITF3,15,Campania
2021-04-23,PIE,27447,12603,14844,20685,6762,ITC,ITC1,1,Piemonte
2021-02-28,TOS,1649,667,982,922,727,ITI,ITI1,9,Toscana
2021-05-01,PUG,27605,12641,14964,16955,10650,ITF,ITF4,16,Puglia
2021-06-05,SAR,17827,8413,9414,11378,6449,ITG,ITG2,20,Sardegna
2021-02-23,VEN,7383,3254,4129,7112,271,ITH,ITH3,5,Veneto
2021-04-19,MAR,9601,4497,5104,8020,1581,ITI,ITI3,11,Marche
2021-05-31,CAL,15258,7323,7935,7377,7881,ITF,ITF6,18,Calabria
2021-02-25,SAR,2899,1255,1644,2294,605,ITG,ITG2,20,Sardegna
2021-01-04,CAM,5826,2963,2863,5826,0,ITF,ITF3,15,Campania
2021-02-11,TOS,5383,2021,3362,5141,242,ITI,ITI1,9,Toscana
2021-05-16,VDA,688,341,347,347,341,ITC,ITC2,2,Valle d'Aosta / Vallée d'Aoste
2021-01-30,EMR,10079,3520,6559,141,9938,ITH,ITH5,8,Emilia-Romagna
2021-03-14,SAR,607,376,231,607,0,ITG,ITG2,20,Sardegna
2021-03-24,MOL,1631,658,973,1229,402,ITF,ITF2,14,Molise
2020-12-30,SIC,184,109,75,184,0,ITG,ITG1,19,Sicilia
2021-02-09,TOS,4488,1468,3020,3877,611,ITI,ITI1,9,Toscana
2021-04-05,PAB,301,144,157,23,278,ITH,ITH1,4,Provincia Autonoma Bolzano / Bozen
2021-06-14,LAZ,62473,29281,33192,32408,30065,ITI,ITI4,12,Lazio
2021-06-19,CAM,61111,29078,32033,23408,37703,ITF,ITF3,15,Campania
2021-01-16,SIC,2577,1150,1427,2577,0,ITG,ITG1,19,Sicilia
2021-01-28,PAT,530,147,383,48,482,ITH,ITH2,4,Provincia Autonoma Trento
2021-01-11,PAT,731,222,509,731,0,ITH,ITH2,4,Provincia Autonoma Trento
2021-01-22,BAS,67,24,43,67,0,ITF,ITF5,17,Basilicata
2021-06-19,LOM,103279,51494,51785,58505,44774,ITC,ITC4,3,Lombardia
2021-03-21,LAZ,18226,7162,11064,13175,5051,ITI,ITI4,12,Lazio
2021-04-09,SIC,20293,9880,10413,11217,9076,ITG,ITG1,19,Sicilia
2021-01-12,PAB,1709,459,1250,1709,0,ITH,ITH1,4,Provincia Autonoma Bolzano / Bozen
2021-03-23,SIC,20827,10005,10822,15314,5513,ITG,ITG1,19,Sicilia
2021-01-02,PUG,2949,1301,1648,2949,0,ITF,ITF4,16,Puglia
2021-01-03,ABR,471,185,286,471,0,ITF,ITF1,13,Abruzzo
2021-04-12,PUG,29217,13760,15457,26339,2878,ITF,ITF4,16,Puglia
2020-12-30,LAZ,1630,629,1001,1630,0,ITI,ITI4,12,Lazio
2021-02-16,PAT,664,245,419,659,5,ITH,ITH2,4,Provincia Autonoma Trento
2021-03-09,CAM,14124,6870,7254,10339,3785,ITF,ITF3,15,Campania
2021-05-02,BAS,4180,2001,2179,3551,629,ITF,ITF5,17,Basilicata
2021-04-15,BAS,3386,1659,1727,2632,754,ITF,ITF5,17,Basilicata
2021-01-17,MOL,78,38,40,48,30,ITF,ITF2,14,Molise
2021-06-15,LIG,17053,8283,8770,10594,6459,ITC,ITC3,7,Liguria
2021-02-14,MAR,738,301,437,738,0,ITI,ITI3,11,Marche
2021-04-28,VEN,32392,15169,17223,23374,9018,ITH,ITH3,5,Veneto
2021-04-23,EMR,29560,13811,15749,14679,14881,ITH,ITH5,8,Emilia-Romagna
2021-04-23,PAT,3636,1768,1868,3582,54,ITH,ITH2,4,Provincia Autonoma Trento
2021-01-30,PAT,386,132,254,152,234,ITH,ITH2,4,Provincia Autonoma Trento
2021-04-21,FVG,7753,3457,4296,4073,3680,ITH,ITH4,6,Friuli-Venezia Giulia
2020-12-28,SIC,212,126,86,212,0,ITG,ITG1,19,Sicilia
2021-01-13,EMR,9077,2942,6135,9077,0,ITH,ITH5,8,Emilia-Romagna
2021-03-27,ABR,6121,2620,3501,3635,2486,ITF,ITF1,13,Abruzzo
2021-04-09,LAZ,27553,12486,15067,19302,8251,ITI,ITI4,12,Lazio
2021-01-11,FVG,1882,608,1274,1882,0,ITH,ITH4,6,Friuli-Venezia Giulia
2021-03-23,LAZ,25199,11761,13438,18603,6596,ITI,ITI4,12,Lazio
2021-04-10,MOL,2640,1261,1379,2488,152,ITF,ITF2,14,Molise
2021-05-10,PAT,3212,1646,1566,2707,505,ITH,ITH2,4,Provincia Autonoma Trento
2021-03-07,LIG,1915,1138,777,1614,301,ITC,ITC3,7,Liguria
2021-05-31,CAM,40657,20601,20056,30389,10268,ITF,ITF3,15,Campania
2021-01-03,BAS,901,344,557,901,0,ITF,ITF5,17,Basilicata
2021-01-01,UMB,274,105,169,274,0,ITI,ITI2,10,Umbria
2021-02-05,MOL,593,269,324,55,538,ITF,ITF2,14,Molise
2021-04-11,UMB,3102,1503,1599,3053,49,ITI,ITI2,10,Umbria
2021-04-30,SAR,11134,5301,5833,6923,4211,ITG,ITG2,20,Sardegna
2021-01-18,VEN,2762,776,1986,2563,199,ITH,ITH3,5,Veneto
2021-01-05,ABR,1615,604,1011,1615,0,ITF,ITF1,13,Abruzzo
2021-03-11,CAL,7284,3430,3854,6018,1266,ITF,ITF6,18,Calabria
2021-04-04,EMR,9879,4717,5162,7612,2267,ITH,ITH5,8,Emilia-Romagna
2021-04-04,PIE,9256,4060,5196,6542,2714,ITC,ITC1,1,Piemonte
2021-06-04,VDA,908,383,525,474,434,ITC,ITC2,2,Valle d'Aosta / Vallée d'Aoste
2021-01-18,UMB,614,219,395,529,85,ITI,ITI2,10,Umbria
2021-01-19,MOL,173,63,110,162,11,ITF,ITF2,14,Molise
2021-04-21,PIE,25755,11841,13914,20415,5340,ITC,ITC1,1,Piemonte
2021-05-17,SAR,12164,5708,6456,9273,2891,ITG,ITG2,20,Sardegna
2021-02-04,VEN,7386,2025,5361,551,6835,ITH,ITH3,5,Veneto
2021-04-15,ABR,7819,3679,4140,5979,1840,ITF,ITF1,13,Abruzzo
2021-03-08,VDA,485,233,252,240,245,ITC,ITC2,2,Valle d'Aosta / Vallée d'Aoste
2021-04-23,UMB,6614,2788,3826,3493,3121,ITI,ITI2,10,Umbria
2021-05-12,EMR,38878,18279,20599,29220,9658,ITH,ITH5,8,Emilia-Romagna
2021-02-25,UMB,1336,497,839,1284,52,ITI,ITI2,10,Umbria
2021-05-04,VDA,1135,510,625,462,673,ITC,ITC2,2,Valle d'Aosta / Vallée d'Aoste
2021-02-01,EMR,10320,3610,6710,362,9958,ITH,ITH5,8,Emilia-Romagna
2021-06-15,MAR,12906,6414,6492,9854,3052,ITI,ITI3,11,Marche
2021-03-11,UMB,3595,1726,1869,2589,1006,ITI,ITI2,10,Umbria
2021-01-28,TOS,6282,1882,4400,354,5928,ITI,ITI1,9,Toscana
2021-05-01,MOL,2647,1268,1379,424,2223,ITF,ITF2,14,Molise
2021-01-13,UMB,450,139,311,450,0,ITI,ITI2,10,Umbria
2021-06-16,VDA,683,365,318,642,41,ITC,ITC2,2,Valle d'Aosta / Vallée d'Aoste
2021-06-19,UMB,4564,2199,2365,2534,2030,ITI,ITI2,10,Umbria
2021-03-05,MOL,1219,649,570,1015,204,ITF,ITF2,14,Molise
2021-05-31,PAT,4720,2174,2546,1676,3044,ITH,ITH2,4,Provincia Autonoma Trento
2021-01-30,CAM,10722,5080,5642,38,10684,ITF,ITF3,15,Campania
2021-03-25,BAS,1884,604,1280,1539,345,ITF,ITF5,17,Basilicata
2021-02-06,CAL,2911,1341,1570,444,2467,ITF,ITF6,18,Calabria
2021-06-13,MOL,2620,1405,1215,2295,325,ITF,ITF2,14,Molise
2021-01-27,BAS,412,175,237,113,299,ITF,ITF5,17,Basilicata
2021-04-17,MOL,3054,1501,1553,1568,1486,ITF,ITF2,14,Molise
2021-02-10,BAS,548,238,310,496,52,ITF,ITF5,17,Basilicata
2021-03-14,LIG,1659,752,907,1055,604,ITC,ITC3,7,Liguria
2021-04-11,FVG,3432,1519,1913,2526,906,ITH,ITH4,6,Friuli-Venezia Giulia
2021-01-12,MAR,1228,414,814,1228,0,ITI,ITI3,11,Marche
2021-05-21,BAS,4574,2320,2254,1491,3083,ITF,ITF5,17,Basilicata
2021-06-07,FVG,9107,4732,4375,8153,954,ITH,ITH4,6,Friuli-Venezia Giulia
2021-06-22,LIG,15468,7319,8149,8434,7034,ITC,ITC3,7,Liguria
2021-01-16,SAR,1492,525,967,1492,0,ITG,ITG2,20,Sardegna
2021-01-16,CAM,3370,1676,1694,3370,0,ITF,ITF3,15,Campania
2021-05-10,LIG,12648,5639,7009,6273,6375,ITC,ITC3,7,Liguria
2021-06-19,SIC,43731,20775,22956,18596,25135,ITG,ITG1,19,Sicilia
2021-05-05,VEN,44316,21237,23079,37743,6573,ITH,ITH3,5,Veneto
2021-04-23,SIC,28584,13702,14882,22770,5814,ITG,ITG1,19,Sicilia
2021-01-23,CAL,401,186,215,359,42,ITF,ITF6,18,Calabria
2021-06-07,PIE,34853,17845,17008,30072,4781,ITC,ITC1,1,Piemonte
2021-01-16,LOM,15425,5731,9694,15425,0,ITC,ITC4,3,Lombardia
2021-04-30,LAZ,41352,18316,23036,27141,14211,ITI,ITI4,12,Lazio
2021-02-10,ABR,947,312,635,503,444,ITF,ITF1,13,Abruzzo
2021-01-18,EMR,3128,879,2249,2449,679,ITH,ITH5,8,Emilia-Romagna
2021-03-15,VDA,362,123,239,159,203,ITC,ITC2,2,Valle d'Aosta / Vallée d'Aoste
2021-03-16,EMR,12246,5027,7219,4938,7308,ITH,ITH5,8,Emilia-Romagna
2021-05-11,VDA,647,325,322,496,151,ITC,ITC2,2,Valle d'Aosta / Vallée d'Aoste
2021-01-25,EMR,6462,2146,4316,207,6255,ITH,ITH5,8,Emilia-Romagna
2021-06-22,MAR,12998,6375,6623,6553,6445,ITI,ITI3,11,Marche
2021-01-06,UMB,846,325,521,846,0,ITI,ITI2,10,Umbria
2021-04-27,VDA,978,423,555,686,292,ITC,ITC2,2,Valle d'Aosta / Vallée d'Aoste
2021-06-12,UMB,7698,3682,4016,6126,1572,ITI,ITI2,10,Umbria
2021-03-23,EMR,18795,8144,10651,12108,6687,ITH,ITH5,8,Emilia-Romagna
2021-04-26,MAR,9004,3993,5011,5982,3022,ITI,ITI3,11,Marche
2021-01-17,VDA,131,56,75,131,0,ITC,ITC2,2,Valle d'Aosta / Vallée d'Aoste
2021-04-16,UMB,8115,3749,4366,6277,1838,ITI,ITI2,10,Umbria
2021-06-23,VDA,1043,551,492,427,616,ITC,ITC2,2,Valle d'Aosta / Vallée d'Aoste
2021-04-30,UMB,6265,2975,3290,2866,3399,ITI,ITI2,10,Umbria
2021-06-19,LAZ,59963,28029,31934,29716,30247,ITI,ITI4,12,Lazio
2021-03-19,TOS,10143,4460,5683,7275,2868,ITI,ITI1,9,Toscana
2021-06-20,MOL,420,173,247,50,370,ITF,ITF2,14,Molise
2021-03-04,UMB,4487,1855,2632,3659,828,ITI,ITI2,10,Umbria
2021-04-24,MOL,2551,1202,1349,710,1841,ITF,ITF2,14,Molise
2021-01-24,PAB,12,10,2,0,12,ITH,ITH1,4,Provincia Autonoma Bolzano / Bozen
2021-01-31,PUG,1815,831,984,75,1740,ITF,ITF4,16,Puglia
2021-02-26,MOL,563,260,303,490,73,ITF,ITF2,14,Molise
2021-03-28,CAL,2662,1219,1443,1571,1091,ITF,ITF6,18,Calabria
2021-01-20,UMB,613,222,391,613,0,ITI,ITI2,10,Umbria
2021-04-30,SIC,34959,16326,18633,23959,11000,ITG,ITG1,19,Sicilia
2021-06-06,MOL,2059,1059,1000,1736,323,ITF,ITF2,14,Molise
2021-04-01,BAS,2699,1107,1592,1978,721,ITF,ITF5,17,Basilicata
2021-05-03,LIG,13280,5923,7357,6468,6812,ITC,ITC3,7,Liguria
2021-05-31,FVG,8871,4412,4459,6709,2162,ITH,ITH4,6,Friuli-Venezia Giulia
2021-02-03,BAS,669,301,368,32,637,ITF,ITF5,17,Basilicata
2021-05-12,VEN,36725,17777,18948,31620,5105,ITH,ITH3,5,Veneto
2021-03-21,LIG,550,220,330,69,481,ITC,ITC3,7,Liguria
2020-12-28,PIE,1,1,0,1,0,ITC,ITC1,1,Piemonte
2021-01-23,LIG,809,295,514,153,656,ITC,ITC3,7,Liguria
2021-01-09,LOM,12414,4573,7841,12414,0,ITC,ITC4,3,Lombardia
2021-01-30,CAL,2183,1149,1034,353,1830,ITF,ITF6,18,Calabria
2021-06-24,VEN,54337,27507,26830,17306,37031,ITH,ITH3,5,Veneto
2021-01-23,CAM,3839,2029,1810,273,3566,ITF,ITF3,15,Campania
2021-03-04,SIC,15074,6570,8504,10955,4119,ITG,ITG1,19,Sicilia
2021-03-07,LOM,12084,5358,6726,9527,2557,ITC,ITC4,3,Lombardia
2021-03-16,VEN,12527,5353,7174,6907,5620,ITH,ITH3,5,Veneto
2021-03-21,CAM,10070,4674,5396,7680,2390,ITF,ITF3,15,Campania
2021-05-17,LIG,12024,5519,6505,8701,3323,ITC,ITC3,7,Liguria
2021-06-12,SIC,44498,21746,22752,38633,5865,ITG,ITG1,19,Sicilia
2021-01-21,TOS,1589,686,903,867,722,ITI,ITI1,9,Toscana
2021-05-07,LAZ,48205,22599,25606,30460,17745,ITI,ITI4,12,Lazio
2021-03-11,LAZ,25254,11861,13393,19024,6230,ITI,ITI4,12,Lazio
2021-03-09,EMR,14753,6019,8734,10798,3955,ITH,ITH5,8,Emilia-Romagna
2021-05-05,EMR,30088,13983,16105,18839,11249,ITH,ITH5,8,Emilia-Romagna
2021-02-03,ABR,2062,717,1345,419,1643,ITF,ITF1,13,Abruzzo
2021-01-27,LOM,8034,2673,5361,808,7226,ITC,ITC4,3,Lombardia
2021-02-17,CAL,1849,812,1037,1638,211,ITF,ITF6,18,Calabria
2021-05-29,PUG,30306,14282,16024,20944,9362,ITF,ITF4,16,Puglia
2021-02-10,CAM,6905,3413,3492,6728,177,ITF,ITF3,15,Campania
2021-03-19,MOL,1184,482,702,757,427,ITF,ITF2,14,Molise
2021-05-02,PIE,25067,11267,13800,14322,10745,ITC,ITC1,1,Piemonte
2021-03-25,LOM,42794,16009,26785,30124,12670,ITC,ITC4,3,Lombardia
2021-01-23,SAR,60,22,38,0,60,ITG,ITG2,20,Sardegna
2021-05-13,MOL,3039,1410,1629,2582,457,ITF,ITF2,14,Molise
2021-02-14,PAB,297,130,167,297,0,ITH,ITH1,4,Provincia Autonoma Bolzano / Bozen
2021-02-18,SIC,5277,3100,2177,4847,430,ITG,ITG1,19,Sicilia
2021-06-18,VDA,998,443,555,599,399,ITC,ITC2,2,Valle d'Aosta / Vallée d'Aoste
2021-04-30,CAM,42292,20173,22119,25821,16471,ITF,ITF3,15,Campania
2021-05-08,PAB,4427,2382,2045,3764,663,ITH,ITH1,4,Provincia Autonoma Bolzano / Bozen
2021-01-30,LAZ,7012,2894,4118,807,6205,ITI,ITI4,12,Lazio
2021-02-01,UMB,1285,342,943,48,1237,ITI,ITI2,10,Umbria
2021-02-04,CAM,7943,3429,4514,1308,6635,ITF,ITF3,15,Campania
2021-05-12,SIC,36725,17300,19425,21863,14862,ITG,ITG1,19,Sicilia
2021-03-13,BAS,1798,890,908,753,1045,ITF,ITF5,17,Basilicata
2021-02-18,UMB,1496,582,914,1030,466,ITI,ITI2,10,Umbria
2021-03-03,PAB,1180,394,786,1167,13,ITH,ITH1,4,Provincia Autonoma Bolzano / Bozen
2021-05-17,LOM,94615,45346,49269,30222,64393,ITC,ITC4,3,Lombardia
2021-01-27,FVG,1272,425,847,450,822,ITH,ITH4,6,Friuli-Venezia Giulia
2021-02-07,BAS,375,159,216,49,326,ITF,ITF5,17,Basilicata
2021-01-01,CAM,919,506,413,919,0,ITF,ITF3,15,Campania
2021-04-28,MOL,1693,923,770,476,1217,ITF,ITF2,14,Molise
2021-05-14,VEN,46671,22196,24475,25827,20844,ITH,ITH3,5,Veneto
2021-05-18,BAS,5897,2857,3040,3405,2492,ITF,ITF5,17,Basilicata
2021-02-04,PUG,5929,2366,3563,1195,4734,ITF,ITF4,16,Puglia
2021-05-09,EMR,25609,12252,13357,18642,6967,ITH,ITH5,8,Emilia-Romagna
2021-01-29,EMR,10414,3496,6918,290,10124,ITH,ITH5,8,Emilia-Romagna
2021-04-08,SIC,16682,8240,8442,8218,8464,ITG,ITG1,19,Sicilia
2021-05-07,FVG,10604,4850,5754,7097,3507,ITH,ITH4,6,Friuli-Venezia Giulia
2021-01-15,LAZ,6583,2708,3875,6583,0,ITI,ITI4,12,Lazio
2021-02-20,VEN,6424,2014,4410,6353,71,ITH,ITH3,5,Veneto
2021-03-04,PAT,2361,794,1567,1583,778,ITH,ITH2,4,Provincia Autonoma Trento
2020-12-30,LIG,12,5,7,12,0,ITC,ITC3,7,Liguria
2021-02-15,EMR,2904,851,2053,2779,125,ITH,ITH5,8,Emilia-Romagna
2021-04-25,LAZ,24522,11249,13273,16705,7817,ITI,ITI4,12,Lazio
2021-04-20,PIE,25481,11666,13815,19135,6346,ITC,ITC1,1,Piemonte
2021-03-25,CAM,20320,9653,10667,16817,3503,ITF,ITF3,15,Campania
2021-05-01,BAS,4703,2136,2567,3952,751,ITF,ITF5,17,Basilicata
2021-01-19,ABR,111,55,56,91,20,ITF,ITF1,13,Abruzzo
2021-03-18,TOS,9979,3984,5995,6007,3972,ITI,ITI1,9,Toscana
2021-05-09,FVG,7355,3301,4054,3498,3857,ITH,ITH4,6,Friuli-Venezia Giulia
2021-02-07,ABR,778,307,471,201,577,ITF,ITF1,13,Abruzzo
2021-02-22,SAR,1639,949,690,1411,228,ITG,ITG2,20,Sardegna
2021-03-02,MAR,4962,1943,3019,4396,566,ITI,ITI3,11,Marche
2021-04-13,CAL,6900,3381,3519,5587,1313,ITF,ITF6,18,Calabria
2021-05-07,PIE,33072,15642,17430,18947,14125,ITC,ITC1,1,Piemonte
2021-01-27,EMR,8361,2947,5414,462,7899,ITH,ITH5,8,Emilia-Romagna
2021-01-27,PIE,4196,1453,2743,999,3197,ITC,ITC1,1,Piemonte
2021-05-19,LOM,82797,39562,43235,33813,48984,ITC,ITC4,3,Lombardia
2021-06-10,MAR,14674,7564,7110,12661,2013,ITI,ITI3,11,Marche
2021-01-20,CAL,1401,626,775,1400,1,ITF,ITF6,18,Calabria
2021-02-13,PIE,4153,1334,2819,2931,1222,ITC,ITC1,1,Piemonte
2021-03-11,SAR,6428,3092,3336,5226,1202,ITG,ITG2,20,Sardegna
2021-02-08,LOM,10081,2918,7163,2130,7951,ITC,ITC4,3,Lombardia
2021-05-17,PUG,32807,15195,17612,20954,11853,ITF,ITF4,16,Puglia
2021-06-09,TOS,34704,17491,17213,34281,423,ITI,ITI1,9,Toscana
2021-02-25,LOM,15289,6348,8941,13720,1569,ITC,ITC4,3,Lombardia
2021-01-03,CAL,6,3,3,6,0,ITF,ITF6,18,Calabria
2021-04-11,LIG,4246,1929,2317,3997,249,ITC,ITC3,7,Liguria
2021-06-02,VEN,20307,10234,10073,15960,4347,ITH,ITH3,5,Veneto
2021-02-21,MOL,574,227,347,572,2,ITF,ITF2,14,Molise
2021-03-29,VDA,493,233,260,453,40,ITC,ITC2,2,Valle d'Aosta / Vallée d'Aoste
2021-01-21,ABR,157,47,110,157,0,ITF,ITF1,13,Abruzzo
2021-03-27,CAL,8578,3881,4697,4565,4013,ITF,ITF6,18,Calabria
2021-05-16,UMB,5319,2536,2783,5267,52,ITI,ITI2,10,Umbria
2021-06-20,VDA,1131,545,586,487,644,ITC,ITC2,2,Valle d'Aosta / Vallée d'Aoste
2021-02-04,MOL,758,295,463,77,681,ITF,ITF2,14,Molise
2021-04-04,TOS,13915,6605,7310,13662,253,ITI,ITI1,9,Toscana
2021-05-26,FVG,13339,6676,6663,9923,3416,ITH,ITH4,6,Friuli-Venezia Giulia
2021-03-12,VDA,531,175,356,305,226,ITC,ITC2,2,Valle d'Aosta / Vallée d'Aoste
2021-05-01,ABR,10734,5042,5692,5760,4974,ITF,ITF1,13,Abruzzo
2021-05-24,MAR,10796,5111,5685,8122,2674,ITI,ITI3,11,Marche
2021-02-15,FVG,2454,911,1543,2200,254,ITH,ITH4,6,Friuli-Venezia Giulia
2021-05-15,MOL,2979,1398,1581,2595,384,ITF,ITF2,14,Molise
2021-02-06,LOM,15251,5536,9715,1014,14237,ITC,ITC4,3,Lombardia
2021-02-20,SIC,7139,3692,3447,6897,242,ITG,ITG1,19,Sicilia
2021-04-06,LAZ,24387,11109,13278,17273,7114,ITI,ITI4,12,Lazio
2021-05-20,ABR,12745,5901,6844,7487,5258,ITF,ITF1,13,Abruzzo
2021-05-10,PAB,3018,1300,1718,1413,1605,ITH,ITH1,4,Provincia Autonoma Bolzano / Bozen
2021-05-09,PIE,27095,12918,14177,13474,13621,ITC,ITC1,1,Piemonte
2021-06-04,SAR,14373,6868,7505,9819,4554,ITG,ITG2,20,Sardegna
2021-01-18,LIG,2137,745,1392,1980,157,ITC,ITC3,7,Liguria
2021-01-27,PAT,804,277,527,93,711,ITH,ITH2,4,Provincia Autonoma Trento
2021-02-03,SIC,5921,2780,3141,722,5199,ITG,ITG1,19,Sicilia
2021-03-16,TOS,4899,1882,3017,2648,2251,ITI,ITI1,9,Toscana
2021-06-21,SAR,14015,6730,7285,5193,8822,ITG,ITG2,20,Sardegna
2020-12-27,LAZ,274,132,142,274,0,ITI,ITI4,12,Lazio
2021-02-13,PAT,537,333,204,172,365,ITH,ITH2,4,Provincia Autonoma Trento
2021-02-27,TOS,1984,756,1228,1082,902,ITI,ITI1,9,Toscana
2021-03-11,VEN,19827,8888,10939,14256,5571,ITH,ITH3,5,Veneto
2021-03-13,SAR,2755,1076,1679,2474,281,ITG,ITG2,20,Sardegna
2021-05-26,PIE,32737,15101,17636,15657,17080,ITC,ITC1,1,Piemonte
2021-01-20,CAM,1257,650,607,1257,0,ITF,ITF3,15,Campania
2021-04-27,SIC,26291,12656,13635,15531,10760,ITG,ITG1,19,Sicilia
2021-02-15,PIE,4432,1597,2835,3227,1205,ITC,ITC1,1,Piemonte
2021-05-22,MAR,11937,5719,6218,7489,4448,ITI,ITI3,11,Marche
2021-03-04,PIE,14535,5770,8765,11587,2948,ITC,ITC1,1,Piemonte
2021-03-08,CAL,5419,2904,2515,4353,1066,ITF,ITF6,18,Calabria
2021-03-30,SAR,8778,3591,5187,6502,2276,ITG,ITG2,20,Sardegna
2021-04-27,UMB,5668,2404,3264,3090,2578,ITI,ITI2,10,Umbria
2021-05-01,PAB,2104,1067,1037,1944,160,ITH,ITH1,4,Provincia Autonoma Bolzano / Bozen
2021-05-07,CAL,16112,7590,8522,9733,6379,ITF,ITF6,18,Calabria
2021-05-08,PUG,54228,22958,31270,24510,29718,ITF,ITF4,16,Puglia
2021-02-18,TOS,8822,3285,5537,7926,896,ITI,ITI1,9,Toscana
2021-04-04,CAM,7965,4017,3948,6919,1046,ITF,ITF3,15,Campania
2021-01-02,MAR,456,141,315,456,0,ITI,ITI3,11,Marche
2021-02-13,CAL,1397,604,793,1032,365,ITF,ITF6,18,Calabria
2021-05-11,BAS,2654,1353,1301,1621,1033,ITF,ITF5,17,Basilicata
2021-05-29,TOS,31543,15250,16293,23390,8153,ITI,ITI1,9,Toscana
2021-06-10,VEN,51694,26709,24985,42516,9178,ITH,ITH3,5,Veneto
2021-06-12,SAR,14746,7188,7558,10045,4701,ITG,ITG2,20,Sardegna
2021-02-17,ABR,2071,948,1123,1789,282,ITF,ITF1,13,Abruzzo
2021-03-04,SAR,4364,2292,2072,3108,1256,ITG,ITG2,20,Sardegna
2021-04-02,VEN,24044,10598,13446,17716,6328,ITH,ITH3,5,Veneto
2021-04-16,SIC,28548,14330,14218,20280,8268,ITG,ITG1,19,Sicilia
2021-05-17,PIE,30877,14584,16293,17752,13125,ITC,ITC1,1,Piemonte
2021-06-12,CAM,60385,29657,30728,53179,7206,ITF,ITF3,15,Campania
2021-02-06,PIE,7995,2666,5329,400,7595,ITC,ITC1,1,Piemonte
2021-01-23,SIC,4429,2278,2151,207,4222,ITG,ITG1,19,Sicilia
2021-02-23,PIE,9234,3713,5521,8653,581,ITC,ITC1,1,Piemonte
2021-03-04,CAM,14706,5395,9311,8812,5894,ITF,ITF3,15,Campania
2021-03-12,PAB,1664,734,930,1251,413,ITH,ITH1,4,Provincia Autonoma Bolzano / Bozen
2021-03-21,SAR,4030,1809,2221,2590,1440,ITG,ITG2,20,Sardegna
2021-06-11,ABR,11546,5752,5794,8797,2749,ITF,ITF1,13,Abruzzo
2021-01-06,SIC,6237,3282,2955,6237,0,ITG,ITG1,19,Sicilia
2021-03-29,PAB,1171,499,672,412,759,ITH,ITH1,4,Provincia Autonoma Bolzano / Bozen
2021-05-31,PIE,29030,14001,15029,20510,8520,ITC,ITC1,1,Piemonte
2021-06-17,PIE,40793,20480,20313,24532,16261,ITC,ITC1,1,Piemonte
2021-01-18,PAT,643,154,489,588,55,ITH,ITH2,4,Provincia Autonoma Trento
2021-06-12,LOM,88485,47643,40842,85426,3059,ITC,ITC4,3,Lombardia
2021-03-09,PIE,14054,5506,8548,11711,2343,ITC,ITC1,1,Piemonte
2021-03-21,LOM,23510,8493,15017,18317,5193,ITC,ITC4,3,Lombardia
2021-05-11,ABR,10754,5114,5640,5909,4845,ITF,ITF1,13,Abruzzo
2021-04-02,SIC,13874,6540,7334,9141,4733,ITG,ITG1,19,Sicilia
2021-02-10,SIC,4357,1778,2579,3973,384,ITG,ITG1,19,Sicilia
2021-03-23,TOS,9398,4375,5023,7124,2274,ITI,ITI1,9,Toscana
2021-06-24,MOL,3106,1448,1658,428,2678,ITF,ITF2,14,Molise
2021-03-07,MAR,5179,2106,3073,4425,754,ITI,ITI3,11,Marche
2021-03-13,EMR,16135,6361,9774,10822,5313,ITH,ITH5,8,Emilia-Romagna
2021-05-21,SIC,45798,21607,24191,24373,21425,ITG,ITG1,19,Sicilia
2021-03-02,MOL,667,383,284,509,158,ITF,ITF2,14,Molise
2021-06-09,VEN,42292,21718,20574,34910,7382,ITH,ITH3,5,Veneto
2021-06-11,CAL,17317,8509,8808,14733,2584,ITF,ITF6,18,Calabria
2021-02-13,LOM,6417,2441,3976,4941,1476,ITC,ITC4,3,Lombardia
2021-04-20,UMB,5442,2359,3083,3495,1947,ITI,ITI2,10,Umbria
2021-06-10,MOL,2571,1182,1389,1270,1301,ITF,ITF2,14,Molise
2021-01-08,CAL,2144,1028,1116,2144,0,ITF,ITF6,18,Calabria
2021-04-05,BAS,723,233,490,421,302,ITF,ITF5,17,Basilicata
2021-01-27,UMB,840,330,510,13,827,ITI,ITI2,10,Umbria
2021-03-27,EMR,21659,9059,12600,14751,6908,ITH,ITH5,8,Emilia-Romagna
2021-05-07,CAM,59755,29197,30558,43809,15946,ITF,ITF3,15,Campania
2021-03-18,CAL,4414,2059,2355,2356,2058,ITF,ITF6,18,Calabria
2020-12-30,TOS,327,104,223,327,0,ITI,ITI1,9,Toscana
2021-01-10,UMB,1070,277,793,1070,0,ITI,ITI2,10,Umbria
2021-01-27,CAM,7738,3820,3918,162,7576,ITF,ITF3,15,Campania
2021-04-13,EMR,23717,11127,12590,19376,4341,ITH,ITH5,8,Emilia-Romagna
2021-06-04,FVG,12020,6175,5845,10637,1383,ITH,ITH4,6,Friuli-Venezia Giulia
2021-05-21,UMB,8975,3670,5305,4138,4837,ITI,ITI2,10,Umbria
2021-01-03,EMR,2763,943,1820,2763,0,ITH,ITH5,8,Emilia-Romagna
2021-03-22,BAS,1187,535,652,639,548,ITF,ITF5,17,Basilicata
2021-05-04,UMB,5536,2545,2991,2411,3125,ITI,ITI2,10,Umbria
2021-04-01,LAZ,29615,14023,15592,22474,7141,ITI,ITI4,12,Lazio
2021-01-13,SAR,573,178,395,573,0,ITG,ITG2,20,Sardegna
2021-04-01,UMB,4376,1838,2538,2366,2010,ITI,ITI2,10,Umbria
2021-05-24,LIG,11817,5557,6260,9333,2484,ITC,ITC3,7,Liguria
2021-06-21,FVG,9013,4404,4609,1810,7203,ITH,ITH4,6,Friuli-Venezia Giulia
2021-01-21,PAB,953,442,511,139,814,ITH,ITH1,4,Provincia Autonoma Bolzano / Bozen
2021-05-25,VDA,1115,530,585,541,574,ITC,ITC2,2,Valle d'Aosta / Vallée d'Aoste
2021-03-13,FVG,2941,1124,1817,1670,1271,ITH,ITH4,6,Friuli-Venezia Giulia
2021-01-25,VEN,6468,2075,4393,159,6309,ITH,ITH3,5,Veneto
2021-02-14,VDA,48,16,32,1,47,ITC,ITC2,2,Valle d'Aosta / Vallée d'Aoste
2021-04-05,ABR,2694,1147,1547,1814,880,ITF,ITF1,13,Abruzzo
2021-05-07,LIG,13590,6037,7553,5798,7792,ITC,ITC3,7,Liguria
2021-01-01,PIE,1038,395,643,1038,0,ITC,ITC1,1,Piemonte
2021-05-08,VDA,904,540,364,526,378,ITC,ITC2,2,Valle d'Aosta / Vallée d'Aoste
2021-01-13,LOM,26424,8071,18353,26424,0,ITC,ITC4,3,Lombardia
2021-02-13,LIG,1080,508,572,800,280,ITC,ITC3,7,Liguria
2021-06-12,PUG,33748,16831,16917,24974,8774,ITF,ITF4,16,Puglia
2021-03-03,BAS,1746,816,930,1187,559,ITF,ITF5,17,Basilicata
2021-04-02,MOL,1455,709,746,678,777,ITF,ITF2,14,Molise
2021-05-02,PAT,3514,1955,1559,3477,37,ITH,ITH2,4,Provincia Autonoma Trento
2021-06-07,LIG,15668,7648,8020,8658,7010,ITC,ITC3,7,Liguria
2021-06-23,LAZ,61635,28986,32649,28693,32942,ITI,ITI4,12,Lazio
2021-01-16,MAR,2034,732,1302,2034,0,ITI,ITI3,11,Marche
2021-02-27,CAL,4002,2060,1942,3620,382,ITF,ITF6,18,Calabria
2021-05-25,BAS,4194,2111,2083,873,3321,ITF,ITF5,17,Basilicata
2021-04-01,SIC,14232,6609,7623,9568,4664,ITG,ITG1,19,Sicilia
2021-05-02,EMR,25578,11651,13927,13587,11991,ITH,ITH5,8,Emilia-Romagna
2021-05-12,TOS,34178,15567,18611,14165,20013,ITI,ITI1,9,Toscana
2021-05-08,MOL,2974,1455,1519,1730,1244,ITF,ITF2,14,Molise
2021-01-22,EMR,1829,477,1352,1088,741,ITH,ITH5,8,Emilia-Romagna
2021-03-01,UMB,1503,774,729,1389,114,ITI,ITI2,10,Umbria
2021-01-18,TOS,1119,636,483,1021,98,ITI,ITI1,9,Toscana
2021-04-20,VEN,22433,9495,12938,8433,14000,ITH,ITH3,5,Veneto
2021-04-21,MOL,1864,789,1075,969,895,ITF,ITF2,14,Molise
2021-06-19,MAR,14459,7284,7175,7789,6670,ITI,ITI3,11,Marche
2021-02-08,EMR,5231,1534,3697,2318,2913,ITH,ITH5,8,Emilia-Romagna
2021-03-14,FVG,1398,550,848,1146,252,ITH,ITH4,6,Friuli-Venezia Giulia
2021-02-04,SIC,6705,3050,3655,1452,5253,ITG,ITG1,19,Sicilia
2021-02-20,EMR,5318,2094,3224,5055,263,ITH,ITH5,8,Emilia-Romagna
2021-03-02,TOS,10599,3799,6800,7155,3444,ITI,ITI1,9,Toscana
2021-06-12,VEN,47753,24057,23696,37041,10712,ITH,ITH3,5,Veneto
2021-06-24,PAT,5902,3092,2810,3722,2180,ITH,ITH2,4,Provincia Autonoma Trento
2021-04-04,SAR,1,0,1,0,1,ITG,ITG2,20,Sardegna
2021-06-18,BAS,4451,2058,2393,2193,2258,ITF,ITF5,17,Basilicata
2021-01-04,TOS,5065,1894,3171,5065,0,ITI,ITI1,9,Toscana
2021-04-08,VDA,584,282,302,441,143,ITC,ITC2,2,Valle d'Aosta / Vallée d'Aoste
2021-05-24,LAZ,43901,20117,23784,34148,9753,ITI,ITI4,12,Lazio
2021-05-26,UMB,9652,4569,5083,8399,1253,ITI,ITI2,10,Umbria
2021-04-14,TOS,20176,8342,11834,15069,5107,ITI,ITI1,9,Toscana
2021-05-12,PAT,3302,1492,1810,2115,1187,ITH,ITH2,4,Provincia Autonoma Trento
2021-02-18,CAM,9080,3813,5267,8373,707,ITF,ITF3,15,Campania
2021-02-28,PUG,6057,1806,4251,5871,186,ITF,ITF4,16,Puglia
2021-06-03,MAR,14631,7476,7155,12375,2256,ITI,ITI3,11,Marche
2021-03-16,PAT,1391,506,885,608,783,ITH,ITH2,4,Provincia Autonoma Trento
2021-05-25,MOL,1963,887,1076,1333,630,ITF,ITF2,14,Molise
2021-06-08,PAB,4146,2116,2030,830,3316,ITH,ITH1,4,Provincia Autonoma Bolzano / Bozen
2021-01-15,EMR,7750,2404,5346,7750,0,ITH,ITH5,8,Emilia-Romagna
2021-05-14,PAT,5317,2540,2777,3932,1385,ITH,ITH2,4,Provincia Autonoma Trento
2021-02-02,ABR,1763,668,1095,222,1541,ITF,ITF1,13,Abruzzo
2021-05-13,ABR,11147,5042,6105,7188,3959,ITF,ITF1,13,Abruzzo
2021-06-13,VDA,851,399,452,373,478,ITC,ITC2,2,Valle d'Aosta / Vallée d'Aoste
2021-02-08,PIE,6918,2356,4562,666,6252,ITC,ITC1,1,Piemonte
2021-01-03,LAZ,5253,1973,3280,5253,0,ITI,ITI4,12,Lazio
2021-05-12,PUG,36528,16304,20224,24056,12472,ITF,ITF4,16,Puglia
2021-06-14,TOS,31765,16307,15458,27671,4094,ITI,ITI1,9,Toscana
2021-01-04,MOL,314,131,183,314,0,ITF,ITF2,14,Molise
2021-04-25,CAM,30730,15170,15560,25337,5393,ITF,ITF3,15,Campania
2021-01-01,SIC,817,437,380,817,0,ITG,ITG1,19,Sicilia
2021-03-31,ABR,6712,2938,3774,4643,2069,ITF,ITF1,13,Abruzzo
2021-04-13,LAZ,25746,11928,13818,18029,7717,ITI,ITI4,12,Lazio
2021-04-14,MOL,1806,767,1039,1145,661,ITF,ITF2,14,Molise
2021-04-08,FVG,7411,3195,4216,5489,1922,ITH,ITH4,6,Friuli-Venezia Giulia
2021-06-23,CAL,16826,7677,9149,7896,8930,ITF,ITF6,18,Calabria
2021-02-16,MOL,156,70,86,150,6,ITF,ITF2,14,Molise
2021-04-20,SIC,19000,8981,10019,13756,5244,ITG,ITG1,19,Sicilia
2021-02-18,MAR,2104,748,1356,1818,286,ITI,ITI3,11,Marche
2021-05-27,MOL,2834,1348,1486,1998,836,ITF,ITF2,14,Molise
2021-04-23,LIG,14671,6637,8034,8551,6120,ITC,ITC3,7,Liguria
2021-05-21,FVG,11184,5004,6180,8217,2967,ITH,ITH4,6,Friuli-Venezia Giulia
2021-06-09,EMR,42330,21535,20795,35984,6346,ITH,ITH5,8,Emilia-Romagna
2021-05-29,MAR,12788,6194,6594,8260,4528,ITI,ITI3,11,Marche
2021-01-24,BAS,840,303,537,58,782,ITF,ITF5,17,Basilicata
2021-02-10,FVG,1352,496,856,1266,86,ITH,ITH4,6,Friuli-Venezia Giulia
2021-03-01,EMR,10095,3582,6513,7837,2258,ITH,ITH5,8,Emilia-Romagna
2021-05-02,VEN,37235,17263,19972,26905,10330,ITH,ITH3,5,Veneto
2021-05-15,ABR,11438,5180,6258,6128,5310,ITF,ITF1,13,Abruzzo
2021-02-01,FVG,2097,688,1409,16,2081,ITH,ITH4,6,Friuli-Venezia Giulia
2021-03-11,LIG,6397,3088,3309,4387,2010,ITC,ITC3,7,Liguria
2021-05-28,UMB,9577,4431,5146,7282,2295,ITI,ITI2,10,Umbria
2021-01-13,LIG,2754,1013,1741,2754,0,ITC,ITC3,7,Liguria
2021-05-13,BAS,5985,2967,3018,3389,2596,ITF,ITF5,17,Basilicata
2021-06-08,VDA,712,356,356,679,33,ITC,ITC2,2,Valle d'Aosta / Vallée d'Aoste
2021-05-04,EMR,29267,13704,15563,15607,13660,ITH,ITH5,8,Emilia-Romagna
2021-06-14,VEN,42373,21423,20950,27111,15262,ITH,ITH3,5,Veneto
2021-01-08,LAZ,7730,2895,4835,7730,0,ITI,ITI4,12,Lazio
2021-01-13,CAM,8020,3666,4354,8020,0,ITF,ITF3,15,Campania
2021-04-15,UMB,7641,3489,4152,5754,1887,ITI,ITI2,10,Umbria
2021-06-16,SAR,17629,8274,9355,12328,5301,ITG,ITG2,20,Sardegna
2021-02-08,PAT,1152,319,833,342,810,ITH,ITH2,4,Provincia Autonoma Trento
2021-03-04,TOS,17847,6950,10897,14765,3082,ITI,ITI1,9,Toscana
2021-03-06,VEN,10667,4356,6311,7405,3262,ITH,ITH3,5,Veneto
2021-04-28,PAB,2464,1302,1162,2459,5,ITH,ITH1,4,Provincia Autonoma Bolzano / Bozen
2021-02-17,UMB,1618,748,870,1267,351,ITI,ITI2,10,Umbria
2021-05-21,PIE,36039,16744,19295,20411,15628,ITC,ITC1,1,Piemonte
2021-01-04,LIG,2616,855,1761,2616,0,ITC,ITC3,7,Liguria
2021-01-23,PUG,3039,1294,1745,886,2153,ITF,ITF4,16,Puglia
2021-05-29,MOL,2350,1223,1127,1960,390,ITF,ITF2,14,Molise
2021-03-13,CAL,6928,3012,3916,5954,974,ITF,ITF6,18,Calabria
2021-05-03,PUG,33284,14877,18407,22660,10624,ITF,ITF4,16,Puglia
2021-02-27,EMR,10961,3998,6963,9223,1738,ITH,ITH5,8,Emilia-Romagna
2021-03-07,PUG,4983,2000,2983,4412,571,ITF,ITF4,16,Puglia
2020-12-30,VEN,699,245,454,699,0,ITH,ITH3,5,Veneto
2021-04-25,EMR,22349,10239,12110,14840,7509,ITH,ITH5,8,Emilia-Romagna
2021-01-01,SAR,32,17,15,32,0,ITG,ITG2,20,Sardegna
2021-02-16,MAR,1288,475,813,1258,30,ITI,ITI3,11,Marche
2021-02-26,VDA,207,58,149,122,85,ITC,ITC2,2,Valle d'Aosta / Vallée d'Aoste
2021-04-13,UMB,7690,3403,4287,6020,1670,ITI,ITI2,10,Umbria
2021-05-14,FVG,10742,5350,5392,8159,2583,ITH,ITH4,6,Friuli-Venezia Giulia
2021-06-21,LIG,14374,6818,7556,9211,5163,ITC,ITC3,7,Liguria
2021-02-25,MAR,3515,1437,2078,3336,179,ITI,ITI3,11,Marche
2021-02-27,SAR,1921,647,1274,1366,555,ITG,ITG2,20,Sardegna
2021-02-03,FVG,2647,791,1856,23,2624,ITH,ITH4,6,Friuli-Venezia Giulia
2021-02-15,UMB,1368,692,676,1367,1,ITI,ITI2,10,Umbria
2021-06-21,TOS,31065,15395,15670,18355,12710,ITI,ITI1,9,Toscana
2021-02-01,PIE,8645,3055,5590,579,8066,ITC,ITC1,1,Piemonte
2021-04-18,CAM,27218,13283,13935,18318,8900,ITF,ITF3,15,Campania
2021-05-08,BAS,4835,2399,2436,3429,1406,ITF,ITF5,17,Basilicata
2021-06-05,MAR,13932,7006,6926,11873,2059,ITI,ITI3,11,Marche
2021-01-15,CAL,2802,1259,1543,2802,0,ITF,ITF6,18,Calabria
2021-04-10,VDA,404,190,214,399,5,ITC,ITC2,2,Valle d'Aosta / Vallée d'Aoste
2021-01-08,CAM,10454,4967,5487,10454,0,ITF,ITF3,15,Campania
2021-01-16,PAB,2840,1265,1575,2840,0,ITH,ITH1,4,Provincia Autonoma Bolzano / Bozen
2020-12-31,VDA,18,4,14,18,0,ITC,ITC2,2,Valle d'Aosta / Vallée d'Aoste
2021-06-23,ABR,10824,5207,5617,5532,5292,ITF,ITF1,13,Abruzzo
2021-04-18,EMR,17500,8395,9105,12582,4918,ITH,ITH5,8,Emilia-Romagna
2021-04-28,PAT,4250,1976,2274,4112,138,ITH,ITH2,4,Provincia Autonoma Trento
2021-04-26,PUG,26252,12026,14226,23019,3233,ITF,ITF4,16,Puglia
2021-05-05,PIE,32198,15098,17100,19178,13020,ITC,ITC1,1,Piemonte
2021-05-31,SAR,11366,5408,5958,8257,3109,ITG,ITG2,20,Sardegna
2021-02-18,VEN,5828,2455,3373,5764,64,ITH,ITH3,5,Veneto
2021-03-25,VDA,389,154,235,379,10,ITC,ITC2,2,Valle d'Aosta / Vallée d'Aoste
2021-04-12,PAB,2105,946,1159,2098,7,ITH,ITH1,4,Provincia Autonoma Bolzano / Bozen
2021-06-14,EMR,40546,20940,19606,27515,13031,ITH,ITH5,8,Emilia-Romagna
2021-01-16,FVG,1230,360,870,1230,0,ITH,ITH4,6,Friuli-Venezia Giulia
2021-03-28,LAZ,19114,7761,11353,13804,5310,ITI,ITI4,12,Lazio
2021-03-30,UMB,3978,1729,2249,2438,1540,ITI,ITI2,10,Umbria
2021-02-16,TOS,9280,3340,5940,8559,721,ITI,ITI1,9,Toscana
2021-04-16,VEN,24439,10487,13952,12558,11881,ITH,ITH3,5,Veneto
2021-05-21,VDA,917,433,484,531,386,ITC,ITC2,2,Valle d'Aosta / Vallée d'Aoste
2021-04-18,SAR,5127,2225,2902,2258,2869,ITG,ITG2,20,Sardegna
2021-06-12,MAR,13436,7143,6293,12132,1304,ITI,ITI3,11,Marche
2020-12-27,UMB,86,45,41,86,0,ITI,ITI2,10,Umbria
2021-04-17,VDA,638,407,231,636,2,ITC,ITC2,2,Valle d'Aosta / Vallée d'Aoste
2021-05-02,TOS,11166,4931,6235,9203,1963,ITI,ITI1,9,Toscana
2021-01-08,SAR,3258,1184,2074,3258,0,ITG,ITG2,20,Sardegna
2021-04-16,MAR,10082,4702,5380,9557,525,ITI,ITI3,11,Marche
2021-01-07,VDA,276,111,165,276,0,ITC,ITC2,2,Valle d'Aosta / Vallée d'Aoste
2021-03-25,FVG,5527,2419,3108,3391,2136,ITH,ITH4,6,Friuli-Venezia Giulia
2021-06-14,LIG,14656,7099,7557,9238,5418,ITC,ITC3,7,Liguria
2021-02-27,CAM,13948,4473,9475,12306,1642,ITF,ITF3,15,Campania
2021-03-07,PAB,114,13,101,9,105,ITH,ITH1,4,Provincia Autonoma Bolzano / Bozen
2021-04-01,PAT,2904,1230,1674,1810,1094,ITH,ITH2,4,Provincia Autonoma Trento
2021-06-04,SIC,57598,26633,30965,45796,11802,ITG,ITG1,19,Sicilia
2021-03-06,CAL,8439,4345,4094,7645,794,ITF,ITF6,18,Calabria
2021-06-09,LAZ,69914,32981,36933,36362,33552,ITI,ITI4,12,Lazio
2021-02-19,VDA,292,102,190,268,24,ITC,ITC2,2,Valle d'Aosta / Vallée d'Aoste
2021-02-22,UMB,1889,807,1082,1803,86,ITI,ITI2,10,Umbria
2021-03-16,PUG,9872,4688,5184,3512,6360,ITF,ITF4,16,Puglia
2021-04-11,LOM,32214,13941,18273,24823,7391,ITC,ITC4,3,Lombardia
2021-06-16,CAM,30378,14359,16019,19638,10740,ITF,ITF3,15,Campania
2021-01-01,LOM,24,7,17,24,0,ITC,ITC4,3,Lombardia
2021-02-25,TOS,10633,4306,6327,9635,998,ITI,ITI1,9,Toscana
2021-06-07,LOM,98509,50188,48321,85210,13299,ITC,ITC4,3,Lombardia
2021-06-24,PUG,48118,23092,25026,21974,26144,ITF,ITF4,16,Puglia
2021-04-18,VEN,17512,7252,10260,9947,7565,ITH,ITH3,5,Veneto
2021-02-27,LOM,13945,5870,8075,13304,641,ITC,ITC4,3,Lombardia
2021-04-21,PAB,3013,1468,1545,2165,848,ITH,ITH1,4,Provincia Autonoma Bolzano / Bozen
2021-04-28,PUG,19785,8869,10916,15020,4765,ITF,ITF4,16,Puglia
2021-03-17,ABR,4539,1873,2666,2799,1740,ITF,ITF1,13,Abruzzo
2021-03-31,MOL,2193,919,1274,1374,819,ITF,ITF2,14,Molise
2021-02-25,LIG,3457,1349,2108,3327,130,ITC,ITC3,7,Liguria
2021-06-02,SAR,9784,4690,5094,8144,1640,ITG,ITG2,20,Sardegna
2021-01-10,EMR,7171,2684,4487,7171,0,ITH,ITH5,8,Emilia-Romagna
2021-06-16,EMR,45101,23038,22063,25266,19835,ITH,ITH5,8,Emilia-Romagna
2021-06-24,PAB,3783,1954,1829,1595,2188,ITH,ITH1,4,Provincia Autonoma Bolzano / Bozen
2021-04-06,SIC,17738,8475,9263,13453,4285,ITG,ITG1,19,Sicilia
2021-01-20,TOS,1331,637,694,1083,248,ITI,ITI1,9,Toscana
2021-03-08,EMR,12200,5093,7107,9541,2659,ITH,ITH5,8,Emilia-Romagna
2021-03-23,PAT,2448,944,1504,1708,740,ITH,ITH2,4,Provincia Autonoma Trento
2021-01-04,MAR,1509,570,939,1509,0,ITI,ITI3,11,Marche
2021-03-30,FVG,7220,3249,3971,6297,923,ITH,ITH4,6,Friuli-Venezia Giulia
2021-04-20,SAR,10996,4993,6003,7780,3216,ITG,ITG2,20,Sardegna
2020-12-30,LOM,114,42,72,114,0,ITC,ITC4,3,Lombardia
2021-01-08,VEN,9407,2835,6572,9407,0,ITH,ITH3,5,Veneto
2021-04-30,TOS,40189,17780,22409,20334,19855,ITI,ITI1,9,Toscana
2021-02-22,SIC,7889,4092,3797,7398,491,ITG,ITG1,19,Sicilia
2021-01-05,VDA,150,54,96,150,0,ITC,ITC2,2,Valle d'Aosta / Vallée d'Aoste
2020-12-27,SIC,92,55,37,92,0,ITG,ITG1,19,Sicilia
2021-06-02,SIC,35246,16287,18959,27475,7771,ITG,ITG1,19,Sicilia
2021-05-09,CAL,9619,4483,5136,6086,3533,ITF,ITF6,18,Calabria
2021-04-27,LAZ,30705,13860,16845,19858,10847,ITI,ITI4,12,Lazio
2021-04-29,BAS,4832,2386,2446,4411,421,ITF,ITF5,17,Basilicata
2021-05-02,CAM,43493,21540,21953,32138,11355,ITF,ITF3,15,Campania
2021-01-09,PAB,612,326,286,612,0,ITH,ITH1,4,Provincia Autonoma Bolzano / Bozen
2021-05-28,PAT,3717,1735,1982,1492,2225,ITH,ITH2,4,Provincia Autonoma Trento
2021-01-22,CAM,1525,776,749,673,852,ITF,ITF3,15,Campania
2021-03-01,LAZ,17116,7367,9749,13231,3885,ITI,ITI4,12,Lazio
2021-06-11,UMB,6899,3462,3437,6131,768,ITI,ITI2,10,Umbria
2021-01-14,VDA,237,69,168,237,0,ITC,ITC2,2,Valle d'Aosta / Vallée d'Aoste
2021-01-25,PAT,818,215,603,24,794,ITH,ITH2,4,Provincia Autonoma Trento
2021-03-17,BAS,1453,609,844,28,1425,ITF,ITF5,17,Basilicata
2021-04-14,MAR,10214,4563,5651,9842,372,ITI,ITI3,11,Marche
2021-01-29,CAL,2057,990,1067,230,1827,ITF,ITF6,18,Calabria
2021-01-09,PUG,4887,2250,2637,4887,0,ITF,ITF4,16,Puglia
2021-01-19,BAS,199,84,115,199,0,ITF,ITF5,17,Basilicata
2021-06-16,LOM,98500,50044,48456,50588,47912,ITC,ITC4,3,Lombardia
2021-06-25,BAS,3286,1556,1730,2463,823,ITF,ITF5,17,Basilicata
2021-03-25,PAT,2875,1105,1770,1826,1049,ITH,ITH2,4,Provincia Autonoma Trento
2021-03-24,ABR,6386,2786,3600,4135,2251,ITF,ITF1,13,Abruzzo
2021-04-24,VDA,722,400,322,555,167,ITC,ITC2,2,Valle d'Aosta / Vallée d'Aoste
2020-12-30,MAR,17,5,12,17,0,ITI,ITI3,11,Marche
2021-01-13,VEN,5985,1606,4379,5985,0,ITH,ITH3,5,Veneto
2021-02-22,LAZ,11459,4990,6469,10957,502,ITI,ITI4,12,Lazio
2021-04-25,TOS,11055,5248,5807,8918,2137,ITI,ITI1,9,Toscana
2021-03-30,PIE,16894,7035,9859,9021,7873,ITC,ITC1,1,Piemonte
2021-02-09,ABR,909,312,597,500,409,ITF,ITF1,13,Abruzzo
2021-06-02,LAZ,43234,21482,21752,31737,11497,ITI,ITI4,12,Lazio
2021-02-23,MOL,582,223,359,363,219,ITF,ITF2,14,Molise
2021-03-06,CAM,16371,6814,9557,10702,5669,ITF,ITF3,15,Campania
2021-05-04,CAL,16447,7583,8864,11730,4717,ITF,ITF6,18,Calabria
2021-01-25,LAZ,8111,3246,4865,770,7341,ITI,ITI4,12,Lazio
2021-06-17,LOM,107631,52298,55333,53479,54152,ITC,ITC4,3,Lombardia
2021-05-05,LAZ,46774,21457,25317,30951,15823,ITI,ITI4,12,Lazio
2021-03-09,LOM,33213,12859,20354,25818,7395,ITC,ITC4,3,Lombardia
2021-05-05,LOM,87893,41909,45984,72590,15303,ITC,ITC4,3,Lombardia
2021-03-13,VDA,147,88,59,147,0,ITC,ITC2,2,Valle d'Aosta / Vallée d'Aoste
2021-03-28,TOS,6212,2808,3404,5958,254,ITI,ITI1,9,Toscana
2021-05-29,PAT,2236,1167,1069,840,1396,ITH,ITH2,4,Provincia Autonoma Trento
2021-02-11,FVG,1930,664,1266,1738,192,ITH,ITH4,6,Friuli-Venezia Giulia
2021-03-02,LAZ,17188,7606,9582,13253,3935,ITI,ITI4,12,Lazio
2021-03-12,MAR,4640,1972,2668,3402,1238,ITI,ITI3,11,Marche
2021-01-30,TOS,4622,1622,3000,198,4424,ITI,ITI1,9,Toscana
2021-04-02,PAT,2845,1157,1688,2170,675,ITH,ITH2,4,Provincia Autonoma Trento
2021-01-14,MAR,2010,692,1318,2010,0,ITI,ITI3,11,Marche
2021-04-09,FVG,7898,3652,4246,6653,1245,ITH,ITH4,6,Friuli-Venezia Giulia
2021-05-23,BAS,4517,2302,2215,1533,2984,ITF,ITF5,17,Basilicata
2021-06-20,MAR,10964,5445,5519,5980,4984,ITI,ITI3,11,Marche
2021-04-16,PAT,2865,1360,1505,2720,145,ITH,ITH2,4,Provincia Autonoma Trento
2021-05-10,TOS,26188,12384,13804,15568,10620,ITI,ITI1,9,Toscana
2021-01-18,LAZ,6267,2557,3710,5289,978,ITI,ITI4,12,Lazio
2021-04-25,UMB,4364,1685,2679,4282,82,ITI,ITI2,10,Umbria
2021-01-15,VDA,218,82,136,218,0,ITC,ITC2,2,Valle d'Aosta / Vallée d'Aoste
2021-02-18,PAT,1208,426,782,1146,62,ITH,ITH2,4,Provincia Autonoma Trento
2021-03-14,TOS,7174,2569,4605,3239,3935,ITI,ITI1,9,Toscana
2021-03-31,PUG,14487,6763,7724,8929,5558,ITF,ITF4,16,Puglia
2021-04-28,LAZ,32927,15027,17900,21358,11569,ITI,ITI4,12,Lazio
2021-03-07,VEN,4492,1768,2724,3931,561,ITH,ITH3,5,Veneto
2021-04-29,PAB,2632,1351,1281,1938,694,ITH,ITH1,4,Provincia Autonoma Bolzano / Bozen
2021-05-19,CAL,18330,9077,9253,11362,6968,ITF,ITF6,18,Calabria
2021-01-14,LIG,2981,1055,1926,2981,0,ITC,ITC3,7,Liguria
2021-02-02,PUG,4344,1846,2498,592,3752,ITF,ITF4,16,Puglia
2021-05-12,CAM,40879,19946,20933,31728,9151,ITF,ITF3,15,Campania
2021-01-19,PAB,853,371,482,723,130,ITH,ITH1,4,Provincia Autonoma Bolzano / Bozen
2021-03-03,MOL,672,316,356,590,82,ITF,ITF2,14,Molise
2021-03-23,CAL,5234,2449,2785,3425,1809,ITF,ITF6,18,Calabria
2021-05-03,VEN,40686,19805,20881,34223,6463,ITH,ITH3,5,Veneto
2021-06-25,PAB,4059,2241,1818,1053,3006,ITH,ITH1,4,Provincia Autonoma Bolzano / Bozen
2021-05-13,PUG,38654,17240,21414,21504,17150,ITF,ITF4,16,Puglia
2021-06-21,UMB,7488,3925,3563,5153,2335,ITI,ITI2,10,Umbria
2021-01-05,MOL,449,180,269,449,0,ITF,ITF2,14,Molise
2020-12-30,FVG,626,244,382,626,0,ITH,ITH4,6,Friuli-Venezia Giulia
2021-03-17,PUG,10345,4701,5644,4171,6174,ITF,ITF4,16,Puglia
2021-03-27,BAS,2246,860,1386,1818,428,ITF,ITF5,17,Basilicata
2021-04-21,SAR,12075,5558,6517,6542,5533,ITG,ITG2,20,Sardegna
2021-04-24,MAR,12037,5309,6728,7573,4464,ITI,ITI3,11,Marche
2021-06-05,FVG,10286,5315,4971,8738,1548,ITH,ITH4,6,Friuli-Venezia Giulia
2021-01-11,SAR,1183,505,678,1183,0,ITG,ITG2,20,Sardegna
2021-02-25,FVG,3165,1652,1513,3136,29,ITH,ITH4,6,Friuli-Venezia Giulia
2021-02-26,MAR,3631,1500,2131,3155,476,ITI,ITI3,11,Marche
2021-03-12,LIG,6216,2872,3344,3745,2471,ITC,ITC3,7,Liguria
2021-06-17,SAR,18446,8523,9923,10035,8411,ITG,ITG2,20,Sardegna
2021-03-27,LAZ,26304,10645,15659,19831,6473,ITI,ITI4,12,Lazio
2021-02-09,PAB,317,126,191,1,316,ITH,ITH1,4,Provincia Autonoma Bolzano / Bozen
2021-03-31,VDA,555,302,253,529,26,ITC,ITC2,2,Valle d'Aosta / Vallée d'Aoste
2021-04-17,ABR,7347,3398,3949,4294,3053,ITF,ITF1,13,Abruzzo
2021-05-19,LIG,13570,5962,7608,10451,3119,ITC,ITC3,7,Liguria
2021-06-16,FVG,11947,5814,6133,4052,7895,ITH,ITH4,6,Friuli-Venezia Giulia
2021-01-25,SAR,591,214,377,22,569,ITG,ITG2,20,Sardegna
2021-02-19,ABR,3300,1551,1749,3200,100,ITF,ITF1,13,Abruzzo
2021-03-23,LIG,9267,4218,5049,6058,3209,ITC,ITC3,7,Liguria
2021-05-23,LAZ,47077,22838,24239,39697,7380,ITI,ITI4,12,Lazio
2021-05-27,VDA,1089,497,592,586,503,ITC,ITC2,2,Valle d'Aosta / Vallée d'Aoste
2021-05-13,VDA,1139,556,583,540,599,ITC,ITC2,2,Valle d'Aosta / Vallée d'Aoste
2021-05-12,MAR,10423,4686,5737,4922,5501,ITI,ITI3,11,Marche
2021-05-28,VEN,46625,22837,23788,24841,21784,ITH,ITH3,5,Veneto
2021-01-07,BAS,640,319,321,640,0,ITF,ITF5,17,Basilicata
2021-01-06,PAT,42,13,29,42,0,ITH,ITH2,4,Provincia Autonoma Trento
2021-01-18,LOM,9197,2968,6229,8222,975,ITC,ITC4,3,Lombardia
2021-02-02,VDA,272,70,202,2,270,ITC,ITC2,2,Valle d'Aosta / Vallée d'Aoste
2021-05-09,LAZ,37537,17257,20280,26267,11270,ITI,ITI4,12,Lazio
2021-05-16,SAR,8221,3831,4390,6061,2160,ITG,ITG2,20,Sardegna
2021-06-25,VDA,977,445,532,324,653,ITC,ITC2,2,Valle d'Aosta / Vallée d'Aoste
2021-01-13,PIE,10085,3226,6859,10085,0,ITC,ITC1,1,Piemonte
2021-06-16,PIE,40172,20143,20029,23952,16220,ITC,ITC1,1,Piemonte
2021-05-10,MOL,2890,1285,1605,2517,373,ITF,ITF2,14,Molise
2021-03-23,LOM,42567,15464,27103,29708,12859,ITC,ITC4,3,Lombardia
2021-05-03,MOL,2485,1165,1320,2322,163,ITF,ITF2,14,Molise
2021-05-16,SIC,33135,16137,16998,21814,11321,ITG,ITG1,19,Sicilia
2021-02-15,CAL,1144,542,602,994,150,ITF,ITF6,18,Calabria
2021-03-06,UMB,4317,1154,3163,4174,143,ITI,ITI2,10,Umbria
2021-03-25,EMR,21476,9416,12060,14487,6989,ITH,ITH5,8,Emilia-Romagna
2021-02-19,BAS,1623,738,885,1561,62,ITF,ITF5,17,Basilicata
2021-05-21,EMR,39250,17526,21724,22231,17019,ITH,ITH5,8,Emilia-Romagna
2021-01-22,UMB,276,105,171,32,244,ITI,ITI2,10,Umbria
2021-05-02,SIC,24601,11427,13174,18000,6601,ITG,ITG1,19,Sicilia
2021-02-10,EMR,4022,1385,2637,2766,1256,ITH,ITH5,8,Emilia-Romagna
2021-01-07,ABR,1604,553,1051,1604,0,ITF,ITF1,13,Abruzzo
2021-05-02,UMB,3787,1868,1919,1333,2454,ITI,ITI2,10,Umbria
2021-04-08,EMR,31210,14332,16878,25907,5303,ITH,ITH5,8,Emilia-Romagna
2021-03-20,SIC,18574,8967,9607,13436,5138,ITG,ITG1,19,Sicilia
2021-02-08,CAM,5113,2449,2664,4310,803,ITF,ITF3,15,Campania
2021-03-20,UMB,2308,842,1466,2283,25,ITI,ITI2,10,Umbria
2021-02-06,TOS,4527,1550,2977,1294,3233,ITI,ITI1,9,Toscana
2021-02-02,PAB,1745,506,1239,8,1737,ITH,ITH1,4,Provincia Autonoma Bolzano / Bozen
2021-06-23,FVG,11752,5682,6070,1989,9763,ITH,ITH4,6,Friuli-Venezia Giulia
2021-05-16,LAZ,50926,24520,26406,37441,13485,ITI,ITI4,12,Lazio
2021-02-01,LIG,2557,922,1635,90,2467,ITC,ITC3,7,Liguria
2021-03-16,SIC,9558,4277,5281,3623,5935,ITG,ITG1,19,Sicilia
2021-06-19,FVG,8339,4346,3993,1294,7045,ITH,ITH4,6,Friuli-Venezia Giulia
2021-01-05,PAB,830,286,544,830,0,ITH,ITH1,4,Provincia Autonoma Bolzano / Bozen
2021-02-04,PAT,976,304,672,422,554,ITH,ITH2,4,Provincia Autonoma Trento
2021-02-15,BAS,622,232,390,580,42,ITF,ITF5,17,Basilicata
2021-05-08,LIG,7529,3334,4195,2316,5213,ITC,ITC3,7,Liguria
2021-01-09,VEN,7928,2539,5389,7928,0,ITH,ITH3,5,Veneto
2021-01-29,BAS,616,231,385,63,553,ITF,ITF5,17,Basilicata
2021-05-26,CAM,52610,25781,26829,21549,31061,ITF,ITF3,15,Campania
2021-01-23,PAB,197,117,80,0,197,ITH,ITH1,4,Provincia Autonoma Bolzano / Bozen
2021-01-25,LIG,2726,889,1837,478,2248,ITC,ITC3,7,Liguria
2021-04-03,UMB,2112,717,1395,1059,1053,ITI,ITI2,10,Umbria
2021-03-18,VEN,12612,5138,7474,7385,5227,ITH,ITH3,5,Veneto
2021-05-05,LIG,13715,6135,7580,5294,8421,ITC,ITC3,7,Liguria
2021-06-14,SAR,13735,6634,7101,10126,3609,ITG,ITG2,20,Sardegna
2021-03-06,SAR,2638,1079,1559,858,1780,ITG,ITG2,20,Sardegna
2021-02-27,SIC,12236,5501,6735,11032,1204,ITG,ITG1,19,Sicilia
2021-03-11,FVG,3474,1515,1959,1723,1751,ITH,ITH4,6,Friuli-Venezia Giulia
2021-05-27,ABR,13205,6037,7168,8383,4822,ITF,ITF1,13,Abruzzo
2021-05-03,PAB,1830,847,983,417,1413,ITH,ITH1,4,Provincia Autonoma Bolzano / Bozen
2021-03-05,BAS,1855,857,998,1109,746,ITF,ITF5,17,Basilicata
2021-06-02,PIE,26531,12998,13533,22062,4469,ITC,ITC1,1,Piemonte
2021-06-21,LAZ,61185,28356,32829,28839,32346,ITI,ITI4,12,Lazio
2021-02-23,PAB,769,324,445,763,6,ITH,ITH1,4,Provincia Autonoma Bolzano / Bozen
2021-02-04,MAR,2385,842,1543,112,2273,ITI,ITI3,11,Marche
2021-02-22,PIE,8483,3472,5011,7893,590,ITC,ITC1,1,Piemonte
2021-06-13,BAS,3010,1437,1573,2702,308,ITF,ITF5,17,Basilicata
2021-04-13,PAT,2555,1058,1497,2048,507,ITH,ITH2,4,Provincia Autonoma Trento
2021-01-20,PAT,292,73,219,280,12,ITH,ITH2,4,Provincia Autonoma Trento
2021-05-17,PAB,3139,1516,1623,2445,694,ITH,ITH1,4,Provincia Autonoma Bolzano / Bozen
2021-03-02,PUG,16386,6091,10295,15084,1302,ITF,ITF4,16,Puglia
2021-04-06,SAR,7461,3123,4338,5032,2429,ITG,ITG2,20,Sardegna
2021-04-25,LOM,51496,23612,27884,46753,4743,ITC,ITC4,3,Lombardia
2021-03-13,LAZ,21753,8685,13068,15859,5894,ITI,ITI4,12,Lazio
2021-03-17,VDA,433,185,248,273,160,ITC,ITC2,2,Valle d'Aosta / Vallée d'Aoste
2021-04-30,PAT,4927,2402,2525,4776,151,ITH,ITH2,4,Provincia Autonoma Trento
2020-12-27,SAR,65,34,31,65,0,ITG,ITG2,20,Sardegna
2021-03-11,PIE,13785,5084,8701,10688,3097,ITC,ITC1,1,Piemonte
2021-06-03,PAB,4721,2565,2156,3775,946,ITH,ITH1,4,Provincia Autonoma Bolzano / Bozen
2021-06-10,PUG,46596,22876,23720,29707,16889,ITF,ITF4,16,Puglia
2021-03-03,VDA,255,118,137,187,68,ITC,ITC2,2,Valle d'Aosta / Vallée d'Aoste
2021-04-06,CAM,24514,11564,12950,19990,4524,ITF,ITF3,15,Campania
2021-05-19,PAT,5097,2455,2642,3842,1255,ITH,ITH2,4,Provincia Autonoma Trento
2021-04-04,PUG,5965,2962,3003,5960,5,ITF,ITF4,16,Puglia
2020-12-27,CAM,720,422,298,720,0,ITF,ITF3,15,Campania
2021-03-19,ABR,5795,2585,3210,2775,3020,ITF,ITF1,13,Abruzzo
2021-05-23,CAL,11384,5552,5832,7034,4350,ITF,ITF6,18,Calabria
2021-02-08,SIC,3882,1678,2204,2129,1753,ITG,ITG1,19,Sicilia
2021-01-18,MAR,696,237,459,547,149,ITI,ITI3,11,Marche
2021-03-01,CAL,2724,1546,1178,2269,455,ITF,ITF6,18,Calabria
2021-03-25,PIE,17062,7203,9859,8423,8639,ITC,ITC1,1,Piemonte
2021-05-27,BAS,3604,1857,1747,1073,2531,ITF,ITF5,17,Basilicata
2021-01-08,UMB,1190,345,845,1190,0,ITI,ITI2,10,Umbria
2021-01-09,MOL,450,152,298,450,0,ITF,ITF2,14,Molise
2021-04-20,CAM,32032,15498,16534,20722,11310,ITF,ITF3,15,Campania
2021-03-21,PUG,2694,1227,1467,590,2104,ITF,ITF4,16,Puglia
2021-04-06,LOM,43056,17583,25473,25122,17934,ITC,ITC4,3,Lombardia
2021-04-28,MAR,10753,4900,5853,6021,4732,ITI,ITI3,11,Marche
2021-06-09,CAL,17497,8213,9284,15262,2235,ITF,ITF6,18,Calabria
2021-03-05,ABR,5349,1958,3391,4652,697,ITF,ITF1,13,Abruzzo
2021-04-19,MOL,1827,842,985,1049,778,ITF,ITF2,14,Molise
2021-02-20,TOS,4640,1789,2851,4127,513,ITI,ITI1,9,Toscana
2021-04-13,FVG,7365,3289,4076,5762,1603,ITH,ITH4,6,Friuli-Venezia Giulia
2021-01-03,FVG,312,122,190,312,0,ITH,ITH4,6,Friuli-Venezia Giulia
2021-05-31,TOS,30269,14598,15671,19451,10818,ITI,ITI1,9,Toscana
2021-03-20,CAM,13985,6525,7460,10246,3739,ITF,ITF3,15,Campania
2021-06-04,EMR,45489,22909,22580,37376,8113,ITH,ITH5,8,Emilia-Romagna
2021-01-22,SIC,1274,636,638,262,1012,ITG,ITG1,19,Sicilia
2021-05-14,TOS,33308,15400,17908,20656,12652,ITI,ITI1,9,Toscana
2021-05-07,VEN,48474,23222,25252,39807,8667,ITH,ITH3,5,Veneto
2021-03-16,LIG,6082,2731,3351,2349,3733,ITC,ITC3,7,Liguria
2021-05-23,UMB,5069,1855,3214,652,4417,ITI,ITI2,10,Umbria
2021-01-27,VEN,7141,2064,5077,241,6900,ITH,ITH3,5,Veneto
2021-02-08,LAZ,9740,4153,5587,4508,5232,ITI,ITI4,12,Lazio
2021-04-25,SAR,4497,2269,2228,3718,779,ITG,ITG2,20,Sardegna
2021-01-08,SIC,8107,3778,4329,8107,0,ITG,ITG1,19,Sicilia
2021-01-20,FVG,748,320,428,13,735,ITH,ITH4,6,Friuli-Venezia Giulia
2021-04-07,ABR,7223,3335,3888,4438,2785,ITF,ITF1,13,Abruzzo
2021-01-15,SAR,1563,573,990,1563,0,ITG,ITG2,20,Sardegna
2021-06-22,PAB,2449,1408,1041,333,2116,ITH,ITH1,4,Provincia Autonoma Bolzano / Bozen
2021-04-18,SIC,19706,9848,9858,15345,4361,ITG,ITG1,19,Sicilia
2021-03-14,PAB,758,336,422,25,733,ITH,ITH1,4,Provincia Autonoma Bolzano / Bozen
2021-02-01,SAR,1524,605,919,225,1299,ITG,ITG2,20,Sardegna
2021-04-14,PAB,3593,1645,1948,3502,91,ITH,ITH1,4,Provincia Autonoma Bolzano / Bozen
2021-01-26,VDA,139,48,91,0,139,ITC,ITC2,2,Valle d'Aosta / Vallée d'Aoste
2021-04-24,BAS,4543,2197,2346,3530,1013,ITF,ITF5,17,Basilicata
2021-05-02,LAZ,32635,14338,18297,23273,9362,ITI,ITI4,12,Lazio
2021-05-09,SAR,6129,2874,3255,5203,926,ITG,ITG2,20,Sardegna
2021-01-04,PAB,508,201,307,508,0,ITH,ITH1,4,Provincia Autonoma Bolzano / Bozen
2021-01-11,PUG,3754,1588,2166,3754,0,ITF,ITF4,16,Puglia
2021-02-12,VDA,263,96,167,217,46,ITC,ITC2,2,Valle d'Aosta / Vallée d'Aoste
2021-06-02,PAT,2838,1359,1479,944,1894,ITH,ITH2,4,Provincia Autonoma Trento
2021-06-14,LOM,94155,47854,46301,49712,44443,ITC,ITC4,3,Lombardia
2021-03-26,MAR,6333,2607,3726,3525,2808,ITI,ITI3,11,Marche
2021-04-13,PIE,25942,11613,14329,22483,3459,ITC,ITC1,1,Piemonte
2021-04-21,PUG,23088,10659,12429,19353,3735,ITF,ITF4,16,Puglia
2021-05-26,SAR,14937,7674,7263,9875,5062,ITG,ITG2,20,Sardegna
2021-04-02,PUG,12841,5999,6842,8317,4524,ITF,ITF4,16,Puglia
2021-05-28,CAL,20979,10193,10786,11519,9460,ITF,ITF6,18,Calabria
2021-01-21,MOL,6,2,4,6,0,ITF,ITF2,14,Molise
2021-04-08,CAM,28380,13740,14640,22538,5842,ITF,ITF3,15,Campania
2021-05-21,LOM,93798,45226,48572,29137,64661,ITC,ITC4,3,Lombardia
2021-01-23,MAR,557,190,367,123,434,ITI,ITI3,11,Marche
2021-02-20,PAT,407,245,162,123,284,ITH,ITH2,4,Provincia Autonoma Trento
2021-06-01,BAS,6135,2925,3210,3059,3076,ITF,ITF5,17,Basilicata
2021-06-04,CAM,74206,35647,38559,65166,9040,ITF,ITF3,15,Campania
2021-04-15,CAL,7688,3766,3922,5996,1692,ITF,ITF6,18,Calabria
2021-05-03,MAR,10213,4612,5601,4806,5407,ITI,ITI3,11,Marche
2021-02-27,FVG,3530,1200,2330,3529,1,ITH,ITH4,6,Friuli-Venezia Giulia
2021-02-28,ABR,1702,508,1194,1700,2,ITF,ITF1,13,Abruzzo
2021-05-07,SIC,36550,17257,19293,24937,11613,ITG,ITG1,19,Sicilia
2021-06-02,TOS,27572,13609,13963,22067,5505,ITI,ITI1,9,Toscana
2021-01-02,ABR,552,220,332,552,0,ITF,ITF1,13,Abruzzo
2021-03-11,SIC,15339,6620,8719,12969,2370,ITG,ITG1,19,Sicilia
2021-04-06,TOS,22216,9816,12400,18501,3715,ITI,ITI1,9,Toscana
2021-04-25,FVG,2365,990,1375,2354,11,ITH,ITH4,6,Friuli-Venezia Giulia
2021-05-23,EMR,25475,11859,13616,13884,11591,ITH,ITH5,8,Emilia-Romagna
2021-06-08,ABR,12639,6497,6142,10442,2197,ITF,ITF1,13,Abruzzo
2021-02-08,TOS,4097,1360,2737,3638,459,ITI,ITI1,9,Toscana
2021-04-01,CAL,8529,3865,4664,3986,4543,ITF,ITF6,18,Calabria
2021-01-27,SIC,7283,3710,3573,178,7105,ITG,ITG1,19,Sicilia
2021-04-26,ABR,8561,4065,4496,7347,1214,ITF,ITF1,13,Abruzzo
2021-05-19,TOS,27920,13559,14361,18883,9037,ITI,ITI1,9,Toscana
2021-05-21,CAM,63664,29566,34098,43175,20489,ITF,ITF3,15,Campania
2021-01-30,LIG,1661,567,1094,24,1637,ITC,ITC3,7,Liguria
2021-03-23,VEN,22206,10237,11969,17497,4709,ITH,ITH3,5,Veneto
2021-05-15,PAB,7001,3688,3313,6707,294,ITH,ITH1,4,Provincia Autonoma Bolzano / Bozen
2021-02-03,LAZ,6488,2488,4000,964,5524,ITI,ITI4,12,Lazio
2021-02-04,PAB,1958,593,1365,8,1950,ITH,ITH1,4,Provincia Autonoma Bolzano / Bozen
2021-05-19,VEN,32893,15067,17826,16984,15909,ITH,ITH3,5,Veneto
2021-01-13,SIC,5175,2437,2738,5175,0,ITG,ITG1,19,Sicilia
2021-01-15,FVG,2021,605,1416,2021,0,ITH,ITH4,6,Friuli-Venezia Giulia
2021-06-01,ABR,10996,4881,6115,6630,4366,ITF,ITF1,13,Abruzzo
2021-03-28,LIG,1141,511,630,390,751,ITC,ITC3,7,Liguria
2021-05-07,SAR,14449,6623,7826,9948,4501,ITG,ITG2,20,Sardegna
2021-04-13,TOS,8487,3506,4981,6030,2457,ITI,ITI1,9,Toscana
2021-01-20,LAZ,4807,1943,2864,3264,1543,ITI,ITI4,12,Lazio
2021-01-27,SAR,1413,497,916,79,1334,ITG,ITG2,20,Sardegna
2021-03-28,MAR,4125,1739,2386,2434,1691,ITI,ITI3,11,Marche
2021-01-08,PAT,1449,313,1136,1449,0,ITH,ITH2,4,Provincia Autonoma Trento
2021-01-31,VDA,291,91,200,58,233,ITC,ITC2,2,Valle d'Aosta / Vallée d'Aoste
2021-06-14,PAT,5740,2968,2772,2117,3623,ITH,ITH2,4,Provincia Autonoma Trento
2021-01-30,MAR,1905,668,1237,28,1877,ITI,ITI3,11,Marche
2021-02-27,PIE,12691,4851,7840,12346,345,ITC,ITC1,1,Piemonte
2021-03-25,SAR,9114,3971,5143,7808,1306,ITG,ITG2,20,Sardegna
2021-06-08,BAS,4667,2224,2443,4219,448,ITF,ITF5,17,Basilicata
2021-04-18,PAT,1855,845,1010,1846,9,ITH,ITH2,4,Provincia Autonoma Trento
2021-04-16,PUG,35966,16903,19063,32684,3282,ITF,ITF4,16,Puglia
2021-04-25,PIE,20233,9305,10928,17732,2501,ITC,ITC1,1,Piemonte
2021-05-14,LAZ,51443,23505,27938,33158,18285,ITI,ITI4,12,Lazio
2021-05-21,SAR,21151,10366,10785,15500,5651,ITG,ITG2,20,Sardegna
2021-02-08,VEN,5003,1559,3444,1929,3074,ITH,ITH3,5,Veneto
2021-04-02,PAB,2077,837,1240,720,1357,ITH,ITH1,4,Provincia Autonoma Bolzano / Bozen
2021-01-15,PIE,9114,3012,6102,9114,0,ITC,ITC1,1,Piemonte
2021-02-18,PUG,4378,1846,2532,3773,605,ITF,ITF4,16,Puglia
2021-03-18,LAZ,14225,6078,8147,7834,6391,ITI,ITI4,12,Lazio
2021-05-07,LOM,92265,43687,48578,69892,22373,ITC,ITC4,3,Lombardia
2021-06-21,PIE,38161,19025,19136,17511,20650,ITC,ITC1,1,Piemonte
2021-03-06,PAT,786,277,509,635,151,ITH,ITH2,4,Provincia Autonoma Trento
2021-04-06,VEN,28928,13312,15616,23876,5052,ITH,ITH3,5,Veneto
2021-05-29,PAB,7134,3768,3366,3994,3140,ITH,ITH1,4,Provincia Autonoma Bolzano / Bozen
2021-01-28,MOL,613,217,396,17,596,ITF,ITF2,14,Molise
2021-03-13,PIE,13047,4723,8324,11602,1445,ITC,ITC1,1,Piemonte
2021-04-01,CAM,24679,12010,12669,20546,4133,ITF,ITF3,15,Campania
2021-03-18,LOM,27384,10953,16431,16150,11234,ITC,ITC4,3,Lombardia
2021-04-08,CAL,9406,4435,4971,5808,3598,ITF,ITF6,18,Calabria
2021-04-09,PUG,21991,9469,12522,17368,4623,ITF,ITF4,16,Puglia
2021-05-28,CAM,72968,35247,37721,26889,46079,ITF,ITF3,15,Campania
2021-02-10,CAL,2510,1079,1431,883,1627,ITF,ITF6,18,Calabria
2021-02-11,PUG,3697,1401,2296,2419,1278,ITF,ITF4,16,Puglia
2021-05-14,LOM,85863,41355,44508,55629,30234,ITC,ITC4,3,Lombardia
2021-03-12,MOL,1459,637,822,1423,36,ITF,ITF2,14,Molise
2021-04-11,PAT,2340,1135,1205,2249,91,ITH,ITH2,4,Provincia Autonoma Trento
2021-04-12,BAS,2168,1049,1119,1680,488,ITF,ITF5,17,Basilicata
2021-05-10,MAR,9448,4336,5112,4897,4551,ITI,ITI3,11,Marche
2021-05-22,PUG,34494,15788,18706,24116,10378,ITF,ITF4,16,Puglia
2021-01-14,MOL,646,239,407,646,0,ITF,ITF2,14,Molise
2021-03-14,MAR,2499,1032,1467,1907,592,ITI,ITI3,11,Marche
2021-06-04,CAL,17285,8033,9252,12752,4533,ITF,ITF6,18,Calabria
2021-01-20,SIC,952,506,446,691,261,ITG,ITG1,19,Sicilia
2021-04-18,FVG,6038,2800,3238,5631,407,ITH,ITH4,6,Friuli-Venezia Giulia
2021-04-19,ABR,6227,2858,3369,3855,2372,ITF,ITF1,13,Abruzzo
2021-01-08,FVG,2321,746,1575,2321,0,ITH,ITH4,6,Friuli-Venezia Giulia
2021-02-21,ABR,1218,550,668,1217,1,ITF,ITF1,13,Abruzzo
2021-05-26,TOS,35536,17066,18470,20385,15151,ITI,ITI1,9,Toscana
2021-06-14,FVG,9987,4827,5160,5222,4765,ITH,ITH4,6,Friuli-Venezia Giulia
2021-05-11,UMB,6241,2833,3408,4037,2204,ITI,ITI2,10,Umbria
2021-05-14,CAM,61003,27567,33436,36326,24677,ITF,ITF3,15,Campania
2021-03-30,TOS,17018,7642,9376,13455,3563,ITI,ITI1,9,Toscana
2021-05-21,CAL,21337,10861,10476,13974,7363,ITF,ITF6,18,Calabria
2021-02-20,FVG,2068,933,1135,1924,144,ITH,ITH4,6,Friuli-Venezia Giulia
2021-03-18,SIC,15284,7664,7620,9788,5496,ITG,ITG1,19,Sicilia
2021-06-15,ABR,11104,5475,5629,8686,2418,ITF,ITF1,13,Abruzzo
2021-01-22,FVG,90,30,60,0,90,ITH,ITH4,6,Friuli-Venezia Giulia
2021-04-16,LOM,53644,23915,29729,39305,14339,ITC,ITC4,3,Lombardia
2021-05-08,MAR,12268,5476,6792,5022,7246,ITI,ITI3,11,Marche
2021-06-19,CAL,15572,7292,8280,8313,7259,ITF,ITF6,18,Calabria
2021-01-11,PIE,8745,2981,5764,8745,0,ITC,ITC1,1,Piemonte
2021-02-06,SAR,1971,698,1273,569,1402,ITG,ITG2,20,Sardegna
2021-04-29,MOL,2238,1145,1093,891,1347,ITF,ITF2,14,Molise
2021-05-03,LOM,83679,39747,43932,71557,12122,ITC,ITC4,3,Lombardia
2021-04-23,FVG,7464,3377,4087,3602,3862,ITH,ITH4,6,Friuli-Venezia Giulia
2021-01-11,EMR,9348,3273,6075,9348,0,ITH,ITH5,8,Emilia-Romagna
2021-01-23,LOM,1115,357,758,916,199,ITC,ITC4,3,Lombardia
2021-02-23,SAR,1537,1026,511,1285,252,ITG,ITG2,20,Sardegna
2021-04-12,MOL,1299,557,742,1048,251,ITF,ITF2,14,Molise
2021-06-10,TOS,26302,13483,12819,25788,514,ITI,ITI1,9,Toscana
2021-05-24,TOS,33713,16699,17014,24144,9569,ITI,ITI1,9,Toscana
2021-06-17,LIG,16223,7697,8526,10478,5745,ITC,ITC3,7,Liguria
2021-01-19,PUG,1221,452,769,1211,10,ITF,ITF4,16,Puglia
2021-02-15,LAZ,8027,3541,4486,7396,631,ITI,ITI4,12,Lazio
2021-01-25,TOS,5126,1895,3231,247,4879,ITI,ITI1,9,Toscana
2021-01-29,LAZ,8042,3079,4963,813,7229,ITI,ITI4,12,Lazio
2021-03-18,PAT,2320,957,1363,1240,1080,ITH,ITH2,4,Provincia Autonoma Trento
2021-03-21,PAB,768,285,483,14,754,ITH,ITH1,4,Provincia Autonoma Bolzano / Bozen
2021-01-09,MAR,1711,606,1105,1711,0,ITI,ITI3,11,Marche
2021-04-30,VEN,49984,23475,26509,34321,15663,ITH,ITH3,5,Veneto
2021-06-12,PAB,4906,2659,2247,1619,3287,ITH,ITH1,4,Provincia Autonoma Bolzano / Bozen
2021-04-06,PIE,20247,8813,11434,15051,5196,ITC,ITC1,1,Piemonte
2021-05-02,SAR,5886,2669,3217,5305,581,ITG,ITG2,20,Sardegna
2021-05-30,UMB,5981,2998,2983,5780,201,ITI,ITI2,10,Umbria
2021-01-20,VEN,1038,368,670,386,652,ITH,ITH3,5,Veneto
2021-04-18,TOS,8357,4090,4267,7342,1015,ITI,ITI1,9,Toscana
2020-12-27,PIE,913,369,544,913,0,ITC,ITC1,1,Piemonte
2021-04-02,MAR,6886,2983,3903,6147,739,ITI,ITI3,11,Marche
2021-05-14,CAL,19916,9573,10343,13049,6867,ITF,ITF6,18,Calabria
2021-03-08,UMB,3702,1829,1873,2339,1363,ITI,ITI2,10,Umbria
2021-06-09,PAT,6233,3076,3157,2164,4069,ITH,ITH2,4,Provincia Autonoma Trento
2021-06-16,SIC,39715,18468,21247,21064,18651,ITG,ITG1,19,Sicilia
2021-01-14,PAB,1946,575,1371,1946,0,ITH,ITH1,4,Provincia Autonoma Bolzano / Bozen
2021-02-08,SAR,1470,533,937,856,614,ITG,ITG2,20,Sardegna
2021-03-16,MAR,3472,1485,1987,290,3182,ITI,ITI3,11,Marche
2021-04-27,CAL,9955,4893,5062,8008,1947,ITF,ITF6,18,Calabria
2021-06-16,UMB,6312,3089,3223,3219,3093,ITI,ITI2,10,Umbria
2021-01-19,VDA,256,77,179,256,0,ITC,ITC2,2,Valle d'Aosta / Vallée d'Aoste
2021-03-25,SIC,20356,9461,10895,14891,5465,ITG,ITG1,19,Sicilia
2021-06-22,ABR,10245,4802,5443,5401,4844,ITF,ITF1,13,Abruzzo
2021-04-07,PAB,1798,823,975,1258,540,ITH,ITH1,4,Provincia Autonoma Bolzano / Bozen
2021-02-03,CAL,2799,1442,1357,575,2224,ITF,ITF6,18,Calabria
2021-03-25,UMB,3904,1699,2205,2840,1064,ITI,ITI2,10,Umbria
2021-06-02,LIG,8530,4342,4188,5363,3167,ITC,ITC3,7,Liguria
2021-01-04,PUG,4508,2016,2492,4508,0,ITF,ITF4,16,Puglia
2021-06-21,LOM,111528,57160,54368,80767,30761,ITC,ITC4,3,Lombardia
2021-04-12,VDA,486,186,300,323,163,ITC,ITC2,2,Valle d'Aosta / Vallée d'Aoste
2021-04-29,VDA,1291,634,657,757,534,ITC,ITC2,2,Valle d'Aosta / Vallée d'Aoste
2021-06-02,CAM,42739,20107,22632,38109,4630,ITF,ITF3,15,Campania
2021-06-19,LIG,7091,3624,3467,5620,1471,ITC,ITC3,7,Liguria
2021-02-17,LAZ,9184,4606,4578,8309,875,ITI,ITI4,12,Lazio
2021-02-22,CAM,10681,3294,7387,10418,263,ITF,ITF3,15,Campania
2021-03-02,PAB,695,200,495,693,2,ITH,ITH1,4,Provincia Autonoma Bolzano / Bozen
2021-03-07,MOL,1132,501,631,1130,2,ITF,ITF2,14,Molise
2021-04-06,PAT,2261,950,1311,1496,765,ITH,ITH2,4,Provincia Autonoma Trento
2021-04-17,BAS,3461,1655,1806,2199,1262,ITF,ITF5,17,Basilicata
2021-06-24,MAR,13881,6692,7189,6516,7365,ITI,ITI3,11,Marche
2021-05-28,LAZ,56760,26290,30470,43683,13077,ITI,ITI4,12,Lazio
2021-06-15,MOL,2100,983,1117,649,1451,ITF,ITF2,14,Molise
2021-03-11,CAM,17998,9057,8941,10719,7279,ITF,ITF3,15,Campania
2021-03-19,PAB,1906,773,1133,799,1107,ITH,ITH1,4,Provincia Autonoma Bolzano / Bozen
2021-06-02,LOM,84626,43572,41054,78295,6331,ITC,ITC4,3,Lombardia
2021-03-06,SIC,12638,5058,7580,9856,2782,ITG,ITG1,19,Sicilia
2021-06-09,FVG,11063,5827,5236,9694,1369,ITH,ITH4,6,Friuli-Venezia Giulia
2021-03-11,LOM,36209,13473,22736,26302,9907,ITC,ITC4,3,Lombardia
2021-05-16,CAM,51145,23225,27920,33573,17572,ITF,ITF3,15,Campania
2021-06-11,EMR,44864,23300,21564,38379,6485,ITH,ITH5,8,Emilia-Romagna
2021-02-20,CAM,8573,3080,5493,8270,303,ITF,ITF3,15,Campania
2021-03-29,BAS,2434,880,1554,2147,287,ITF,ITF5,17,Basilicata
2021-03-27,UMB,4254,1513,2741,3914,340,ITI,ITI2,10,Umbria
2021-06-17,MOL,2306,1017,1289,937,1369,ITF,ITF2,14,Molise
2021-06-14,SIC,42386,20155,22231,27634,14752,ITG,ITG1,19,Sicilia
2021-01-05,BAS,946,409,537,946,0,ITF,ITF5,17,Basilicata
2021-03-01,FVG,2957,1041,1916,2905,52,ITH,ITH4,6,Friuli-Venezia Giulia
2021-03-20,EMR,16085,6829,9256,9121,6964,ITH,ITH5,8,Emilia-Romagna
2021-03-18,FVG,3372,1421,1951,1691,1681,ITH,ITH4,6,Friuli-Venezia Giulia
2021-03-26,PUG,11921,5765,6156,7276,4645,ITF,ITF4,16,Puglia
2021-05-28,SIC,51190,22949,28241,24716,26474,ITG,ITG1,19,Sicilia
2021-06-16,VEN,47078,23218,23860,25909,21169,ITH,ITH3,5,Veneto
2021-03-09,PUG,13597,6069,7528,11587,2010,ITF,ITF4,16,Puglia
2021-04-06,EMR,24747,11174,13573,20005,4742,ITH,ITH5,8,Emilia-Romagna
2021-01-01,VEN,1528,471,1057,1528,0,ITH,ITH3,5,Veneto
2021-01-13,PAT,421,123,298,421,0,ITH,ITH2,4,Provincia Autonoma Trento
2020-12-27,EMR,972,373,599,972,0,ITH,ITH5,8,Emilia-Romagna
2021-02-18,LIG,2768,1126,1642,2434,334,ITC,ITC3,7,Liguria
2021-03-06,LAZ,18358,7084,11274,14101,4257,ITI,ITI4,12,Lazio
2021-03-25,VEN,25950,11054,14896,19851,6099,ITH,ITH3,5,Veneto
2021-06-09,PIE,38548,20320,18228,35843,2705,ITC,ITC1,1,Piemonte
2021-02-03,CAM,8903,4003,4900,878,8025,ITF,ITF3,15,Campania
2021-04-11,VEN,21009,8876,12133,14702,6307,ITH,ITH3,5,Veneto
2021-06-20,BAS,4005,1880,2125,1968,2037,ITF,ITF5,17,Basilicata
2021-01-11,MAR,1176,411,765,1176,0,ITI,ITI3,11,Marche
2021-02-22,CAL,2051,1042,1009,1493,558,ITF,ITF6,18,Calabria
2021-03-18,PIE,11759,4805,6954,4029,7730,ITC,ITC1,1,Piemonte
2021-02-26,BAS,2149,904,1245,2069,80,ITF,ITF5,17,Basilicata
2021-02-03,UMB,725,174,551,67,658,ITI,ITI2,10,Umbria
2021-03-10,VDA,438,183,255,225,213,ITC,ITC2,2,Valle d'Aosta / Vallée d'Aoste
2021-03-20,LAZ,19089,7552,11537,13204,5885,ITI,ITI4,12,Lazio
2021-05-07,PAT,5997,3085,2912,5156,841,ITH,ITH2,4,Provincia Autonoma Trento
2021-05-14,SIC,52061,24405,27656,36374,15687,ITG,ITG1,19,Sicilia
2021-02-16,PAB,530,205,325,530,0,ITH,ITH1,4,Provincia Autonoma Bolzano / Bozen
2021-02-23,PUG,9351,4421,4930,8873,478,ITF,ITF4,16,Puglia
2021-04-20,PAT,2879,1377,1502,2843,36,ITH,ITH2,4,Provincia Autonoma Trento
2021-05-02,LOM,83498,38332,45166,61036,22462,ITC,ITC4,3,Lombardia
2021-01-06,SAR,1615,549,1066,1615,0,ITG,ITG2,20,Sardegna
2021-02-11,MAR,1987,657,1330,1598,389,ITI,ITI3,11,Marche
2021-03-25,CAL,7408,3468,3940,4554,2854,ITF,ITF6,18,Calabria
2021-01-28,PAB,871,308,563,9,862,ITH,ITH1,4,Provincia Autonoma Bolzano / Bozen
2021-02-02,MOL,539,176,363,216,323,ITF,ITF2,14,Molise
2021-02-21,VDA,18,3,15,0,18,ITC,ITC2,2,Valle d'Aosta / Vallée d'Aoste
2021-05-09,PAT,2324,1210,1114,1980,344,ITH,ITH2,4,Provincia Autonoma Trento
2021-05-20,BAS,5857,2965,2892,2892,2965,ITF,ITF5,17,Basilicata
2021-01-16,MOL,420,166,254,420,0,ITF,ITF2,14,Molise
2021-04-13,CAM,26604,12683,13921,21072,5532,ITF,ITF3,15,Campania
2021-05-05,MAR,11650,5301,6349,5221,6429,ITI,ITI3,11,Marche
2021-06-16,CAL,17895,8252,9643,11810,6085,ITF,ITF6,18,Calabria
2021-01-03,CAM,3836,2009,1827,3836,0,ITF,ITF3,15,Campania
2021-02-15,PAT,534,188,346,420,114,ITH,ITH2,4,Provincia Autonoma Trento
2021-04-26,MOL,1157,521,636,826,331,ITF,ITF2,14,Molise
2021-06-06,BAS,4502,2070,2432,3723,779,ITF,ITF5,17,Basilicata
2021-06-01,VDA,871,469,402,518,353,ITC,ITC2,2,Valle d'Aosta / Vallée d'Aoste
2021-04-08,LAZ,26728,12241,14487,19035,7693,ITI,ITI4,12,Lazio
2021-05-26,PAT,3917,1843,2074,1225,2692,ITH,ITH2,4,Provincia Autonoma Trento
2021-04-09,MOL,2323,1251,1072,2132,191,ITF,ITF2,14,Molise
2021-04-13,LOM,47601,21249,26352,33527,14074,ITC,ITC4,3,Lombardia
2021-06-07,TOS,34801,17044,17757,31192,3609,ITI,ITI1,9,Toscana
2021-06-23,SAR,20515,9652,10863,6278,14237,ITG,ITG2,20,Sardegna
2021-01-15,SIC,4992,2175,2817,4992,0,ITG,ITG1,19,Sicilia
2021-04-20,FVG,7111,3060,4051,3208,3903,ITH,ITH4,6,Friuli-Venezia Giulia
2021-05-28,EMR,41161,18926,22235,17844,23317,ITH,ITH5,8,Emilia-Romagna
2021-04-25,SIC,21352,10183,11169,16376,4976,ITG,ITG1,19,Sicilia
2021-05-21,TOS,28870,13446,15424,17463,11407,ITI,ITI1,9,Toscana
2021-04-30,LOM,117215,54779,62436,89730,27485,ITC,ITC4,3,Lombardia
2021-02-01,SIC,5895,2618,3277,294,5601,ITG,ITG1,19,Sicilia
2021-01-20,LOM,5663,1377,4286,5549,114,ITC,ITC4,3,Lombardia
2021-01-18,MOL,114,48,66,114,0,ITF,ITF2,14,Molise
2021-04-27,VEN,28124,12751,15373,21207,6917,ITH,ITH3,5,Veneto
2021-03-22,SIC,16573,7832,8741,11210,5363,ITG,ITG1,19,Sicilia
2021-04-22,EMR,29048,13449,15599,14970,14078,ITH,ITH5,8,Emilia-Romagna
2021-06-19,ABR,10310,5080,5230,6482,3828,ITF,ITF1,13,Abruzzo
2021-01-17,VEN,1933,781,1152,1584,349,ITH,ITH3,5,Veneto
2021-02-05,UMB,780,234,546,18,762,ITI,ITI2,10,Umbria
2021-01-12,EMR,9476,3124,6352,9476,0,ITH,ITH5,8,Emilia-Romagna
2020-12-29,SIC,243,152,91,243,0,ITG,ITG1,19,Sicilia
2021-01-10,FVG,2939,918,2021,2939,0,ITH,ITH4,6,Friuli-Venezia Giulia
2021-03-28,ABR,2415,1015,1400,2044,371,ITF,ITF1,13,Abruzzo
2021-06-25,PIE,42535,21155,21380,18441,24094,ITC,ITC1,1,Piemonte
2021-04-11,MOL,1196,591,605,1182,14,ITF,ITF2,14,Molise
2021-01-18,PUG,1845,771,1074,1496,349,ITF,ITF4,16,Puglia
2021-04-14,BAS,2041,998,1043,1367,674,ITF,ITF5,17,Basilicata
2021-04-05,FVG,2895,1438,1457,2880,15,ITH,ITH4,6,Friuli-Venezia Giulia
2021-04-03,PIE,19434,8159,11275,10887,8547,ITC,ITC1,1,Piemonte
2021-01-21,BAS,30,10,20,30,0,ITF,ITF5,17,Basilicata
2021-02-03,VEN,5945,1667,4278,480,5465,ITH,ITH3,5,Veneto
2021-01-10,PIE,5214,2275,2939,5214,0,ITC,ITC1,1,Piemonte
2021-06-13,SIC,33479,16637,16842,29994,3485,ITG,ITG1,19,Sicilia
2021-01-04,BAS,607,271,336,607,0,ITF,ITF5,17,Basilicata
2021-01-22,LOM,3142,868,2274,3073,69,ITC,ITC4,3,Lombardia
2021-06-16,LIG,15670,7541,8129,10158,5512,ITC,ITC3,7,Liguria
2021-01-12,FVG,2260,713,1547,2260,0,ITH,ITH4,6,Friuli-Venezia Giulia
2021-04-25,PAB,3073,1497,1576,2401,672,ITH,ITH1,4,Provincia Autonoma Bolzano / Bozen
2021-01-29,FVG,2412,813,1599,264,2148,ITH,ITH4,6,Friuli-Venezia Giulia
2021-02-06,PUG,4548,1930,2618,1592,2956,ITF,ITF4,16,Puglia
2021-03-01,TOS,4473,1733,2740,832,3641,ITI,ITI1,9,Toscana
2021-04-29,VEN,50227,23365,26862,37043,13184,ITH,ITH3,5,Veneto
2021-01-20,PUG,1548,542,1006,1540,8,ITF,ITF4,16,Puglia
2021-03-08,LIG,5623,2458,3165,3934,1689,ITC,ITC3,7,Liguria
2021-04-30,PUG,34912,15635,19277,22946,11966,ITF,ITF4,16,Puglia
2021-04-22,FVG,6775,3081,3694,3087,3688,ITH,ITH4,6,Friuli-Venezia Giulia
2021-02-05,VEN,8377,2534,5843,1417,6960,ITH,ITH3,5,Veneto
2021-04-14,ABR,6593,2948,3645,4475,2118,ITF,ITF1,13,Abruzzo
2021-05-07,MAR,12838,5806,7032,3659,9179,ITI,ITI3,11,Marche
2021-06-18,CAL,18447,8576,9871,10958,7489,ITF,ITF6,18,Calabria
2021-04-12,UMB,7092,3079,4013,5374,1718,ITI,ITI2,10,Umbria
2021-02-22,VEN,7014,3041,3973,6627,387,ITH,ITH3,5,Veneto
2021-03-25,LIG,9762,4229,5533,6369,3393,ITC,ITC3,7,Liguria
2021-04-13,PUG,28699,13611,15088,25299,3400,ITF,ITF4,16,Puglia
2021-02-13,MAR,1093,462,631,1011,82,ITI,ITI3,11,Marche
2021-01-19,UMB,103,23,80,103,0,ITI,ITI2,10,Umbria
2021-02-23,VDA,216,123,93,216,0,ITC,ITC2,2,Valle d'Aosta / Vallée d'Aoste
2021-01-01,LIG,144,55,89,144,0,ITC,ITC3,7,Liguria
2021-04-05,EMR,14846,6800,8046,11954,2892,ITH,ITH5,8,Emilia-Romagna
2021-05-16,VEN,28423,14013,14410,21333,7090,ITH,ITH3,5,Veneto
2021-01-04,ABR,1403,576,827,1403,0,ITF,ITF1,13,Abruzzo
2021-01-27,MAR,2118,780,1338,122,1996,ITI,ITI3,11,Marche
2021-03-10,CAL,6561,3317,3244,5277,1284,ITF,ITF6,18,Calabria
2021-04-29,UMB,5216,2248,2968,2890,2326,ITI,ITI2,10,Umbria
2021-05-18,SAR,14052,6787,7265,9509,4543,ITG,ITG2,20,Sardegna
2021-01-13,PAB,1691,557,1134,1691,0,ITH,ITH1,4,Provincia Autonoma Bolzano / Bozen
2021-03-24,UMB,4106,1792,2314,2783,1323,ITI,ITI2,10,Umbria
2021-01-23,ABR,264,115,149,57,207,ITF,ITF1,13,Abruzzo
2021-02-14,BAS,151,48,103,151,0,ITF,ITF5,17,Basilicata
2021-06-09,UMB,8049,3897,4152,7326,723,ITI,ITI2,10,Umbria
2021-05-16,EMR,25844,12167,13677,18734,7110,ITH,ITH5,8,Emilia-Romagna
2021-06-23,UMB,11199,5721,5478,7785,3414,ITI,ITI2,10,Umbria
2021-01-27,CAL,1461,735,726,397,1064,ITF,ITF6,18,Calabria
2021-01-28,PUG,5475,2278,3197,472,5003,ITF,ITF4,16,Puglia
2021-01-12,ABR,1805,667,1138,1805,0,ITF,ITF1,13,Abruzzo
2021-03-18,CAM,12175,5380,6795,5986,6189,ITF,ITF3,15,Campania
2021-04-15,LAZ,31934,14309,17625,21121,10813,ITI,ITI4,12,Lazio
2021-01-31,BAS,77,24,53,0,77,ITF,ITF5,17,Basilicata
2021-02-22,EMR,7482,3091,4391,7210,272,ITH,ITH5,8,Emilia-Romagna
2021-03-15,UMB,4616,1950,2666,2848,1768,ITI,ITI2,10,Umbria
2021-06-23,SIC,43764,20315,23449,17491,26273,ITG,ITG1,19,Sicilia
2021-02-01,TOS,5509,1958,3551,521,4988,ITI,ITI1,9,Toscana
2021-05-25,ABR,11420,5324,6096,8283,3137,ITF,ITF1,13,Abruzzo
2021-02-10,LAZ,8188,3399,4789,4849,3339,ITI,ITI4,12,Lazio
2021-02-10,UMB,715,349,366,700,15,ITI,ITI2,10,Umbria
2021-03-13,PAT,833,382,451,785,48,ITH,ITH2,4,Provincia Autonoma Trento
2021-05-09,VEN,35041,16115,18926,24982,10059,ITH,ITH3,5,Veneto
2021-05-21,LAZ,51791,24851,26940,37856,13935,ITI,ITI4,12,Lazio
2021-05-31,MAR,11781,5942,5839,8851,2930,ITI,ITI3,11,Marche
2021-04-05,VDA,464,223,241,458,6,ITC,ITC2,2,Valle d'Aosta / Vallée d'Aoste
2021-06-04,LAZ,61291,29849,31442,43718,17573,ITI,ITI4,12,Lazio
2021-05-02,FVG,6897,3247,3650,3939,2958,ITH,ITH4,6,Friuli-Venezia Giulia
2021-02-20,PIE,3834,1254,2580,3660,174,ITC,ITC1,1,Piemonte
2021-05-17,MAR,11854,5568,6286,7691,4163,ITI,ITI3,11,Marche
2021-01-12,BAS,217,88,129,217,0,ITF,ITF5,17,Basilicata
2021-02-11,MOL,293,133,160,257,36,ITF,ITF2,14,Molise
2021-06-05,PAB,6067,3022,3045,4973,1094,ITH,ITH1,4,Provincia Autonoma Bolzano / Bozen
2021-03-04,LOM,29312,12106,17206,20254,9058,ITC,ITC4,3,Lombardia
2021-04-04,LIG,756,366,390,507,249,ITC,ITC3,7,Liguria
2021-04-23,PUG,29466,13694,15772,24211,5255,ITF,ITF4,16,Puglia
2021-01-31,ABR,1521,493,1028,288,1233,ITF,ITF1,13,Abruzzo
2021-05-04,LAZ,39863,18340,21523,26347,13516,ITI,ITI4,12,Lazio
2021-05-22,MOL,1314,711,603,1230,84,ITF,ITF2,14,Molise
2021-06-21,PAT,6127,3307,2820,3730,2397,ITH,ITH2,4,Provincia Autonoma Trento
2021-04-18,LIG,2613,1164,1449,2145,468,ITC,ITC3,7,Liguria
2021-05-16,FVG,9986,4778,5208,8587,1399,ITH,ITH4,6,Friuli-Venezia Giulia
2021-05-26,VEN,31041,15173,15868,14577,16464,ITH,ITH3,5,Veneto
2021-05-28,SAR,17945,8691,9254,13670,4275,ITG,ITG2,20,Sardegna
2021-05-10,ABR,10099,4779,5320,5451,4648,ITF,ITF1,13,Abruzzo
2021-02-17,SAR,1407,577,830,1333,74,ITG,ITG2,20,Sardegna
2021-04-30,PAB,3338,1592,1746,1562,1776,ITH,ITH1,4,Provincia Autonoma Bolzano / Bozen
2021-04-29,PIE,48454,21977,26477,35836,12618,ITC,ITC1,1,Piemonte
2021-05-25,SAR,14469,7161,7308,8593,5876,ITG,ITG2,20,Sardegna
2021-01-08,LIG,2926,999,1927,2926,0,ITC,ITC3,7,Liguria
2021-01-20,PAB,617,252,365,409,208,ITH,ITH1,4,Provincia Autonoma Bolzano / Bozen
2021-01-24,SIC,4318,2256,2062,136,4182,ITG,ITG1,19,Sicilia
2021-04-23,ABR,7382,3388,3994,5080,2302,ITF,ITF1,13,Abruzzo
2021-04-30,MAR,13954,6108,7846,5411,8543,ITI,ITI3,11,Marche
2021-01-06,PAB,59,18,41,59,0,ITH,ITH1,4,Provincia Autonoma Bolzano / Bozen
2021-02-14,CAL,466,212,254,436,30,ITF,ITF6,18,Calabria
2021-06-11,SAR,14786,7019,7767,9237,5549,ITG,ITG2,20,Sardegna
2021-01-30,ABR,1511,568,943,69,1442,ITF,ITF1,13,Abruzzo
2021-03-01,VEN,9395,3716,5679,7573,1822,ITH,ITH3,5,Veneto
2021-04-05,CAM,11637,5542,6095,9214,2423,ITF,ITF3,15,Campania
2021-03-03,SAR,4120,2282,1838,2821,1299,ITG,ITG2,20,Sardegna
2021-03-22,LOM,40324,14297,26027,29771,10553,ITC,ITC4,3,Lombardia
2021-05-16,PIE,28140,12778,15362,15075,13065,ITC,ITC1,1,Piemonte
2021-05-25,CAL,16362,7997,8365,10284,6078,ITF,ITF6,18,Calabria
2021-04-08,LOM,52322,21748,30574,35874,16448,ITC,ITC4,3,Lombardia
2021-02-05,PIE,9604,3139,6465,659,8945,ITC,ITC1,1,Piemonte
2020-12-29,LOM,106,45,61,106,0,ITC,ITC4,3,Lombardia
2021-02-24,LAZ,12050,5209,6841,11056,994,ITI,ITI4,12,Lazio
2021-01-24,UMB,258,106,152,1,257,ITI,ITI2,10,Umbria
2021-05-04,SIC,26809,12470,14339,17531,9278,ITG,ITG1,19,Sicilia
2021-04-22,LOM,73866,33366,40500,57543,16323,ITC,ITC4,3,Lombardia
2021-03-17,CAM,11590,5100,6490,5009,6581,ITF,ITF3,15,Campania
2021-04-29,PAT,4641,2240,2401,4433,208,ITH,ITH2,4,Provincia Autonoma Trento
2021-05-10,BAS,4805,2383,2422,2763,2042,ITF,ITF5,17,Basilicata
2021-03-03,LOM,26962,11510,15452,19683,7279,ITC,ITC4,3,Lombardia
2021-04-27,TOS,10350,4912,5438,3866,6484,ITI,ITI1,9,Toscana
2021-06-18,FVG,10436,5104,5332,3205,7231,ITH,ITH4,6,Friuli-Venezia Giulia
2021-03-18,PUG,9475,4291,5184,3329,6146,ITF,ITF4,16,Puglia
2021-04-11,MAR,7117,3115,4002,6831,286,ITI,ITI3,11,Marche
2021-01-22,PAT,1669,433,1236,329,1340,ITH,ITH2,4,Provincia Autonoma Trento
2021-01-26,CAL,1823,870,953,277,1546,ITF,ITF6,18,Calabria
2021-03-10,FVG,3582,1694,1888,1788,1794,ITH,ITH4,6,Friuli-Venezia Giulia
2021-01-27,LIG,1744,603,1141,141,1603,ITC,ITC3,7,Liguria
2021-02-05,PAT,802,272,530,283,519,ITH,ITH2,4,Provincia Autonoma Trento
2021-02-24,FVG,2522,1086,1436,2504,18,ITH,ITH4,6,Friuli-Venezia Giulia
2021-03-29,LAZ,25199,11880,13319,18162,7037,ITI,ITI4,12,Lazio
2021-05-01,EMR,28402,12774,15628,15626,12776,ITH,ITH5,8,Emilia-Romagna
2021-05-16,PAT,1331,736,595,1092,239,ITH,ITH2,4,Provincia Autonoma Trento
2021-03-04,PUG,15342,6090,9252,13922,1420,ITF,ITF4,16,Puglia
2021-03-30,PAB,1299,532,767,218,1081,ITH,ITH1,4,Provincia Autonoma Bolzano / Bozen
2021-06-08,UMB,7282,3587,3695,6746,536,ITI,ITI2,10,Umbria
2021-06-11,CAM,67767,32851,34916,61755,6012,ITF,ITF3,15,Campania
2021-05-21,LIG,12838,5952,6886,9714,3124,ITC,ITC3,7,Liguria
2021-06-09,PUG,41439,20525,20914,30307,11132,ITF,ITF4,16,Puglia
2021-01-28,VDA,291,123,168,56,235,ITC,ITC2,2,Valle d'Aosta / Vallée d'Aoste
2021-03-03,CAM,13923,5496,8427,7293,6630,ITF,ITF3,15,Campania
2021-04-03,VEN,21950,9626,12324,14242,7708,ITH,ITH3,5,Veneto
2021-03-11,MAR,6591,2784,3807,5221,1370,ITI,ITI3,11,Marche
2021-04-16,PAB,2949,1418,1531,2438,511,ITH,ITH1,4,Provincia Autonoma Bolzano / Bozen
2021-04-22,CAL,9620,4795,4825,6778,2842,ITF,ITF6,18,Calabria
2021-01-05,PAT,709,232,477,709,0,ITH,ITH2,4,Provincia Autonoma Trento
2021-01-03,UMB,270,112,158,270,0,ITI,ITI2,10,Umbria
2021-02-20,LOM,9336,3867,5469,9038,298,ITC,ITC4,3,Lombardia
2021-04-25,CAL,15703,7982,7721,14693,1010,ITF,ITF6,18,Calabria
2021-05-05,PUG,39113,17139,21974,24950,14163,ITF,ITF4,16,Puglia
2021-06-06,VDA,1160,582,578,787,373,ITC,ITC2,2,Valle d'Aosta / Vallée d'Aoste
2021-04-23,MAR,11166,5144,6022,8111,3055,ITI,ITI3,11,Marche
2021-05-21,PAT,5050,2420,2630,3340,1710,ITH,ITH2,4,Provincia Autonoma Trento
2021-01-06,TOS,4519,1460,3059,4519,0,ITI,ITI1,9,Toscana
2021-03-10,ABR,5046,1682,3364,4090,956,ITF,ITF1,13,Abruzzo
2021-04-16,LIG,11986,5285,6701,10158,1828,ITC,ITC3,7,Liguria
2021-04-18,LOM,36359,16214,20145,31121,5238,ITC,ITC4,3,Lombardia
2021-04-27,CAM,32157,15624,16533,24237,7920,ITF,ITF3,15,Campania
2021-06-07,VEN,44385,23160,21225,37377,7008,ITH,ITH3,5,Veneto
2021-01-08,LOM,12703,3918,8785,12703,0,ITC,ITC4,3,Lombardia
2021-06-10,PAB,4439,2304,2135,1346,3093,ITH,ITH1,4,Provincia Autonoma Bolzano / Bozen
2021-06-17,PUG,41621,20328,21293,21183,20438,ITF,ITF4,16,Puglia
2021-02-27,VEN,8988,2691,6297,8141,847,ITH,ITH3,5,Veneto
2021-06-23,CAM,45973,21699,24274,10212,35761,ITF,ITF3,15,Campania
2021-01-26,ABR,1542,567,975,30,1512,ITF,ITF1,13,Abruzzo
2021-06-15,VDA,876,479,397,621,255,ITC,ITC2,2,Valle d'Aosta / Vallée d'Aoste
2021-02-09,MOL,359,170,189,197,162,ITF,ITF2,14,Molise
2021-01-06,LIG,1660,616,1044,1660,0,ITC,ITC3,7,Liguria
2021-05-06,ABR,13007,6088,6919,7981,5026,ITF,ITF1,13,Abruzzo
2021-02-15,SIC,3730,1733,1997,3166,564,ITG,ITG1,19,Sicilia
2021-04-13,SAR,7610,3596,4014,5783,1827,ITG,ITG2,20,Sardegna
2021-04-27,EMR,32101,14863,17238,19640,12461,ITH,ITH5,8,Emilia-Romagna
2021-02-08,FVG,2357,694,1663,92,2265,ITH,ITH4,6,Friuli-Venezia Giulia
2021-05-14,PIE,33401,16272,17129,17983,15418,ITC,ITC1,1,Piemonte
2021-05-26,SIC,44509,20856,23653,24077,20432,ITG,ITG1,19,Sicilia
2021-06-09,SAR,15457,7364,8093,11719,3738,ITG,ITG2,20,Sardegna
2021-02-01,PAT,1222,336,886,92,1130,ITH,ITH2,4,Provincia Autonoma Trento
2021-03-11,TOS,15882,6338,9544,12554,3328,ITI,ITI1,9,Toscana
2021-01-03,SIC,4778,2495,2283,4778,0,ITG,ITG1,19,Sicilia
2021-06-19,TOS,26428,13858,12570,21709,4719,ITI,ITI1,9,Toscana
2021-01-01,LAZ,3554,1382,2172,3554,0,ITI,ITI4,12,Lazio
2021-04-13,SIC,19656,9582,10074,10905,8751,ITG,ITG1,19,Sicilia
2021-01-10,LAZ,4043,1702,2341,4043,0,ITI,ITI4,12,Lazio
2021-01-15,CAM,4980,2381,2599,4980,0,ITF,ITF3,15,Campania
2021-03-10,BAS,1680,842,838,841,839,ITF,ITF5,17,Basilicata
2021-06-16,LAZ,63915,30579,33336,32243,31672,ITI,ITI4,12,Lazio
2021-06-21,CAM,45756,22096,23660,10609,35147,ITF,ITF3,15,Campania
2021-03-13,CAM,14517,7038,7479,9235,5282,ITF,ITF3,15,Campania
2021-04-20,LAZ,31083,14274,16809,19783,11300,ITI,ITI4,12,Lazio
2021-04-22,UMB,5437,2237,3200,2773,2664,ITI,ITI2,10,Umbria
2021-03-04,VEN,12980,4884,8096,9508,3472,ITH,ITH3,5,Veneto
2021-04-26,PAB,1543,771,772,1538,5,ITH,ITH1,4,Provincia Autonoma Bolzano / Bozen
2021-01-26,BAS,800,353,447,101,699,ITF,ITF5,17,Basilicata
2021-02-23,MAR,3270,1398,1872,3214,56,ITI,ITI3,11,Marche
2021-03-05,VDA,275,124,151,53,222,ITC,ITC2,2,Valle d'Aosta / Vallée d'Aoste
2021-03-08,LAZ,20855,9040,11815,15582,5273,ITI,ITI4,12,Lazio
2021-05-06,BAS,5052,2435,2617,3483,1569,ITF,ITF5,17,Basilicata
2021-03-20,CAL,6707,3073,3634,4199,2508,ITF,ITF6,18,Calabria
2021-03-22,CAM,13180,6343,6837,11140,2040,ITF,ITF3,15,Campania
2021-05-15,BAS,6529,3344,3185,3958,2571,ITF,ITF5,17,Basilicata
2021-03-30,PUG,12285,5874,6411,6379,5906,ITF,ITF4,16,Puglia
2021-06-13,FVG,8637,4494,4143,5320,3317,ITH,ITH4,6,Friuli-Venezia Giulia
2021-02-01,PUG,3966,1660,2306,373,3593,ITF,ITF4,16,Puglia
2021-02-07,CAM,2929,1382,1547,2158,771,ITF,ITF3,15,Campania
2021-04-02,BAS,2317,1046,1271,1713,604,ITF,ITF5,17,Basilicata
2021-02-03,PAT,847,315,532,414,433,ITH,ITH2,4,Provincia Autonoma Trento
2021-02-04,BAS,1096,442,654,63,1033,ITF,ITF5,17,Basilicata
2021-04-17,FVG,7452,3234,4218,5969,1483,ITH,ITH4,6,Friuli-Venezia Giulia
2021-05-06,EMR,35926,16601,19325,22870,13056,ITH,ITH5,8,Emilia-Romagna
2021-01-10,SIC,3534,1578,1956,3534,0,ITG,ITG1,19,Sicilia
2021-01-26,EMR,8334,3000,5334,214,8120,ITH,ITH5,8,Emilia-Romagna
2021-02-05,TOS,5749,2245,3504,1924,3825,ITI,ITI1,9,Toscana
2021-04-09,ABR,8895,4212,4683,6356,2539,ITF,ITF1,13,Abruzzo
2021-04-22,LAZ,38862,19223,19639,24250,14612,ITI,ITI4,12,Lazio
2021-01-15,MAR,1771,500,1271,1771,0,ITI,ITI3,11,Marche
2021-04-17,UMB,6666,3059,3607,5326,1340,ITI,ITI2,10,Umbria
2021-05-23,PAT,1955,993,962,447,1508,ITH,ITH2,4,Provincia Autonoma Trento
2021-03-20,LIG,2316,995,1321,1142,1174,ITC,ITC3,7,Liguria
2021-03-24,EMR,21217,9399,11818,13835,7382,ITH,ITH5,8,Emilia-Romagna
2021-05-16,TOS,26661,12879,13782,24200,2461,ITI,ITI1,9,Toscana
2021-02-28,VDA,260,86,174,77,183,ITC,ITC2,2,Valle d'Aosta / Vallée d'Aoste
2021-03-10,LAZ,23326,10650,12676,17679,5647,ITI,ITI4,12,Lazio
2021-03-11,MOL,1465,637,828,1459,6,ITF,ITF2,14,Molise
2021-04-10,PAT,2823,1321,1502,2028,795,ITH,ITH2,4,Provincia Autonoma Trento
2021-05-11,VEN,33143,16493,16650,28424,4719,ITH,ITH3,5,Veneto
2021-01-12,LAZ,5413,1981,3432,5413,0,ITI,ITI4,12,Lazio
2021-01-15,LOM,25214,7433,17781,25214,0,ITC,ITC4,3,Lombardia
2021-03-15,CAL,3557,1689,1868,2112,1445,ITF,ITF6,18,Calabria
2021-06-18,LAZ,63706,30605,33101,30700,33006,ITI,ITI4,12,Lazio
2021-01-18,PAB,1772,687,1085,1767,5,ITH,ITH1,4,Provincia Autonoma Bolzano / Bozen
2021-05-14,PUG,44888,20512,24376,28779,16109,ITF,ITF4,16,Puglia
2021-02-02,BAS,367,143,224,175,192,ITF,ITF5,17,Basilicata
2021-04-17,PIE,30460,14147,16313,27144,3316,ITC,ITC1,1,Piemonte
2021-01-22,VEN,1080,332,748,25,1055,ITH,ITH3,5,Veneto
2021-01-06,MOL,689,260,429,689,0,ITF,ITF2,14,Molise
2021-04-29,LOM,115471,53575,61896,85636,29835,ITC,ITC4,3,Lombardia
2021-06-13,PIE,37863,19992,17871,33733,4130,ITC,ITC1,1,Piemonte
2021-04-02,ABR,6697,3102,3595,5208,1489,ITF,ITF1,13,Abruzzo
2021-04-25,MAR,8599,3993,4606,7024,1575,ITI,ITI3,11,Marche
2021-04-16,MOL,2430,1033,1397,1198,1232,ITF,ITF2,14,Molise
2021-05-05,VDA,1038,566,472,456,582,ITC,ITC2,2,Valle d'Aosta / Vallée d'Aoste
2021-06-25,LOM,103662,53928,49734,76645,27017,ITC,ITC4,3,Lombardia
2021-01-24,EMR,2443,885,1558,298,2145,ITH,ITH5,8,Emilia-Romagna
2021-06-11,LAZ,69005,32358,36647,36869,32136,ITI,ITI4,12,Lazio
2021-06-03,MOL,3291,1566,1725,2737,554,ITF,ITF2,14,Molise
2021-03-01,SIC,12694,6014,6680,11039,1655,ITG,ITG1,19,Sicilia
2021-04-07,MOL,1688,847,841,1413,275,ITF,ITF2,14,Molise
2021-03-04,LIG,4738,2118,2620,3891,847,ITC,ITC3,7,Liguria
2021-03-06,LOM,21318,9092,12226,16806,4512,ITC,ITC4,3,Lombardia
2021-04-01,FVG,6384,3048,3336,5369,1015,ITH,ITH4,6,Friuli-Venezia Giulia
2021-04-09,MAR,9566,4190,5376,9366,200,ITI,ITI3,11,Marche
2021-04-20,EMR,22619,10403,12216,14266,8353,ITH,ITH5,8,Emilia-Romagna
2021-05-28,FVG,10502,5030,5472,6403,4099,ITH,ITH4,6,Friuli-Venezia Giulia
2021-06-12,LIG,10114,4909,5205,7892,2222,ITC,ITC3,7,Liguria
2021-04-08,UMB,5894,2525,3369,4099,1795,ITI,ITI2,10,Umbria
2021-03-30,PAT,2388,973,1415,1751,637,ITH,ITH2,4,Provincia Autonoma Trento
2021-03-24,BAS,1895,724,1171,1497,398,ITF,ITF5,17,Basilicata
2021-04-19,VDA,751,325,426,542,209,ITC,ITC2,2,Valle d'Aosta / Vallée d'Aoste
2021-04-30,LIG,14415,6439,7976,5847,8568,ITC,ITC3,7,Liguria
2021-06-23,EMR,37174,18604,18570,18447,18727,ITH,ITH5,8,Emilia-Romagna
2021-06-09,SIC,49360,23488,25872,42243,7117,ITG,ITG1,19,Sicilia
2021-01-13,TOS,4062,1398,2664,4062,0,ITI,ITI1,9,Toscana
2021-04-25,VEN,18317,8149,10168,13482,4835,ITH,ITH3,5,Veneto
2021-06-17,PAB,1734,967,767,658,1076,ITH,ITH1,4,Provincia Autonoma Bolzano / Bozen
2021-04-01,PIE,19346,8081,11265,11226,8120,ITC,ITC1,1,Piemonte
2021-06-04,UMB,8898,4398,4500,7712,1186,ITI,ITI2,10,Umbria
2021-06-05,MOL,2927,1487,1440,2773,154,ITF,ITF2,14,Molise
2021-04-23,TOS,25682,11431,14251,9364,16318,ITI,ITI1,9,Toscana
2021-06-21,VEN,43731,21885,21846,20827,22904,ITH,ITH3,5,Veneto
2021-03-14,PUG,3325,1433,1892,2511,814,ITF,ITF4,16,Puglia
2021-05-28,PIE,34946,16539,18407,19039,15907,ITC,ITC1,1,Piemonte
2021-01-06,VEN,8134,2386,5748,8134,0,ITH,ITH3,5,Veneto
2021-01-22,CAL,659,275,384,657,2,ITF,ITF6,18,Calabria
2021-01-16,PUG,2506,1033,1473,2506,0,ITF,ITF4,16,Puglia
2021-06-09,LOM,102624,51714,50910,88295,14329,ITC,ITC4,3,Lombardia
2021-05-02,CAL,12510,5838,6672,10665,1845,ITF,ITF6,18,Calabria
2021-01-08,EMR,10866,3580,7286,10866,0,ITH,ITH5,8,Emilia-Romagna
2021-01-25,PIE,6215,1938,4277,983,5232,ITC,ITC1,1,Piemonte
2021-02-20,SAR,2041,855,1186,1707,334,ITG,ITG2,20,Sardegna
2021-01-02,PAB,91,48,43,91,0,ITH,ITH1,4,Provincia Autonoma Bolzano / Bozen
2021-03-06,EMR,20896,5935,14961,18165,2731,ITH,ITH5,8,Emilia-Romagna
2021-01-06,MAR,2202,801,1401,2202,0,ITI,ITI3,11,Marche
2021-03-06,LIG,3304,1842,1462,2599,705,ITC,ITC3,7,Liguria
2021-03-08,LOM,29727,11176,18551,22654,7073,ITC,ITC4,3,Lombardia
2021-03-29,CAL,5568,2360,3208,3812,1756,ITF,ITF6,18,Calabria
2021-06-23,VEN,47799,23715,24084,14978,32821,ITH,ITH3,5,Veneto
2021-01-31,CAL,1111,555,556,154,957,ITF,ITF6,18,Calabria
2021-05-04,LOM,86798,41069,45729,72414,14384,ITC,ITC4,3,Lombardia
2021-05-06,LAZ,48728,22688,26040,31191,17537,ITI,ITI4,12,Lazio
2021-01-22,LIG,1819,604,1215,1333,486,ITC,ITC3,7,Liguria
2021-01-24,LOM,1199,457,742,536,663,ITC,ITC4,3,Lombardia
2021-02-19,FVG,3252,1290,1962,2825,427,ITH,ITH4,6,Friuli-Venezia Giulia
2021-03-04,MAR,6487,2869,3618,5094,1393,ITI,ITI3,11,Marche
2021-05-02,LIG,3883,1771,2112,506,3377,ITC,ITC3,7,Liguria
2021-03-13,MAR,5763,2653,3110,1805,3958,ITI,ITI3,11,Marche
2021-06-13,UMB,6756,3553,3203,6526,230,ITI,ITI2,10,Umbria
2021-01-16,VDA,237,80,157,237,0,ITC,ITC2,2,Valle d'Aosta / Vallée d'Aoste
2021-04-29,SAR,11120,5111,6009,6762,4358,ITG,ITG2,20,Sardegna
2021-06-22,VDA,1189,666,523,541,648,ITC,ITC2,2,Valle d'Aosta / Vallée d'Aoste
2021-03-08,CAM,14685,6846,7839,9910,4775,ITF,ITF3,15,Campania
2021-06-21,MAR,12455,6109,6346,5579,6876,ITI,ITI3,11,Marche
2021-02-11,ABR,816,262,554,773,43,ITF,ITF1,13,Abruzzo
2021-03-14,VDA,392,200,192,392,0,ITC,ITC2,2,Valle d'Aosta / Vallée d'Aoste
2021-06-25,SAR,16423,7775,8648,3927,12496,ITG,ITG2,20,Sardegna
2021-03-15,VEN,16666,7327,9339,11458,5208,ITH,ITH3,5,Veneto
2021-05-01,UMB,5377,2642,2735,2147,3230,ITI,ITI2,10,Umbria
2021-05-04,CAM,48476,23344,25132,39577,8899,ITF,ITF3,15,Campania
2021-06-06,PAT,2228,1061,1167,445,1783,ITH,ITH2,4,Provincia Autonoma Trento
2021-03-18,PAB,1302,531,771,226,1076,ITH,ITH1,4,Provincia Autonoma Bolzano / Bozen
2021-03-20,TOS,6586,2977,3609,5450,1136,ITI,ITI1,9,Toscana
2021-05-11,CAL,15055,7284,7771,10284,4771,ITF,ITF6,18,Calabria
2021-05-20,EMR,40226,18303,21923,18865,21361,ITH,ITH5,8,Emilia-Romagna
2021-05-30,PIE,27702,13187,14515,18378,9324,ITC,ITC1,1,Piemonte
2021-01-24,CAM,4122,2119,2003,377,3745,ITF,ITF3,15,Campania
2021-03-05,UMB,4624,1403,3221,3968,656,ITI,ITI2,10,Umbria
2021-05-09,MAR,8865,4021,4844,3638,5227,ITI,ITI3,11,Marche
2021-01-22,TOS,2866,1064,1802,528,2338,ITI,ITI1,9,Toscana
2021-02-19,PIE,5535,2175,3360,5034,501,ITC,ITC1,1,Piemonte
2021-04-26,VDA,715,327,388,545,170,ITC,ITC2,2,Valle d'Aosta / Vallée d'Aoste
2021-05-14,PAB,5134,2320,2814,3097,2037,ITH,ITH1,4,Provincia Autonoma Bolzano / Bozen
2021-05-21,PUG,38891,18469,20422,28881,10010,ITF,ITF4,16,Puglia
2021-03-04,MOL,850,417,433,526,324,ITF,ITF2,14,Molise
2021-03-16,PAB,1290,532,758,124,1166,ITH,ITH1,4,Provincia Autonoma Bolzano / Bozen
2021-05-13,CAM,55445,24826,30619,39443,16002,ITF,ITF3,15,Campania
2021-01-19,SIC,1480,655,825,1258,222,ITG,ITG1,19,Sicilia
2021-06-12,MOL,3375,1736,1639,3289,86,ITF,ITF2,14,Molise
2021-05-04,LIG,13647,6085,7562,5419,8228,ITC,ITC3,7,Liguria
2021-01-10,SAR,2183,750,1433,2183,0,ITG,ITG2,20,Sardegna
2021-02-17,PAT,1112,425,687,1021,91,ITH,ITH2,4,Provincia Autonoma Trento
2021-03-03,UMB,4438,1773,2665,3727,711,ITI,ITI2,10,Umbria
2021-06-11,SIC,48302,23018,25284,40716,7586,ITG,ITG1,19,Sicilia
2021-05-24,ABR,12264,5855,6409,8913,3351,ITF,ITF1,13,Abruzzo
2021-02-11,BAS,952,401,551,869,83,ITF,ITF5,17,Basilicata
2021-05-12,PAB,3791,2058,1733,3638,153,ITH,ITH1,4,Provincia Autonoma Bolzano / Bozen
2021-04-29,SIC,31702,14824,16878,22252,9450,ITG,ITG1,19,Sicilia
2021-06-04,PIE,37484,19594,17890,34550,2934,ITC,ITC1,1,Piemonte
2021-02-01,PAB,1452,440,1012,12,1440,ITH,ITH1,4,Provincia Autonoma Bolzano / Bozen
2021-01-17,LAZ,4894,2028,2866,4682,212,ITI,ITI4,12,Lazio
2021-02-24,PIE,11409,4629,6780,10904,505,ITC,ITC1,1,Piemonte
2021-03-03,SIC,14419,6431,7988,11356,3063,ITG,ITG1,19,Sicilia
2021-05-20,VDA,807,363,444,367,440,ITC,ITC2,2,Valle d'Aosta / Vallée d'Aoste
2021-04-27,FVG,8101,3718,4383,3626,4475,ITH,ITH4,6,Friuli-Venezia Giulia
2021-05-12,LIG,12025,5446,6579,6678,5347,ITC,ITC3,7,Liguria
2021-01-06,PIE,3116,1111,2005,3116,0,ITC,ITC1,1,Piemonte
2021-05-26,LIG,16655,8408,8247,12282,4373,ITC,ITC3,7,Liguria
2021-03-24,VDA,515,230,285,258,257,ITC,ITC2,2,Valle d'Aosta / Vallée d'Aoste
2021-03-30,LIG,12207,5424,6783,8819,3388,ITC,ITC3,7,Liguria
2021-05-17,MOL,2228,1092,1136,1732,496,ITF,ITF2,14,Molise
2021-06-16,PAT,6207,3343,2864,2044,4163,ITH,ITH2,4,Provincia Autonoma Trento
2021-03-21,MOL,1246,542,704,479,767,ITF,ITF2,14,Molise
2021-05-21,VEN,44721,21998,22723,20973,23748,ITH,ITH3,5,Veneto
2021-01-25,LOM,7012,2367,4645,473,6539,ITC,ITC4,3,Lombardia
2021-05-06,VDA,1063,509,554,679,384,ITC,ITC2,2,Valle d'Aosta / Vallée d'Aoste
2021-05-31,PUG,37612,18094,19518,23545,14067,ITF,ITF4,16,Puglia
2021-02-01,LOM,16064,5322,10742,309,15755,ITC,ITC4,3,Lombardia
2021-02-12,BAS,775,332,443,744,31,ITF,ITF5,17,Basilicata
2021-03-14,MOL,596,240,356,17,579,ITF,ITF2,14,Molise
2020-12-27,CAL,311,170,141,311,0,ITF,ITF6,18,Calabria
2021-03-18,EMR,13675,5806,7869,5675,8000,ITH,ITH5,8,Emilia-Romagna
2021-06-22,MOL,2947,1366,1581,685,2262,ITF,ITF2,14,Molise
2021-06-23,PIE,39401,19533,19868,16665,22736,ITC,ITC1,1,Piemonte
2021-05-14,EMR,37238,17163,20075,27641,9597,ITH,ITH5,8,Emilia-Romagna
2021-02-03,EMR,9338,2989,6349,965,8373,ITH,ITH5,8,Emilia-Romagna
2021-04-10,BAS,1032,378,654,949,83,ITF,ITF5,17,Basilicata
2021-04-01,EMR,23947,10770,13177,19401,4546,ITH,ITH5,8,Emilia-Romagna
2021-03-13,UMB,1735,524,1211,1486,249,ITI,ITI2,10,Umbria
2021-06-21,SIC,39579,18320,21259,18183,21396,ITG,ITG1,19,Sicilia
2021-01-15,UMB,701,215,486,701,0,ITI,ITI2,10,Umbria
2021-02-01,CAM,3984,1813,2171,110,3874,ITF,ITF3,15,Campania
2021-02-26,ABR,3923,1679,2244,2955,968,ITF,ITF1,13,Abruzzo
2021-02-17,EMR,6538,2764,3774,5766,772,ITH,ITH5,8,Emilia-Romagna
2021-04-06,CAL,7561,3423,4138,4145,3416,ITF,ITF6,18,Calabria
2021-01-29,UMB,1232,348,884,79,1153,ITI,ITI2,10,Umbria
2021-03-30,CAM,22048,10573,11475,19090,2958,ITF,ITF3,15,Campania
2021-05-09,SIC,28077,13137,14940,19808,8269,ITG,ITG1,19,Sicilia
2021-02-08,CAL,1856,737,1119,663,1193,ITF,ITF6,18,Calabria
2021-05-09,UMB,5769,2760,3009,5378,391,ITI,ITI2,10,Umbria
2021-02-16,VDA,326,53,273,320,6,ITC,ITC2,2,Valle d'Aosta / Vallée d'Aoste
2021-05-04,FVG,9535,4298,5237,6181,3354,ITH,ITH4,6,Friuli-Venezia Giulia
2021-06-01,EMR,27133,13085,14048,17245,9888,ITH,ITH5,8,Emilia-Romagna
2021-02-15,MAR,967,412,555,954,13,ITI,ITI3,11,Marche
2021-03-15,PAT,1411,545,866,947,464,ITH,ITH2,4,Provincia Autonoma Trento
2021-06-24,BAS,4124,1953,2171,2219,1905,ITF,ITF5,17,Basilicata
2021-01-24,FVG,305,119,186,1,304,ITH,ITH4,6,Friuli-Venezia Giulia
2021-06-11,TOS,29657,15418,14239,25053,4604,ITI,ITI1,9,Toscana
2021-01-17,PAT,251,195,56,251,0,ITH,ITH2,4,Provincia Autonoma Trento
2021-04-28,BAS,4704,2158,2546,4263,441,ITF,ITF5,17,Basilicata
2021-05-26,MAR,11804,5917,5887,8621,3183,ITI,ITI3,11,Marche
2021-06-23,PAT,6509,3450,3059,4639,1870,ITH,ITH2,4,Provincia Autonoma Trento
2021-02-12,LAZ,6848,2849,3999,6432,416,ITI,ITI4,12,Lazio
2021-04-15,TOS,24402,10196,14206,15866,8536,ITI,ITI1,9,Toscana
2021-02-17,TOS,8175,3169,5006,7423,752,ITI,ITI1,9,Toscana
2021-03-08,FVG,4119,1642,2477,2034,2085,ITH,ITH4,6,Friuli-Venezia Giulia
2021-04-25,PUG,11305,5235,6070,10147,1158,ITF,ITF4,16,Puglia
2021-05-11,PAT,3699,1750,1949,2849,850,ITH,ITH2,4,Provincia Autonoma Trento
2021-02-27,PUG,14221,4818,9403,12996,1225,ITF,ITF4,16,Puglia
2021-04-06,LIG,13242,5898,7344,10982,2260,ITC,ITC3,7,Liguria
2021-04-24,CAL,19077,9508,9569,15596,3481,ITF,ITF6,18,Calabria
2021-04-17,CAM,36182,17510,18672,24672,11510,ITF,ITF3,15,Campania
2021-01-01,PUG,148,61,87,148,0,ITF,ITF4,16,Puglia
2021-02-08,LIG,1977,741,1236,306,1671,ITC,ITC3,7,Liguria
2021-02-26,CAL,3076,1638,1438,2623,453,ITF,ITF6,18,Calabria
2021-05-31,PAB,2987,1464,1523,2120,867,ITH,ITH1,4,Provincia Autonoma Bolzano / Bozen
2021-06-07,PUG,44011,21489,22522,30821,13190,ITF,ITF4,16,Puglia
2021-02-17,VEN,6022,2772,3250,5928,94,ITH,ITH3,5,Veneto
2021-03-28,MOL,1626,747,879,524,1102,ITF,ITF2,14,Molise
2021-06-13,CAM,41844,20395,21449,37120,4724,ITF,ITF3,15,Campania
2021-03-22,FVG,3657,1445,2212,1703,1954,ITH,ITH4,6,Friuli-Venezia Giulia
2021-04-11,PUG,16458,7246,9212,14800,1658,ITF,ITF4,16,Puglia
2021-01-30,MOL,461,158,303,12,449,ITF,ITF2,14,Molise
2021-03-02,BAS,797,384,413,661,136,ITF,ITF5,17,Basilicata
2021-03-30,MAR,7430,3053,4377,4615,2815,ITI,ITI3,11,Marche
2021-04-27,PAT,3911,1879,2032,3842,69,ITH,ITH2,4,Provincia Autonoma Trento
2020-12-27,LIG,135,56,79,135,0,ITC,ITC3,7,Liguria
2021-02-05,SAR,1897,749,1148,433,1464,ITG,ITG2,20,Sardegna
2021-06-20,CAL,6526,3087,3439,3689,2837,ITF,ITF6,18,Calabria
2021-02-01,MAR,1362,479,883,98,1264,ITI,ITI3,11,Marche
2021-04-01,VEN,25310,11149,14161,18904,6406,ITH,ITH3,5,Veneto
2021-06-10,BAS,4340,2099,2241,3899,441,ITF,ITF5,17,Basilicata
2021-02-05,SIC,6786,2992,3794,2128,4658,ITG,ITG1,19,Sicilia
2021-03-08,PIE,14020,5359,8661,11306,2714,ITC,ITC1,1,Piemonte
2021-04-03,SAR,4667,1806,2861,2700,1967,ITG,ITG2,20,Sardegna
2021-01-18,ABR,125,51,74,46,79,ITF,ITF1,13,Abruzzo
2021-06-24,ABR,10730,5338,5392,5691,5039,ITF,ITF1,13,Abruzzo
2021-05-04,PIE,28586,13145,15441,16410,12176,ITC,ITC1,1,Piemonte
2021-05-30,SAR,9726,4836,4890,7369,2357,ITG,ITG2,20,Sardegna
2021-04-28,ABR,9513,4587,4926,7490,2023,ITF,ITF1,13,Abruzzo
2021-01-24,PIE,3153,959,2194,434,2719,ITC,ITC1,1,Piemonte
2021-02-19,SAR,1499,473,1026,1443,56,ITG,ITG2,20,Sardegna
2021-06-06,CAL,13380,6435,6945,11684,1696,ITF,ITF6,18,Calabria
2021-01-01,PAB,6,5,1,6,0,ITH,ITH1,4,Provincia Autonoma Bolzano / Bozen
2021-04-15,VEN,20867,8617,12250,10042,10825,ITH,ITH3,5,Veneto
2021-05-12,ABR,9630,4600,5030,6050,3580,ITF,ITF1,13,Abruzzo
2021-05-30,CAM,52153,25442,26711,38841,13312,ITF,ITF3,15,Campania
2021-06-07,PAB,2901,1506,1395,2582,319,ITH,ITH1,4,Provincia Autonoma Bolzano / Bozen
2021-03-22,PIE,11523,4890,6633,3917,7606,ITC,ITC1,1,Piemonte
2021-04-03,SIC,16403,7809,8594,13567,2836,ITG,ITG1,19,Sicilia
2021-04-22,PIE,27695,12753,14942,20986,6709,ITC,ITC1,1,Piemonte
2021-01-12,PIE,10090,3415,6675,10090,0,ITC,ITC1,1,Piemonte
2021-01-30,PAB,498,245,253,4,494,ITH,ITH1,4,Provincia Autonoma Bolzano / Bozen
2021-03-29,CAM,19399,9573,9826,17853,1546,ITF,ITF3,15,Campania
2021-05-03,ABR,11099,5233,5866,7262,3837,ITF,ITF1,13,Abruzzo
2021-06-03,VDA,1306,667,639,896,410,ITC,ITC2,2,Valle d'Aosta / Vallée d'Aoste
2021-01-29,PIE,5945,1887,4058,455,5490,ITC,ITC1,1,Piemonte
2021-02-24,SAR,2414,1295,1119,2224,190,ITG,ITG2,20,Sardegna
2021-04-20,MAR,10697,4996,5701,9279,1418,ITI,ITI3,11,Marche
2021-06-01,CAL,12843,5952,6891,7920,4923,ITF,ITF6,18,Calabria
2021-04-10,UMB,7475,3514,3961,7340,135,ITI,ITI2,10,Umbria
2021-05-02,PUG,21309,9657,11652,14043,7266,ITF,ITF4,16,Puglia
2021-04-23,PAB,4543,2151,2392,3252,1291,ITH,ITH1,4,Provincia Autonoma Bolzano / Bozen
2021-05-17,VDA,809,417,392,375,434,ITC,ITC2,2,Valle d'Aosta / Vallée d'Aoste
2021-01-17,UMB,54,17,37,54,0,ITI,ITI2,10,Umbria
2021-03-27,LIG,3932,1549,2383,2537,1395,ITC,ITC3,7,Liguria
2021-05-23,TOS,28379,13647,14732,25814,2565,ITI,ITI1,9,Toscana
2021-01-25,MAR,1595,558,1037,96,1499,ITI,ITI3,11,Marche
2020-12-31,UMB,322,127,195,322,0,ITI,ITI2,10,Umbria
2021-04-10,SIC,20421,9969,10452,11458,8963,ITG,ITG1,19,Sicilia
2021-01-10,PAT,84,19,65,84,0,ITH,ITH2,4,Provincia Autonoma Trento
2021-04-13,LIG,13077,5867,7210,11053,2024,ITC,ITC3,7,Liguria
2021-04-15,LOM,49414,21845,27569,35592,13822,ITC,ITC4,3,Lombardia
2021-01-17,SIC,1304,591,713,1245,59,ITG,ITG1,19,Sicilia
2021-04-16,ABR,7536,3487,4049,5619,1917,ITF,ITF1,13,Abruzzo
2021-06-20,CAM,46788,22346,24442,13812,32976,ITF,ITF3,15,Campania
2021-01-05,LOM,7851,2575,5276,7851,0,ITC,ITC4,3,Lombardia
2021-03-22,LAZ,23131,10361,12770,16457,6674,ITI,ITI4,12,Lazio
2021-03-27,CAM,21510,10242,11268,17645,3865,ITF,ITF3,15,Campania
2021-01-23,BAS,720,304,416,33,687,ITF,ITF5,17,Basilicata
2021-05-13,CAL,15929,7655,8274,11231,4698,ITF,ITF6,18,Calabria
2021-05-03,BAS,4513,2043,2470,3685,828,ITF,ITF5,17,Basilicata
2021-04-24,EMR,28630,13240,15390,14402,14228,ITH,ITH5,8,Emilia-Romagna
2020-12-29,LAZ,488,176,312,488,0,ITI,ITI4,12,Lazio
2021-01-08,MAR,1580,592,988,1580,0,ITI,ITI3,11,Marche
2021-01-11,PAB,1571,513,1058,1571,0,ITH,ITH1,4,Provincia Autonoma Bolzano / Bozen
2021-02-19,CAL,1508,681,827,1247,261,ITF,ITF6,18,Calabria
2021-05-15,VDA,1065,614,451,380,685,ITC,ITC2,2,Valle d'Aosta / Vallée d'Aoste
2021-06-06,SAR,10032,4998,5034,6380,3652,ITG,ITG2,20,Sardegna
2021-01-29,PAT,1354,332,1022,55,1299,ITH,ITH2,4,Provincia Autonoma Trento
2021-02-09,BAS,491,213,278,316,175,ITF,ITF5,17,Basilicata
2021-02-04,VDA,294,86,208,8,286,ITC,ITC2,2,Valle d'Aosta / Vallée d'Aoste
2021-03-27,LOM,32430,12373,20057,23724,8706,ITC,ITC4,3,Lombardia
2021-04-18,MAR,8824,4131,4693,7903,921,ITI,ITI3,11,Marche
2021-05-11,EMR,35776,16791,18985,28522,7254,ITH,ITH5,8,Emilia-Romagna
2021-05-30,CAL,10944,5254,5690,6791,4153,ITF,ITF6,18,Calabria
2021-04-28,VDA,1218,632,586,715,503,ITC,ITC2,2,Valle d'Aosta / Vallée d'Aoste
2021-06-01,CAM,41906,20792,21114,31478,10428,ITF,ITF3,15,Campania
2021-01-31,EMR,7698,2763,4935,241,7457,ITH,ITH5,8,Emilia-Romagna
2021-02-10,TOS,4263,1281,2982,3740,523,ITI,ITI1,9,Toscana
2021-04-03,FVG,4011,1989,2022,2681,1330,ITH,ITH4,6,Friuli-Venezia Giulia
2021-01-03,LOM,854,316,538,854,0,ITC,ITC4,3,Lombardia
2021-04-06,PAB,2250,1118,1132,2147,103,ITH,ITH1,4,Provincia Autonoma Bolzano / Bozen
2021-06-18,CAM,63709,30281,33428,33443,30266,ITF,ITF3,15,Campania
2021-03-10,CAM,15610,7719,7891,8775,6835,ITF,ITF3,15,Campania
2021-04-22,PAT,3152,1470,1682,3107,45,ITH,ITH2,4,Provincia Autonoma Trento
2021-06-15,UMB,5937,3002,2935,3898,2039,ITI,ITI2,10,Umbria
2021-05-04,TOS,18301,8207,10094,12855,5446,ITI,ITI1,9,Toscana
2021-06-13,LAZ,52555,23271,29284,27734,24821,ITI,ITI4,12,Lazio
2021-03-07,LAZ,14133,5466,8667,10540,3593,ITI,ITI4,12,Lazio
2021-06-10,FVG,10625,5584,5041,9644,981,ITH,ITH4,6,Friuli-Venezia Giulia
2021-06-15,LAZ,65324,31482,33842,33444,31880,ITI,ITI4,12,Lazio
2021-06-18,PUG,46288,22776,23512,28668,17620,ITF,ITF4,16,Puglia
2021-02-28,PIE,10816,4060,6756,10576,240,ITC,ITC1,1,Piemonte
2021-05-15,CAM,62627,29033,33594,43940,18687,ITF,ITF3,15,Campania
2021-03-17,PIE,12518,5055,7463,5224,7294,ITC,ITC1,1,Piemonte
2021-06-21,BAS,4242,2038,2204,2151,2091,ITF,ITF5,17,Basilicata
2020-12-31,VEN,3220,1042,2178,3220,0,ITH,ITH3,5,Veneto
2021-03-11,ABR,5495,2221,3274,4357,1138,ITF,ITF1,13,Abruzzo
2021-03-24,LAZ,27596,12854,14742,21359,6237,ITI,ITI4,12,Lazio
2021-03-25,MOL,1806,730,1076,1309,497,ITF,ITF2,14,Molise
2021-03-19,FVG,3251,1350,1901,1315,1936,ITH,ITH4,6,Friuli-Venezia Giulia
2021-03-08,MOL,1379,522,857,1239,140,ITF,ITF2,14,Molise
2021-03-05,SIC,15665,6770,8895,11430,4235,ITG,ITG1,19,Sicilia
2021-06-02,ABR,9707,4707,5000,6895,2812,ITF,ITF1,13,Abruzzo
2021-04-07,PAT,2622,1017,1605,1680,942,ITH,ITH2,4,Provincia Autonoma Trento
2021-06-16,MOL,1788,904,884,934,854,ITF,ITF2,14,Molise
2021-03-21,EMR,11956,5296,6660,7351,4605,ITH,ITH5,8,Emilia-Romagna
2021-05-13,LIG,13298,6081,7217,9050,4248,ITC,ITC3,7,Liguria
2021-02-16,SIC,4199,2206,1993,3734,465,ITG,ITG1,19,Sicilia
2021-05-29,LAZ,51923,23333,28590,40954,10969,ITI,ITI4,12,Lazio
2021-04-12,VEN,14899,6332,8567,6684,8215,ITH,ITH3,5,Veneto
2021-02-19,LIG,3219,1306,1913,3043,176,ITC,ITC3,7,Liguria
2021-06-19,BAS,4460,2175,2285,2388,2072,ITF,ITF5,17,Basilicata
2021-01-02,VEN,5744,1767,3977,5744,0,ITH,ITH3,5,Veneto
2021-04-13,MOL,1630,718,912,1043,587,ITF,ITF2,14,Molise
2021-06-17,UMB,6935,3511,3424,4883,2052,ITI,ITI2,10,Umbria
2021-05-30,LIG,3300,1612,1688,1366,1934,ITC,ITC3,7,Liguria
2021-03-13,ABR,4125,1420,2705,3082,1043,ITF,ITF1,13,Abruzzo
2021-03-28,BAS,2142,743,1399,2125,17,ITF,ITF5,17,Basilicata
2021-05-17,CAL,14893,7443,7450,10174,4719,ITF,ITF6,18,Calabria
2021-06-10,PIE,40178,20987,19191,37646,2532,ITC,ITC1,1,Piemonte
2021-03-26,UMB,4604,1716,2888,4432,172,ITI,ITI2,10,Umbria
2021-03-27,MOL,2743,1273,1470,1310,1433,ITF,ITF2,14,Molise
2021-02-12,TOS,7606,2683,4923,7393,213,ITI,ITI1,9,Toscana
2021-04-08,PAB,2765,1346,1419,2562,203,ITH,ITH1,4,Provincia Autonoma Bolzano / Bozen
2021-06-10,EMR,43963,22591,21372,38626,5337,ITH,ITH5,8,Emilia-Romagna
2021-04-14,PUG,31890,15058,16832,28583,3307,ITF,ITF4,16,Puglia
2021-05-07,TOS,32118,14689,17429,12003,20115,ITI,ITI1,9,Toscana
2021-03-28,PUG,3540,1654,1886,1214,2326,ITF,ITF4,16,Puglia
2021-03-29,ABR,5709,2600,3109,3070,2639,ITF,ITF1,13,Abruzzo
2021-03-30,LOM,39547,15549,23998,24771,14776,ITC,ITC4,3,Lombardia
2021-04-21,MAR,10781,4967,5814,9587,1194,ITI,ITI3,11,Marche
2021-06-02,CAL,12080,5796,6284,8814,3266,ITF,ITF6,18,Calabria
2021-03-20,FVG,3400,1408,1992,1309,2091,ITH,ITH4,6,Friuli-Venezia Giulia
2021-05-14,LIG,13106,5838,7268,8779,4327,ITC,ITC3,7,Liguria
2021-01-20,SAR,210,77,133,208,2,ITG,ITG2,20,Sardegna
2021-01-28,MAR,2086,725,1361,165,1921,ITI,ITI3,11,Marche
2021-05-18,VDA,970,484,486,353,617,ITC,ITC2,2,Valle d'Aosta / Vallée d'Aoste
2021-06-18,UMB,4706,2298,2408,1608,3098,ITI,ITI2,10,Umbria
2021-01-06,LOM,7059,2492,4567,7059,0,ITC,ITC4,3,Lombardia
2021-05-31,LIG,14638,7327,7311,9123,5515,ITC,ITC3,7,Liguria
2021-06-19,PUG,33609,16807,16802,21982,11627,ITF,ITF4,16,Puglia
2021-02-07,VDA,292,120,172,190,102,ITC,ITC2,2,Valle d'Aosta / Vallée d'Aoste
2021-04-13,VEN,14029,6322,7707,8543,5486,ITH,ITH3,5,Veneto
2021-06-03,ABR,13182,6283,6899,9409,3773,ITF,ITF1,13,Abruzzo
2021-01-13,FVG,2650,834,1816,2650,0,ITH,ITH4,6,Friuli-Venezia Giulia
2021-02-13,TOS,7786,2361,5425,7559,227,ITI,ITI1,9,Toscana
2021-03-09,LIG,5930,2753,3177,4499,1431,ITC,ITC3,7,Liguria
2021-04-06,FVG,6655,3115,3540,5505,1150,ITH,ITH4,6,Friuli-Venezia Giulia
2021-03-12,ABR,6017,1987,4030,4435,1582,ITF,ITF1,13,Abruzzo
2021-04-04,MAR,3824,1792,2032,2655,1169,ITI,ITI3,11,Marche
2021-05-16,CAL,13778,6724,7054,9969,3809,ITF,ITF6,18,Calabria
2020-12-27,FVG,262,149,113,262,0,ITH,ITH4,6,Friuli-Venezia Giulia
2021-03-26,MOL,2575,1045,1530,1933,642,ITF,ITF2,14,Molise
2021-02-20,LIG,1335,637,698,1334,1,ITC,ITC3,7,Liguria
2021-05-01,VDA,940,563,377,456,484,ITC,ITC2,2,Valle d'Aosta / Vallée d'Aoste
2021-06-20,ABR,8318,4179,4139,5390,2928,ITF,ITF1,13,Abruzzo
2021-03-03,PIE,12120,4644,7476,11301,819,ITC,ITC1,1,Piemonte
2021-03-29,SAR,4724,1829,2895,4135,589,ITG,ITG2,20,Sardegna
2021-05-13,UMB,5919,2665,3254,3841,2078,ITI,ITI2,10,Umbria
2021-03-14,ABR,1873,731,1142,1207,666,ITF,ITF1,13,Abruzzo
2021-04-14,VDA,941,430,511,717,224,ITC,ITC2,2,Valle d'Aosta / Vallée d'Aoste
2021-05-18,CAM,52137,23197,28940,32517,19620,ITF,ITF3,15,Campania
2021-04-15,SAR,11846,5540,6306,6888,4958,ITG,ITG2,20,Sardegna
2021-01-03,VEN,5157,1562,3595,5157,0,ITH,ITH3,5,Veneto
2021-02-19,UMB,743,293,450,526,217,ITI,ITI2,10,Umbria
2021-06-21,PUG,40436,19706,20730,21129,19307,ITF,ITF4,16,Puglia
2021-01-05,SAR,1327,446,881,1327,0,ITG,ITG2,20,Sardegna
2021-01-08,TOS,5947,1643,4304,5947,0,ITI,ITI1,9,Toscana
2021-03-20,PIE,11922,4899,7023,6024,5898,ITC,ITC1,1,Piemonte
2021-06-09,MAR,14044,7304,6740,12175,1869,ITI,ITI3,11,Marche
2021-03-04,PAB,1715,1005,710,1486,229,ITH,ITH1,4,Provincia Autonoma Bolzano / Bozen
2021-01-22,SAR,83,47,36,55,28,ITG,ITG2,20,Sardegna
2021-02-12,PAT,1011,340,671,590,421,ITH,ITH2,4,Provincia Autonoma Trento
2021-01-17,CAL,896,430,466,801,95,ITF,ITF6,18,Calabria
2021-05-16,LIG,3703,1860,1843,2143,1560,ITC,ITC3,7,Liguria
2021-05-18,LOM,88154,42144,46010,32612,55542,ITC,ITC4,3,Lombardia
2021-02-19,SIC,4906,2647,2259,4343,563,ITG,ITG1,19,Sicilia
2021-06-04,LOM,104375,54195,50180,94769,9606,ITC,ITC4,3,Lombardia
2021-02-22,LIG,3343,1476,1867,3201,142,ITC,ITC3,7,Liguria
2021-02-24,LOM,14720,5957,8763,13766,954,ITC,ITC4,3,Lombardia
2021-02-25,ABR,3052,1340,1712,2524,528,ITF,ITF1,13,Abruzzo
2021-03-01,PAT,1237,454,783,942,295,ITH,ITH2,4,Provincia Autonoma Trento
2021-03-08,SIC,13395,5867,7528,10782,2613,ITG,ITG1,19,Sicilia
2021-06-05,ABR,14579,6841,7738,10530,4049,ITF,ITF1,13,Abruzzo
2021-06-07,MAR,13161,6500,6661,10712,2449,ITI,ITI3,11,Marche
2021-01-31,LAZ,4460,1854,2606,477,3983,ITI,ITI4,12,Lazio
2021-02-05,CAM,7260,3463,3797,2132,5128,ITF,ITF3,15,Campania
2021-03-20,PAT,874,403,471,671,203,ITH,ITH2,4,Provincia Autonoma Trento
2021-03-24,CAL,7723,3525,4198,4454,3269,ITF,ITF6,18,Calabria
2021-03-03,PAT,1659,622,1037,1141,518,ITH,ITH2,4,Provincia Autonoma Trento
2021-03-14,BAS,1010,477,533,541,469,ITF,ITF5,17,Basilicata
2021-01-02,VDA,6,5,1,6,0,ITC,ITC2,2,Valle d'Aosta / Vallée d'Aoste
2021-05-11,LAZ,48256,22161,26095,31729,16527,ITI,ITI4,12,Lazio
2021-06-13,EMR,27250,14237,13013,22995,4255,ITH,ITH5,8,Emilia-Romagna
2021-03-26,VDA,498,204,294,491,7,ITC,ITC2,2,Valle d'Aosta / Vallée d'Aoste
2021-05-16,LOM,68664,32496,36168,36487,32177,ITC,ITC4,3,Lombardia
2021-05-30,SIC,35767,16169,19598,17719,18048,ITG,ITG1,19,Sicilia
2021-03-05,EMR,17848,5839,12009,14394,3454,ITH,ITH5,8,Emilia-Romagna
2021-02-05,LOM,25701,7456,18245,2427,23274,ITC,ITC4,3,Lombardia
2021-02-27,MAR,3362,1438,1924,3153,209,ITI,ITI3,11,Marche
2021-04-10,CAL,11408,5141,6267,6583,4825,ITF,ITF6,18,Calabria
2021-04-17,SAR,10085,4503,5582,5486,4599,ITG,ITG2,20,Sardegna
2021-02-18,MOL,319,74,245,306,13,ITF,ITF2,14,Molise
2021-03-31,BAS,3094,1258,1836,2312,782,ITF,ITF5,17,Basilicata
2021-05-13,SIC,47238,22153,25085,30735,16503,ITG,ITG1,19,Sicilia
2021-02-12,FVG,1193,428,765,1146,47,ITH,ITH4,6,Friuli-Venezia Giulia
2021-03-22,EMR,17647,7812,9835,10783,6864,ITH,ITH5,8,Emilia-Romagna
2021-06-17,VDA,775,422,353,626,149,ITC,ITC2,2,Valle d'Aosta / Vallée d'Aoste
2021-04-01,TOS,27022,11209,15813,16394,10628,ITI,ITI1,9,Toscana
2021-05-26,PAB,4936,2492,2444,2962,1974,ITH,ITH1,4,Provincia Autonoma Bolzano / Bozen
2021-02-22,LOM,11894,4807,7087,11589,305,ITC,ITC4,3,Lombardia
2021-04-24,LAZ,33408,15067,18341,20634,12774,ITI,ITI4,12,Lazio
2021-04-29,CAM,41326,20035,21291,24847,16479,ITF,ITF3,15,Campania
2021-06-11,PAT,7182,3420,3762,1569,5613,ITH,ITH2,4,Provincia Autonoma Trento
2021-06-22,BAS,4362,2069,2293,2260,2102,ITF,ITF5,17,Basilicata
2021-03-15,TOS,8698,3645,5053,4255,4443,ITI,ITI1,9,Toscana
2021-01-19,CAM,1095,474,621,1092,3,ITF,ITF3,15,Campania
2021-06-05,BAS,4796,2206,2590,3853,943,ITF,ITF5,17,Basilicata
2021-06-23,TOS,31352,15170,16182,20092,11260,ITI,ITI1,9,Toscana
2021-01-31,SIC,4038,1930,2108,112,3926,ITG,ITG1,19,Sicilia
2021-03-08,VEN,13630,6271,7359,9561,4069,ITH,ITH3,5,Veneto
2021-03-09,MOL,1329,579,750,1177,152,ITF,ITF2,14,Molise
2021-02-01,VEN,8561,2502,6059,160,8401,ITH,ITH3,5,Veneto
2021-03-26,PAB,1657,733,924,523,1134,ITH,ITH1,4,Provincia Autonoma Bolzano / Bozen
2021-04-12,ABR,6206,2943,3263,5032,1174,ITF,ITF1,13,Abruzzo
2021-02-06,LIG,1892,768,1124,145,1747,ITC,ITC3,7,Liguria
2021-03-06,FVG,3500,1196,2304,3175,325,ITH,ITH4,6,Friuli-Venezia Giulia
2021-03-18,SAR,7257,3071,4186,5652,1605,ITG,ITG2,20,Sardegna
2021-02-15,VEN,4389,1824,2565,4149,240,ITH,ITH3,5,Veneto
2021-02-27,PAT,1030,457,573,609,421,ITH,ITH2,4,Provincia Autonoma Trento
2021-04-09,PAB,2937,1301,1636,2207,730,ITH,ITH1,4,Provincia Autonoma Bolzano / Bozen
2021-04-19,BAS,4166,1913,2253,2528,1638,ITF,ITF5,17,Basilicata
2021-05-14,SAR,14214,6588,7626,10906,3308,ITG,ITG2,20,Sardegna
2021-01-01,PAT,213,50,163,213,0,ITH,ITH2,4,Provincia Autonoma Trento
2021-06-07,PAT,5789,2880,2909,2806,2983,ITH,ITH2,4,Provincia Autonoma Trento
2021-02-03,SAR,1119,419,700,426,693,ITG,ITG2,20,Sardegna
2021-03-21,MAR,4504,1873,2631,1629,2875,ITI,ITI3,11,Marche
2021-04-18,PIE,22972,10821,12151,20216,2756,ITC,ITC1,1,Piemonte
2021-03-30,VEN,35956,15293,20663,30716,5240,ITH,ITH3,5,Veneto
2021-05-22,PAB,6821,3552,3269,4654,2167,ITH,ITH1,4,Provincia Autonoma Bolzano / Bozen
2021-01-08,PIE,5533,1762,3771,5533,0,ITC,ITC1,1,Piemonte
2021-02-25,PUG,11972,5063,6909,10799,1173,ITF,ITF4,16,Puglia
2021-03-25,LAZ,28944,13308,15636,22337,6607,ITI,ITI4,12,Lazio
2021-04-01,SAR,10164,4072,6092,7150,3014,ITG,ITG2,20,Sardegna
2021-06-14,PIE,37875,19518,18357,30801,7074,ITC,ITC1,1,Piemonte
2021-02-11,PAB,1094,432,662,239,855,ITH,ITH1,4,Provincia Autonoma Bolzano / Bozen
2021-03-22,VDA,560,205,355,333,227,ITC,ITC2,2,Valle d'Aosta / Vallée d'Aoste
2021-04-25,PAT,1971,940,1031,1964,7,ITH,ITH2,4,Provincia Autonoma Trento
2021-01-27,LAZ,6115,2388,3727,998,5117,ITI,ITI4,12,Lazio
2021-02-06,MAR,2463,902,1561,522,1941,ITI,ITI3,11,Marche
2021-03-06,PIE,13994,5211,8783,11205,2789,ITC,ITC1,1,Piemonte
2021-06-05,PUG,41986,20581,21405,29488,12498,ITF,ITF4,16,Puglia
2021-06-15,BAS,3208,1406,1802,2233,975,ITF,ITF5,17,Basilicata
2021-06-11,LIG,17334,8837,8497,11305,6029,ITC,ITC3,7,Liguria
2021-04-15,LIG,11833,5230,6603,9981,1852,ITC,ITC3,7,Liguria
2021-01-22,PIE,3867,1249,2618,2526,1341,ITC,ITC1,1,Piemonte
2021-01-05,CAL,1513,708,805,1513,0,ITF,ITF6,18,Calabria
2021-02-07,SIC,2323,982,1341,674,1649,ITG,ITG1,19,Sicilia
2021-04-10,VEN,27462,11977,15485,18980,8482,ITH,ITH3,5,Veneto
2021-02-10,LOM,14394,4504,9890,7577,6817,ITC,ITC4,3,Lombardia
2021-02-24,CAM,11784,4149,7635,11096,688,ITF,ITF3,15,Campania
2021-05-18,SIC,36092,17361,18731,23566,12526,ITG,ITG1,19,Sicilia
2021-06-06,VEN,37298,19104,18194,32574,4724,ITH,ITH3,5,Veneto
2020-12-27,TOS,620,267,353,620,0,ITI,ITI1,9,Toscana
2021-06-01,LAZ,48738,23517,25221,30266,18472,ITI,ITI4,12,Lazio
2021-04-05,LAZ,19844,9063,10781,13663,6181,ITI,ITI4,12,Lazio
2021-01-16,ABR,933,430,503,933,0,ITF,ITF1,13,Abruzzo
2021-02-12,EMR,5313,1673,3640,3910,1403,ITH,ITH5,8,Emilia-Romagna
2021-06-05,VDA,925,476,449,737,188,ITC,ITC2,2,Valle d'Aosta / Vallée d'Aoste
2021-04-10,EMR,20921,9300,11621,16776,4145,ITH,ITH5,8,Emilia-Romagna
2021-02-11,VDA,231,107,124,222,9,ITC,ITC2,2,Valle d'Aosta / Vallée d'Aoste
2021-03-29,UMB,3890,1731,2159,2411,1479,ITI,ITI2,10,Umbria
2021-04-17,EMR,27298,13072,14226,17953,9345,ITH,ITH5,8,Emilia-Romagna
2021-01-31,UMB,1058,276,782,25,1033,ITI,ITI2,10,Umbria
2021-04-09,VDA,237,111,126,204,33,ITC,ITC2,2,Valle d'Aosta / Vallée d'Aoste
2021-01-07,EMR,10274,3406,6868,10274,0,ITH,ITH5,8,Emilia-Romagna
2021-05-21,MAR,12956,6117,6839,6699,6257,ITI,ITI3,11,Marche
2021-01-03,TOS,3336,1052,2284,3336,0,ITI,ITI1,9,Toscana
2021-05-25,LAZ,47359,22199,25160,35708,11651,ITI,ITI4,12,Lazio
2021-05-22,VDA,940,494,446,540,400,ITC,ITC2,2,Valle d'Aosta / Vallée d'Aoste
2021-05-25,UMB,8817,4300,4517,7754,1063,ITI,ITI2,10,Umbria
2021-05-26,MOL,1548,697,851,794,754,ITF,ITF2,14,Molise
2021-06-25,PAT,6292,3394,2898,3839,2453,ITH,ITH2,4,Provincia Autonoma Trento
2021-01-05,CAM,7237,3637,3600,7237,0,ITF,ITF3,15,Campania
2021-02-28,BAS,804,343,461,775,29,ITF,ITF5,17,Basilicata
2021-03-30,MOL,2003,857,1146,1491,512,ITF,ITF2,14,Molise
2020-12-27,VEN,880,395,485,880,0,ITH,ITH3,5,Veneto
2021-01-12,CAL,2073,1024,1049,2073,0,ITF,ITF6,18,Calabria
2021-02-18,PAB,1839,457,1382,1832,7,ITH,ITH1,4,Provincia Autonoma Bolzano / Bozen
2021-01-02,BAS,949,380,569,949,0,ITF,ITF5,17,Basilicata
2021-01-06,PUG,3950,1672,2278,3950,0,ITF,ITF4,16,Puglia
2021-02-01,MOL,562,201,361,14,548,ITF,ITF2,14,Molise
2021-01-16,BAS,722,304,418,722,0,ITF,ITF5,17,Basilicata
2021-05-12,MOL,2852,1294,1558,2756,96,ITF,ITF2,14,Molise
2021-04-08,LIG,13738,6160,7578,11693,2045,ITC,ITC3,7,Liguria
2021-05-06,FVG,11884,5520,6364,7917,3967,ITH,ITH4,6,Friuli-Venezia Giulia
2021-02-10,SAR,1959,765,1194,1441,518,ITG,ITG2,20,Sardegna
2021-04-26,BAS,4466,2165,2301,4244,222,ITF,ITF5,17,Basilicata
2021-06-04,LIG,14737,7237,7500,9251,5486,ITC,ITC3,7,Liguria
2021-02-17,CAM,7389,3211,4178,6329,1060,ITF,ITF3,15,Campania
2021-05-25,SIC,33404,15305,18099,14111,19293,ITG,ITG1,19,Sicilia
2021-05-30,VEN,22540,11267,11273,15849,6691,ITH,ITH3,5,Veneto
2021-02-03,LOM,25639,7916,17723,1080,24559,ITC,ITC4,3,Lombardia
2021-02-24,CAL,1914,975,939,1436,478,ITF,ITF6,18,Calabria
2021-03-29,SIC,14988,7059,7929,10491,4497,ITG,ITG1,19,Sicilia
2021-04-15,CAM,34341,16662,17679,24441,9900,ITF,ITF3,15,Campania
2021-04-01,LOM,42951,17226,25725,26753,16198,ITC,ITC4,3,Lombardia
2021-02-15,TOS,8771,3376,5395,7945,826,ITI,ITI1,9,Toscana
2021-04-12,LAZ,23841,10746,13095,16942,6899,ITI,ITI4,12,Lazio
2021-04-03,EMR,19937,8765,11172,16197,3740,ITH,ITH5,8,Emilia-Romagna
2021-03-07,ABR,2523,630,1893,2523,0,ITF,ITF1,13,Abruzzo
2021-05-30,EMR,27070,12789,14281,13377,13693,ITH,ITH5,8,Emilia-Romagna
2021-01-09,ABR,1484,566,918,1484,0,ITF,ITF1,13,Abruzzo
2021-02-19,EMR,7327,3010,4317,6813,514,ITH,ITH5,8,Emilia-Romagna
2021-04-16,VDA,599,261,338,597,2,ITC,ITC2,2,Valle d'Aosta / Vallée d'Aoste
2021-06-08,LAZ,66245,31541,34704,36527,29718,ITI,ITI4,12,Lazio
2020-12-31,EMR,2215,780,1435,2215,0,ITH,ITH5,8,Emilia-Romagna
2021-05-28,MAR,13954,6734,7220,9096,4858,ITI,ITI3,11,Marche
2021-06-06,EMR,36406,18911,17495,32000,4406,ITH,ITH5,8,Emilia-Romagna
2021-06-21,ABR,10928,5334,5594,4958,5970,ITF,ITF1,13,Abruzzo
2021-06-22,LOM,108570,56701,51869,79447,29123,ITC,ITC4,3,Lombardia
2021-03-11,BAS,1794,928,866,835,959,ITF,ITF5,17,Basilicata
2021-01-02,UMB,304,111,193,304,0,ITI,ITI2,10,Umbria
2021-03-02,EMR,12658,4272,8386,10581,2077,ITH,ITH5,8,Emilia-Romagna
2021-01-03,PUG,2007,943,1064,2007,0,ITF,ITF4,16,Puglia
2021-04-14,SAR,8253,3903,4350,7015,1238,ITG,ITG2,20,Sardegna
2021-01-10,MAR,1742,700,1042,1742,0,ITI,ITI3,11,Marche
2021-02-21,CAL,615,288,327,538,77,ITF,ITF6,18,Calabria
2021-06-18,MOL,2613,1166,1447,1166,1447,ITF,ITF2,14,Molise
2021-03-19,EMR,15924,6972,8952,7955,7969,ITH,ITH5,8,Emilia-Romagna
2021-03-19,PIE,11021,4512,6509,4415,6606,ITC,ITC1,1,Piemonte
2021-03-27,PUG,12152,5708,6444,6983,5169,ITF,ITF4,16,Puglia
2021-04-05,PIE,14748,6234,8514,12192,2556,ITC,ITC1,1,Piemonte
2021-05-01,SAR,9912,4764,5148,5454,4458,ITG,ITG2,20,Sardegna
2021-01-19,VEN,1310,473,837,1160,150,ITH,ITH3,5,Veneto
2021-01-21,SAR,126,60,66,94,32,ITG,ITG2,20,Sardegna
2021-02-06,VDA,289,104,185,92,197,ITC,ITC2,2,Valle d'Aosta / Vallée d'Aoste
2021-03-12,CAM,14573,7409,7164,8490,6083,ITF,ITF3,15,Campania
2021-06-01,LIG,16151,8110,8041,10785,5366,ITC,ITC3,7,Liguria
2021-06-03,LOM,96976,49643,47333,86190,10786,ITC,ITC4,3,Lombardia
2021-06-17,SIC,41199,19189,22010,20167,21032,ITG,ITG1,19,Sicilia
2021-02-07,SAR,1118,395,723,228,890,ITG,ITG2,20,Sardegna
2021-04-28,CAL,12522,6059,6463,9663,2859,ITF,ITF6,18,Calabria
2021-03-07,UMB,845,180,665,838,7,ITI,ITI2,10,Umbria
2021-01-05,PUG,5107,2251,2856,5107,0,ITF,ITF4,16,Puglia
2020-12-27,PAB,144,65,79,144,0,ITH,ITH1,4,Provincia Autonoma Bolzano / Bozen
2021-02-04,CAL,3571,1700,1871,653,2918,ITF,ITF6,18,Calabria
2021-04-30,VDA,831,355,476,485,346,ITC,ITC2,2,Valle d'Aosta / Vallée d'Aoste
2021-05-10,LAZ,44434,20304,24130,31022,13412,ITI,ITI4,12,Lazio
2021-06-18,LIG,14973,7280,7693,9426,5547,ITC,ITC3,7,Liguria
2021-06-20,LOM,87805,43752,44053,54196,33609,ITC,ITC4,3,Lombardia
2021-04-15,PUG,32535,15181,17354,28991,3544,ITF,ITF4,16,Puglia
2021-01-20,VDA,23,8,15,23,0,ITC,ITC2,2,Valle d'Aosta / Vallée d'Aoste
2021-03-12,LOM,35261,12965,22296,25062,10199,ITC,ITC4,3,Lombardia
2021-04-03,MAR,7575,3205,4370,6906,669,ITI,ITI3,11,Marche
2021-04-07,FVG,7805,3608,4197,7023,782,ITH,ITH4,6,Friuli-Venezia Giulia
2021-05-15,CAL,27224,13020,14204,20376,6848,ITF,ITF6,18,Calabria
2021-03-29,LOM,40036,15537,24499,25205,14831,ITC,ITC4,3,Lombardia
2020-12-31,SIC,887,473,414,887,0,ITG,ITG1,19,Sicilia
2021-01-26,TOS,5393,1792,3601,220,5173,ITI,ITI1,9,Toscana
2021-03-30,ABR,5128,2262,2866,3306,1822,ITF,ITF1,13,Abruzzo
2021-03-10,LIG,5899,2861,3038,3993,1906,ITC,ITC3,7,Liguria
2021-05-06,TOS,31326,13616,17710,14175,17151,ITI,ITI1,9,Toscana
2021-06-03,CAM,72498,35140,37358,61881,10617,ITF,ITF3,15,Campania
2021-01-06,ABR,1831,664,1167,1831,0,ITF,ITF1,13,Abruzzo
2021-06-25,MAR,14265,7114,7151,6760,7505,ITI,ITI3,11,Marche
2021-02-23,CAM,11003,3388,7615,10477,526,ITF,ITF3,15,Campania
2021-04-19,TOS,9096,4508,4588,8062,1034,ITI,ITI1,9,Toscana
2021-05-01,VEN,38843,18232,20611,29900,8943,ITH,ITH3,5,Veneto
2021-05-03,SAR,8187,3820,4367,6590,1597,ITG,ITG2,20,Sardegna
2021-02-02,CAL,2348,1150,1198,177,2171,ITF,ITF6,18,Calabria
2021-05-30,MOL,1829,908,921,1544,285,ITF,ITF2,14,Molise
2021-03-07,SIC,9259,3454,5805,8176,1083,ITG,ITG1,19,Sicilia
2021-04-07,EMR,26115,11889,14226,20104,6011,ITH,ITH5,8,Emilia-Romagna
2021-04-17,TOS,20533,9206,11327,18411,2122,ITI,ITI1,9,Toscana
2021-05-20,SAR,15946,7572,8374,11328,4618,ITG,ITG2,20,Sardegna
2021-01-12,PAT,505,158,347,505,0,ITH,ITH2,4,Provincia Autonoma Trento
2021-01-16,CAL,2400,1124,1276,2400,0,ITF,ITF6,18,Calabria
2021-06-11,PAB,5731,2942,2789,2262,3469,ITH,ITH1,4,Provincia Autonoma Bolzano / Bozen
2021-06-15,SIC,45095,21248,23847,27814,17281,ITG,ITG1,19,Sicilia
2021-02-09,SAR,2287,837,1450,1290,997,ITG,ITG2,20,Sardegna
2021-01-14,EMR,8129,2593,5536,8129,0,ITH,ITH5,8,Emilia-Romagna
2021-03-24,SIC,20876,9803,11073,15215,5661,ITG,ITG1,19,Sicilia
2021-02-26,SAR,2801,1109,1692,2495,306,ITG,ITG2,20,Sardegna
2021-03-20,PAB,1758,849,909,1133,625,ITH,ITH1,4,Provincia Autonoma Bolzano / Bozen
2021-05-27,LAZ,57937,26895,31042,44252,13685,ITI,ITI4,12,Lazio
2021-05-29,UMB,7846,3606,4240,6283,1563,ITI,ITI2,10,Umbria
2021-03-30,BAS,2741,1157,1584,2396,345,ITF,ITF5,17,Basilicata
2021-01-18,VDA,213,74,139,213,0,ITC,ITC2,2,Valle d'Aosta / Vallée d'Aoste
2021-02-21,CAM,5836,2241,3595,5611,225,ITF,ITF3,15,Campania
2021-03-19,PAT,2423,915,1508,1571,852,ITH,ITH2,4,Provincia Autonoma Trento
2021-01-06,BAS,294,129,165,294,0,ITF,ITF5,17,Basilicata
2021-01-24,TOS,3349,1073,2276,201,3148,ITI,ITI1,9,Toscana
2021-03-05,LAZ,19562,8663,10899,14829,4733,ITI,ITI4,12,Lazio
2021-02-16,LAZ,8359,4034,4325,7753,606,ITI,ITI4,12,Lazio
2021-04-05,PAT,35,17,18,33,2,ITH,ITH2,4,Provincia Autonoma Trento
2021-04-16,BAS,3319,1632,1687,2421,898,ITF,ITF5,17,Basilicata
2021-05-29,SIC,47146,21454,25692,23956,23190,ITG,ITG1,19,Sicilia
2021-01-07,TOS,6018,1751,4267,6018,0,ITI,ITI1,9,Toscana
2021-04-11,VDA,479,208,271,479,0,ITC,ITC2,2,Valle d'Aosta / Vallée d'Aoste
2021-02-27,LIG,1888,921,967,1759,129,ITC,ITC3,7,Liguria
2021-03-20,VEN,13016,5388,7628,10937,2079,ITH,ITH3,5,Veneto
2021-03-27,FVG,5365,2907,2458,3954,1411,ITH,ITH4,6,Friuli-Venezia Giulia
2021-02-15,PUG,3255,1269,1986,2634,621,ITF,ITF4,16,Puglia
2021-03-15,LAZ,20806,9706,11100,14063,6743,ITI,ITI4,12,Lazio
2021-03-22,SAR,3696,1497,2199,3183,513,ITG,ITG2,20,Sardegna
2021-03-25,MAR,6654,2772,3882,3246,3408,ITI,ITI3,11,Marche
2021-05-06,CAL,13259,6277,6982,8991,4268,ITF,ITF6,18,Calabria
2021-03-16,MOL,614,230,384,267,347,ITF,ITF2,14,Molise
2021-04-15,PAT,3202,1443,1759,3048,154,ITH,ITH2,4,Provincia Autonoma Trento
2021-06-25,CAM,64222,31113,33109,13122,51100,ITF,ITF3,15,Campania
2021-01-17,TOS,2535,870,1665,2021,514,ITI,ITI1,9,Toscana
2021-02-10,LIG,2314,837,1477,1019,1295,ITC,ITC3,7,Liguria
2021-05-26,PUG,38292,18384,19908,26654,11638,ITF,ITF4,16,Puglia
2021-04-08,SAR,13446,5939,7507,8326,5120,ITG,ITG2,20,Sardegna
2021-06-19,PAB,5612,2984,2628,580,5032,ITH,ITH1,4,Provincia Autonoma Bolzano / Bozen
2020-12-29,SAR,57,32,25,57,0,ITG,ITG2,20,Sardegna
2021-03-11,PAB,1684,825,859,1146,538,ITH,ITH1,4,Provincia Autonoma Bolzano / Bozen
2021-01-11,MOL,557,194,363,557,0,ITF,ITF2,14,Molise
2021-06-18,PIE,40269,20092,20177,26157,14112,ITC,ITC1,1,Piemonte
2021-02-25,PAB,1498,549,949,1497,1,ITH,ITH1,4,Provincia Autonoma Bolzano / Bozen
2021-05-11,LOM,86830,41413,45417,60653,26177,ITC,ITC4,3,Lombardia
2021-03-10,PIE,13681,5213,8468,11387,2294,ITC,ITC1,1,Piemonte
2021-05-25,CAM,46434,22319,24115,23065,23369,ITF,ITF3,15,Campania
2021-06-02,PAB,1444,809,635,987,457,ITH,ITH1,4,Provincia Autonoma Bolzano / Bozen
2021-03-27,PIE,18397,7828,10569,9570,8827,ITC,ITC1,1,Piemonte
2021-04-05,CAL,3414,1605,1809,2557,857,ITF,ITF6,18,Calabria
2021-04-22,SAR,10504,4659,5845,5585,4919,ITG,ITG2,20,Sardegna
2021-01-10,VEN,5033,1671,3362,5033,0,ITH,ITH3,5,Veneto
2021-03-21,ABR,2134,914,1220,844,1290,ITF,ITF1,13,Abruzzo
2021-01-05,LAZ,7375,2803,4572,7375,0,ITI,ITI4,12,Lazio
2021-01-12,SAR,865,408,457,865,0,ITG,ITG2,20,Sardegna
2021-02-05,EMR,9290,2956,6334,1607,7683,ITH,ITH5,8,Emilia-Romagna
2021-05-28,LOM,93480,44806,48674,42926,50554,ITC,ITC4,3,Lombardia
2021-06-12,VDA,1232,599,633,1066,166,ITC,ITC2,2,Valle d'Aosta / Vallée d'Aoste
2021-04-15,FVG,6489,2861,3628,5219,1270,ITH,ITH4,6,Friuli-Venezia Giulia
2021-02-17,LOM,11988,3755,8233,10598,1390,ITC,ITC4,3,Lombardia
2021-03-15,SIC,10615,4686,5929,5722,4893,ITG,ITG1,19,Sicilia
2021-06-12,ABR,11243,5816,5427,9892,1351,ITF,ITF1,13,Abruzzo
2021-06-11,LOM,100515,51185,49330,85964,14551,ITC,ITC4,3,Lombardia
2021-03-08,TOS,6706,2944,3762,1886,4820,ITI,ITI1,9,Toscana
2021-04-29,FVG,6728,2957,3771,4165,2563,ITH,ITH4,6,Friuli-Venezia Giulia
2021-02-20,MAR,4131,1712,2419,4020,111,ITI,ITI3,11,Marche
2021-01-24,LAZ,5694,2229,3465,612,5082,ITI,ITI4,12,Lazio
2021-06-16,TOS,31684,16210,15474,26555,5129,ITI,ITI1,9,Toscana
2021-01-27,PUG,4602,1941,2661,631,3971,ITF,ITF4,16,Puglia
2021-06-18,PAT,6918,3684,3234,1813,5105,ITH,ITH2,4,Provincia Autonoma Trento
2021-01-05,FVG,1678,551,1127,1678,0,ITH,ITH4,6,Friuli-Venezia Giulia
2021-02-07,LAZ,4945,2026,2919,388,4557,ITI,ITI4,12,Lazio
2021-03-27,PAT,1619,710,909,1362,257,ITH,ITH2,4,Provincia Autonoma Trento
2021-05-07,PUG,49966,22305,27661,26537,23429,ITF,ITF4,16,Puglia
2021-05-30,TOS,28671,13944,14727,21725,6946,ITI,ITI1,9,Toscana
2021-03-18,LIG,4986,2124,2862,2007,2979,ITC,ITC3,7,Liguria
2021-05-18,LAZ,44901,20532,24369,35365,9536,ITI,ITI4,12,Lazio
2021-06-20,EMR,29941,15189,14752,15331,14610,ITH,ITH5,8,Emilia-Romagna
2021-03-21,BAS,1055,487,568,360,695,ITF,ITF5,17,Basilicata
2021-04-01,LIG,12421,5510,6911,9651,2770,ITC,ITC3,7,Liguria
2021-01-13,PUG,4543,1730,2813,4543,0,ITF,ITF4,16,Puglia
2021-02-08,PAB,2,1,1,1,1,ITH,ITH1,4,Provincia Autonoma Bolzano / Bozen
2021-04-22,CAM,33949,16536,17413,21545,12404,ITF,ITF3,15,Campania
2021-05-23,VEN,34484,16464,18020,11076,23408,ITH,ITH3,5,Veneto
2021-06-04,PAT,5821,2603,3218,1831,3990,ITH,ITH2,4,Provincia Autonoma Trento
2021-06-08,CAL,15857,7483,8374,13850,2007,ITF,ITF6,18,Calabria
2021-01-20,MAR,403,100,303,384,19,ITI,ITI3,11,Marche
2021-05-29,BAS,3059,1534,1525,834,2225,ITF,ITF5,17,Basilicata
2021-01-12,CAM,5215,2564,2651,5215,0,ITF,ITF3,15,Campania
2021-02-12,VEN,4314,1447,2867,3742,572,ITH,ITH3,5,Veneto
2021-03-19,VDA,322,85,237,287,35,ITC,ITC2,2,Valle d'Aosta / Vallée d'Aoste
2021-02-03,MAR,2124,741,1383,119,2005,ITI,ITI3,11,Marche
2021-03-17,CAL,4049,1805,2244,2138,1911,ITF,ITF6,18,Calabria
2021-04-06,PUG,13802,6223,7579,7051,6751,ITF,ITF4,16,Puglia
2021-05-11,SAR,8887,4121,4766,6525,2362,ITG,ITG2,20,Sardegna
2021-01-25,MOL,319,130,189,3,316,ITF,ITF2,14,Molise
2021-01-29,VEN,9023,2788,6235,366,8657,ITH,ITH3,5,Veneto
2021-01-31,SAR,2121,750,1371,48,2073,ITG,ITG2,20,Sardegna
2021-05-14,MAR,13493,6218,7275,6720,6773,ITI,ITI3,11,Marche
2021-06-25,CAL,18193,8446,9747,7771,10422,ITF,ITF6,18,Calabria
2021-02-05,FVG,2609,784,1825,89,2520,ITH,ITH4,6,Friuli-Venezia Giulia
2021-02-24,PAT,1325,525,800,926,399,ITH,ITH2,4,Provincia Autonoma Trento
2021-05-05,MOL,2414,1042,1372,2273,141,ITF,ITF2,14,Molise
2021-05-06,CAM,57281,27909,29372,42830,14451,ITF,ITF3,15,Campania
2021-05-19,PAB,3627,1847,1780,1841,1786,ITH,ITH1,4,Provincia Autonoma Bolzano / Bozen
2021-01-03,PAB,41,16,25,41,0,ITH,ITH1,4,Provincia Autonoma Bolzano / Bozen
2021-04-14,FVG,7217,3118,4099,5505,1712,ITH,ITH4,6,Friuli-Venezia Giulia
2021-01-13,ABR,1257,441,816,1257,0,ITF,ITF1,13,Abruzzo
2021-06-03,PAT,4765,2234,2531,1301,3464,ITH,ITH2,4,Provincia Autonoma Trento
2021-01-19,PIE,6466,2105,4361,6454,12,ITC,ITC1,1,Piemonte
2021-02-14,SAR,539,263,276,537,2,ITG,ITG2,20,Sardegna
2021-06-08,LIG,17813,8893,8920,11201,6612,ITC,ITC3,7,Liguria
2021-04-13,PAB,2391,1130,1261,2384,7,ITH,ITH1,4,Provincia Autonoma Bolzano / Bozen
2021-05-03,LAZ,39217,17706,21511,26615,12602,ITI,ITI4,12,Lazio
2021-05-07,VDA,564,245,319,533,31,ITC,ITC2,2,Valle d'Aosta / Vallée d'Aoste
2021-03-17,LIG,5552,2368,3184,2473,3079,ITC,ITC3,7,Liguria
2021-04-23,VDA,921,443,478,538,383,ITC,ITC2,2,Valle d'Aosta / Vallée d'Aoste
2021-05-04,MOL,2705,1181,1524,2577,128,ITF,ITF2,14,Molise
2021-05-08,VEN,41431,18743,22688,29622,11809,ITH,ITH3,5,Veneto
2021-01-13,VDA,337,110,227,337,0,ITC,ITC2,2,Valle d'Aosta / Vallée d'Aoste
2021-04-24,FVG,6676,2946,3730,5433,1243,ITH,ITH4,6,Friuli-Venezia Giulia
2021-05-19,PUG,26332,12734,13598,19911,6421,ITF,ITF4,16,Puglia
2021-06-14,MOL,1627,810,817,552,1075,ITF,ITF2,14,Molise
2021-01-31,CAM,8068,3711,4357,23,8045,ITF,ITF3,15,Campania
2021-01-19,LAZ,4770,1956,2814,4316,454,ITI,ITI4,12,Lazio
2021-03-23,PUG,10997,5540,5457,4526,6471,ITF,ITF4,16,Puglia
2021-05-09,LIG,2823,1245,1578,1113,1710,ITC,ITC3,7,Liguria
2021-06-06,FVG,9450,4614,4836,7905,1545,ITH,ITH4,6,Friuli-Venezia Giulia
2021-05-22,BAS,5488,2723,2765,1937,3551,ITF,ITF5,17,Basilicata
2021-02-26,FVG,3734,2092,1642,3586,148,ITH,ITH4,6,Friuli-Venezia Giulia
2021-06-25,EMR,40616,20612,20004,18970,21646,ITH,ITH5,8,Emilia-Romagna
2021-03-26,BAS,1955,703,1252,1695,260,ITF,ITF5,17,Basilicata
2021-02-17,FVG,2354,999,1355,1874,480,ITH,ITH4,6,Friuli-Venezia Giulia
2021-02-18,ABR,2288,933,1355,2158,130,ITF,ITF1,13,Abruzzo
2021-03-17,EMR,13719,5692,8027,5873,7846,ITH,ITH5,8,Emilia-Romagna
2021-05-18,VEN,26894,12511,14383,13322,13572,ITH,ITH3,5,Veneto
2021-05-30,PAT,1770,872,898,930,840,ITH,ITH2,4,Provincia Autonoma Trento
2021-01-29,LIG,3081,1064,2017,67,3014,ITC,ITC3,7,Liguria
2021-03-27,TOS,8863,4153,4710,8648,215,ITI,ITI1,9,Toscana
2021-05-13,EMR,35766,16491,19275,27987,7779,ITH,ITH5,8,Emilia-Romagna
2021-05-29,ABR,10317,4429,5888,4544,5773,ITF,ITF1,13,Abruzzo
2021-03-06,MAR,5704,2624,3080,4437,1267,ITI,ITI3,11,Marche
2021-04-03,PAT,1140,471,669,972,168,ITH,ITH2,4,Provincia Autonoma Trento
2021-06-06,UMB,7610,3903,3707,6917,693,ITI,ITI2,10,Umbria
2021-01-09,VDA,443,199,244,443,0,ITC,ITC2,2,Valle d'Aosta / Vallée d'Aoste
2021-04-29,LAZ,38658,17245,21413,25424,13234,ITI,ITI4,12,Lazio
2021-01-20,MOL,18,8,10,18,0,ITF,ITF2,14,Molise
2021-01-24,CAL,45,18,27,39,6,ITF,ITF6,18,Calabria
2021-03-03,LAZ,17837,7854,9983,13543,4294,ITI,ITI4,12,Lazio
2021-06-06,PIE,35007,18297,16710,32577,2430,ITC,ITC1,1,Piemonte
2021-03-22,VEN,18138,8175,9963,13096,5042,ITH,ITH3,5,Veneto
2021-04-30,MOL,2937,1556,1381,830,2107,ITF,ITF2,14,Molise
2021-05-11,CAM,39847,19234,20613,30464,9383,ITF,ITF3,15,Campania
2021-01-20,LIG,1552,555,997,1540,12,ITC,ITC3,7,Liguria
2021-06-18,LOM,106764,52434,54330,54012,52752,ITC,ITC4,3,Lombardia
2021-03-13,VEN,17229,7303,9926,14098,3131,ITH,ITH3,5,Veneto
2021-03-25,PUG,11472,5788,5684,5231,6241,ITF,ITF4,16,Puglia
2021-02-24,UMB,1520,565,955,1505,15,ITI,ITI2,10,Umbria
2021-02-25,MOL,541,239,302,473,68,ITF,ITF2,14,Molise
2021-03-15,EMR,13442,6242,7200,6943,6499,ITH,ITH5,8,Emilia-Romagna
2021-05-22,ABR,13093,6363,6730,8198,4895,ITF,ITF1,13,Abruzzo
2021-06-14,MAR,12615,6377,6238,9307,3308,ITI,ITI3,11,Marche
2021-04-27,SAR,7615,3550,4065,5573,2042,ITG,ITG2,20,Sardegna
2021-01-15,VEN,5875,1820,4055,5875,0,ITH,ITH3,5,Veneto
2021-03-09,PAB,1194,543,651,1192,2,ITH,ITH1,4,Provincia Autonoma Bolzano / Bozen
2021-03-26,ABR,5354,2311,3043,3279,2075,ITF,ITF1,13,Abruzzo
2021-01-17,SAR,860,277,583,859,1,ITG,ITG2,20,Sardegna
2021-02-17,PIE,4794,2157,2637,3804,990,ITC,ITC1,1,Piemonte
2021-02-24,SIC,9306,4760,4546,8746,560,ITG,ITG1,19,Sicilia
2021-03-15,SAR,2799,1319,1480,2426,373,ITG,ITG2,20,Sardegna
2021-06-24,VDA,1221,629,592,388,833,ITC,ITC2,2,Valle d'Aosta / Vallée d'Aoste
2021-05-30,FVG,11059,4987,6072,7474,3585,ITH,ITH4,6,Friuli-Venezia Giulia
2021-03-01,LOM,18789,8230,10559,17084,1705,ITC,ITC4,3,Lombardia
2021-02-08,PUG,3993,1610,2383,1599,2394,ITF,ITF4,16,Puglia
2021-05-31,ABR,11298,5103,6195,6954,4344,ITF,ITF1,13,Abruzzo
2021-01-21,SIC,1432,704,728,501,931,ITG,ITG1,19,Sicilia
2021-04-20,ABR,5596,2692,2904,4178,1418,ITF,ITF1,13,Abruzzo
2021-04-24,PAT,3546,1700,1846,3532,14,ITH,ITH2,4,Provincia Autonoma Trento
2021-01-26,LAZ,7961,3127,4834,725,7236,ITI,ITI4,12,Lazio
2021-02-26,PAT,1218,435,783,923,295,ITH,ITH2,4,Provincia Autonoma Trento
2021-05-01,SIC,24440,11311,13129,19276,5164,ITG,ITG1,19,Sicilia
2021-02-14,TOS,9000,2569,6431,8890,110,ITI,ITI1,9,Toscana
2021-03-26,SAR,8439,3492,4947,6913,1526,ITG,ITG2,20,Sardegna
2021-06-08,PIE,37565,19463,18102,34747,2818,ITC,ITC1,1,Piemonte
2021-05-20,VEN,44735,21218,23517,20435,24300,ITH,ITH3,5,Veneto
2021-05-22,SAR,24797,11935,12862,19700,5097,ITG,ITG2,20,Sardegna
2021-05-23,PAB,4338,2303,2035,4330,8,ITH,ITH1,4,Provincia Autonoma Bolzano / Bozen
2021-05-25,TOS,34146,16475,17671,19533,14613,ITI,ITI1,9,Toscana
2021-01-14,PAT,700,203,497,700,0,ITH,ITH2,4,Provincia Autonoma Trento
2021-02-09,VEN,5248,1891,3357,3445,1803,ITH,ITH3,5,Veneto
2021-05-10,UMB,5987,2803,3184,3837,2150,ITI,ITI2,10,Umbria
2021-03-29,TOS,9643,4814,4829,9319,324,ITI,ITI1,9,Toscana
2021-04-26,PIE,19793,8745,11048,15392,4401,ITC,ITC1,1,Piemonte
2021-02-13,BAS,799,313,486,738,61,ITF,ITF5,17,Basilicata
2020-12-28,CAL,6,2,4,6,0,ITF,ITF6,18,Calabria
2021-02-03,PAB,1503,478,1025,5,1498,ITH,ITH1,4,Provincia Autonoma Bolzano / Bozen
2021-04-02,LAZ,29303,14010,15293,21966,7337,ITI,ITI4,12,Lazio
2021-06-03,CAL,14151,6623,7528,9580,4571,ITF,ITF6,18,Calabria
2021-05-15,LOM,80894,38780,42114,47520,33374,ITC,ITC4,3,Lombardia
2021-05-24,BAS,4832,2343,2489,1102,3730,ITF,ITF5,17,Basilicata
2021-01-19,SAR,747,270,477,692,55,ITG,ITG2,20,Sardegna
2021-04-07,CAL,6512,2939,3573,3726,2786,ITF,ITF6,18,Calabria
2021-01-29,MAR,1991,730,1261,167,1824,ITI,ITI3,11,Marche
2021-02-08,VDA,223,83,140,25,198,ITC,ITC2,2,Valle d'Aosta / Vallée d'Aoste
2021-02-10,PUG,3646,1436,2210,2135,1511,ITF,ITF4,16,Puglia
2021-03-17,SAR,6560,2852,3708,4952,1608,ITG,ITG2,20,Sardegna
2021-02-09,EMR,4154,1249,2905,2307,1847,ITH,ITH5,8,Emilia-Romagna
2021-02-23,CAL,1591,753,838,1476,115,ITF,ITF6,18,Calabria
2021-04-25,ABR,9066,4621,4445,8256,810,ITF,ITF1,13,Abruzzo
2021-05-18,MAR,11061,5258,5803,7657,3404,ITI,ITI3,11,Marche
2021-02-28,PAT,242,121,121,242,0,ITH,ITH2,4,Provincia Autonoma Trento
2021-03-23,VDA,379,150,229,245,134,ITC,ITC2,2,Valle d'Aosta / Vallée d'Aoste
2021-05-08,UMB,8113,3734,4379,4908,3205,ITI,ITI2,10,Umbria
2021-05-19,VDA,993,498,495,418,575,ITC,ITC2,2,Valle d'Aosta / Vallée d'Aoste
2021-06-08,PAT,5918,2863,3055,1871,4047,ITH,ITH2,4,Provincia Autonoma Trento
2021-01-28,LAZ,8279,3165,5114,782,7497,ITI,ITI4,12,Lazio
2021-02-02,CAM,5724,2805,2919,444,5280,ITF,ITF3,15,Campania
2021-02-10,PAB,1636,605,1031,26,1610,ITH,ITH1,4,Provincia Autonoma Bolzano / Bozen
2021-05-10,SIC,28267,13583,14684,16157,12110,ITG,ITG1,19,Sicilia
2021-03-31,CAM,23182,11369,11813,19743,3439,ITF,ITF3,15,Campania
2021-05-08,LAZ,45417,20733,24684,30022,15395,ITI,ITI4,12,Lazio
2021-01-28,UMB,1248,394,854,19,1229,ITI,ITI2,10,Umbria
2021-01-29,MOL,421,136,285,6,415,ITF,ITF2,14,Molise
2021-04-26,PAT,2654,1251,1403,2559,95,ITH,ITH2,4,Provincia Autonoma Trento
2021-05-09,MOL,2051,932,1119,1955,96,ITF,ITF2,14,Molise
2021-05-13,LOM,87059,41731,45328,58274,28785,ITC,ITC4,3,Lombardia
2021-05-23,PUG,17881,8358,9523,14076,3805,ITF,ITF4,16,Puglia
2021-02-02,LOM,19867,6593,13274,497,19370,ITC,ITC4,3,Lombardia
2021-03-26,SIC,17843,8286,9557,12413,5430,ITG,ITG1,19,Sicilia
2021-06-02,BAS,5959,2804,3155,4416,1543,ITF,ITF5,17,Basilicata
2021-03-31,LOM,42039,17043,24996,26813,15226,ITC,ITC4,3,Lombardia
2021-05-15,EMR,33236,14979,18257,22837,10399,ITH,ITH5,8,Emilia-Romagna
2021-05-03,FVG,7208,3285,3923,3429,3779,ITH,ITH4,6,Friuli-Venezia Giulia
2021-02-04,EMR,9920,3201,6719,1230,8690,ITH,ITH5,8,Emilia-Romagna
2021-05-22,EMR,32971,14114,18857,16905,16066,ITH,ITH5,8,Emilia-Romagna
2021-05-03,UMB,5092,2272,2820,2205,2887,ITI,ITI2,10,Umbria
2021-01-14,FVG,2584,789,1795,2584,0,ITH,ITH4,6,Friuli-Venezia Giulia
2021-04-05,LIG,3978,1753,2225,2329,1649,ITC,ITC3,7,Liguria
2021-04-18,BAS,3720,1847,1873,2352,1368,ITF,ITF5,17,Basilicata
2021-04-09,EMR,25725,11666,14059,20028,5697,ITH,ITH5,8,Emilia-Romagna
2021-01-28,SIC,9025,4271,4754,393,8632,ITG,ITG1,19,Sicilia
2021-05-11,MOL,3207,1414,1793,2957,250,ITF,ITF2,14,Molise
2021-01-23,UMB,280,100,180,2,278,ITI,ITI2,10,Umbria
2021-05-08,SIC,35597,17017,18580,25322,10275,ITG,ITG1,19,Sicilia
2021-05-27,VEN,46430,22819,23611,23298,23132,ITH,ITH3,5,Veneto
2021-02-17,PUG,4278,1747,2531,3673,605,ITF,ITF4,16,Puglia
2021-05-03,PIE,26677,12175,14502,12516,14161,ITC,ITC1,1,Piemonte
2021-04-07,CAM,24970,11984,12986,20245,4725,ITF,ITF3,15,Campania
2021-03-26,LAZ,29959,13775,16184,23112,6847,ITI,ITI4,12,Lazio
2021-05-21,PAB,6921,3803,3118,5076,1845,ITH,ITH1,4,Provincia Autonoma Bolzano / Bozen
2021-05-28,PUG,43631,20660,22971,27973,15658,ITF,ITF4,16,Puglia
2021-02-07,VEN,2315,862,1453,714,1601,ITH,ITH3,5,Veneto
2021-02-02,EMR,9474,3048,6426,515,8959,ITH,ITH5,8,Emilia-Romagna
2021-02-20,BAS,1163,532,631,1044,119,ITF,ITF5,17,Basilicata
2021-02-19,PAT,929,359,570,870,59,ITH,ITH2,4,Provincia Autonoma Trento
2021-05-31,BAS,4229,2009,2220,1721,2508,ITF,ITF5,17,Basilicata
2021-01-26,SIC,9244,4565,4679,253,8991,ITG,ITG1,19,Sicilia
2021-02-26,PIE,12293,4933,7360,11556,737,ITC,ITC1,1,Piemonte
2021-03-24,SAR,7409,3108,4301,6050,1359,ITG,ITG2,20,Sardegna
2021-01-08,ABR,1525,507,1018,1525,0,ITF,ITF1,13,Abruzzo
2021-06-08,FVG,10274,5378,4896,9860,414,ITH,ITH4,6,Friuli-Venezia Giulia
2021-01-21,UMB,610,202,408,341,269,ITI,ITI2,10,Umbria
2021-03-10,LOM,33239,12713,20526,25379,7860,ITC,ITC4,3,Lombardia
2021-04-24,PIE,27472,12423,15049,21818,5654,ITC,ITC1,1,Piemonte
2021-05-27,TOS,28319,13171,15148,13484,14835,ITI,ITI1,9,Toscana
2021-02-28,FVG,2685,1002,1683,2292,393,ITH,ITH4,6,Friuli-Venezia Giulia
2021-04-18,ABR,5814,2728,3086,4871,943,ITF,ITF1,13,Abruzzo
2021-05-11,MAR,10623,4832,5791,5680,4943,ITI,ITI3,11,Marche
2021-01-14,PIE,9767,3152,6615,9767,0,ITC,ITC1,1,Piemonte
2021-03-16,VDA,182,37,145,118,64,ITC,ITC2,2,Valle d'Aosta / Vallée d'Aoste
2021-03-31,TOS,32703,13248,19455,20541,12162,ITI,ITI1,9,Toscana
2021-05-06,LOM,89788,42180,47608,73324,16464,ITC,ITC4,3,Lombardia
2021-01-26,LOM,8340,2705,5635,349,7991,ITC,ITC4,3,Lombardia
2021-03-31,CAL,8811,4001,4810,4853,3958,ITF,ITF6,18,Calabria
2021-02-18,BAS,1070,401,669,855,215,ITF,ITF5,17,Basilicata
2021-04-09,CAL,7909,3704,4205,5021,2888,ITF,ITF6,18,Calabria
2021-04-02,CAM,21849,10516,11333,19527,2322,ITF,ITF3,15,Campania
2021-05-11,LIG,13902,6384,7518,7298,6604,ITC,ITC3,7,Liguria
2021-05-30,PUG,20890,10003,10887,15862,5028,ITF,ITF4,16,Puglia
2021-01-22,MOL,128,36,92,128,0,ITF,ITF2,14,Molise
2021-03-22,TOS,5250,2762,2488,4806,444,ITI,ITI1,9,Toscana
2021-03-24,VEN,22103,9567,12536,15301,6802,ITH,ITH3,5,Veneto
2021-05-16,PAB,2025,932,1093,1333,692,ITH,ITH1,4,Provincia Autonoma Bolzano / Bozen
2021-05-02,MOL,1893,932,961,588,1305,ITF,ITF2,14,Molise
2021-02-20,ABR,4775,1842,2933,4699,76,ITF,ITF1,13,Abruzzo
2021-03-15,MAR,4401,2026,2375,1311,3090,ITI,ITI3,11,Marche
2021-03-29,LIG,10567,4617,5950,7436,3131,ITC,ITC3,7,Liguria
2021-04-26,FVG,5461,2451,3010,3812,1649,ITH,ITH4,6,Friuli-Venezia Giulia
2021-03-06,MOL,1728,807,921,1569,159,ITF,ITF2,14,Molise
2021-06-05,CAL,20337,9528,10809,17375,2962,ITF,ITF6,18,Calabria
2021-01-31,LIG,624,270,354,9,615,ITC,ITC3,7,Liguria
2021-06-23,MAR,13718,6720,6998,6718,7000,ITI,ITI3,11,Marche
2021-02-04,ABR,1681,615,1066,610,1071,ITF,ITF1,13,Abruzzo
2021-03-08,SAR,4679,2425,2254,3459,1220,ITG,ITG2,20,Sardegna
2021-05-20,CAL,16910,8442,8468,11301,5609,ITF,ITF6,18,Calabria
2021-01-05,SIC,10310,5066,5244,10310,0,ITG,ITG1,19,Sicilia
2021-02-10,PIE,7535,2371,5164,1316,6219,ITC,ITC1,1,Piemonte
2021-04-09,BAS,1151,350,801,1088,63,ITF,ITF5,17,Basilicata
2021-05-04,SAR,9542,4387,5155,7689,1853,ITG,ITG2,20,Sardegna
2021-04-10,FVG,5046,2211,2835,3821,1225,ITH,ITH4,6,Friuli-Venezia Giulia
2021-01-05,UMB,854,429,425,854,0,ITI,ITI2,10,Umbria
2021-01-24,SAR,90,34,56,5,85,ITG,ITG2,20,Sardegna
2021-04-08,PIE,25149,10933,14216,20419,4730,ITC,ITC1,1,Piemonte
2021-04-15,SIC,21023,10247,10776,11729,9294,ITG,ITG1,19,Sicilia
2021-05-11,TOS,27944,12982,14962,12485,15459,ITI,ITI1,9,Toscana
2021-04-20,LOM,67651,30828,36823,57314,10337,ITC,ITC4,3,Lombardia
2021-06-21,MOL,2900,1350,1550,1669,1231,ITF,ITF2,14,Molise
2021-05-23,FVG,10269,4853,5416,6121,4148,ITH,ITH4,6,Friuli-Venezia Giulia
2021-01-10,LOM,10513,3957,6556,10513,0,ITC,ITC4,3,Lombardia
2021-04-25,MOL,792,395,397,559,233,ITF,ITF2,14,Molise
2021-01-15,LIG,2257,755,1502,2257,0,ITC,ITC3,7,Liguria
2021-01-17,LOM,8348,3345,5003,8147,201,ITC,ITC4,3,Lombardia
2021-02-07,CAL,859,428,431,148,711,ITF,ITF6,18,Calabria
2021-03-13,TOS,9288,3310,5978,5324,3964,ITI,ITI1,9,Toscana
2021-03-17,LAZ,13809,5912,7897,7553,6256,ITI,ITI4,12,Lazio
2021-06-23,LOM,107735,55781,51954,76542,31193,ITC,ITC4,3,Lombardia
2021-03-15,LOM,31547,11327,20220,23032,8515,ITC,ITC4,3,Lombardia
2021-04-25,LIG,1936,921,1015,1521,415,ITC,ITC3,7,Liguria
2021-05-18,CAL,15311,7656,7655,11893,3418,ITF,ITF6,18,Calabria
2021-06-25,LAZ,60406,28821,31585,27995,32411,ITI,ITI4,12,Lazio
2021-05-04,VEN,42895,20315,22580,34869,8026,ITH,ITH3,5,Veneto
2021-06-20,SIC,32876,15558,17318,14906,17970,ITG,ITG1,19,Sicilia
2021-01-25,PUG,3826,1680,2146,423,3403,ITF,ITF4,16,Puglia
2021-01-13,MAR,2106,746,1360,2106,0,ITI,ITI3,11,Marche
2021-02-10,PAT,853,291,562,511,342,ITH,ITH2,4,Provincia Autonoma Trento
2021-03-13,LIG,3849,1637,2212,2994,855,ITC,ITC3,7,Liguria
2021-05-03,VDA,839,400,439,488,351,ITC,ITC2,2,Valle d'Aosta / Vallée d'Aoste
2021-06-18,SAR,16479,7504,8975,8715,7764,ITG,ITG2,20,Sardegna
2021-05-02,MAR,8899,3936,4963,3161,5738,ITI,ITI3,11,Marche
2021-03-10,SAR,6050,2953,3097,5200,850,ITG,ITG2,20,Sardegna
2021-01-17,CAM,1155,551,604,702,453,ITF,ITF3,15,Campania
2021-01-29,TOS,6144,1700,4444,304,5840,ITI,ITI1,9,Toscana
2021-03-22,CAL,4930,2308,2622,3173,1757,ITF,ITF6,18,Calabria
2021-04-10,PIE,30176,13420,16756,25898,4278,ITC,ITC1,1,Piemonte
2021-05-06,SAR,12951,6010,6941,9805,3146,ITG,ITG2,20,Sardegna
2021-05-07,PAB,4193,2061,2132,3665,528,ITH,ITH1,4,Provincia Autonoma Bolzano / Bozen
2021-01-24,VEN,4117,1219,2898,28,4089,ITH,ITH3,5,Veneto
2021-03-15,CAM,13337,6485,6852,8592,4745,ITF,ITF3,15,Campania
2021-06-20,UMB,6210,3002,3208,1580,4630,ITI,ITI2,10,Umbria
2021-03-07,VDA,64,30,34,11,53,ITC,ITC2,2,Valle d'Aosta / Vallée d'Aoste
2021-05-09,TOS,22527,9766,12761,9668,12859,ITI,ITI1,9,Toscana
2021-04-24,UMB,4567,1963,2604,3387,1180,ITI,ITI2,10,Umbria
2021-01-13,MOL,474,160,314,474,0,ITF,ITF2,14,Molise
2021-06-19,MOL,2326,1156,1170,1316,1010,ITF,ITF2,14,Molise
2021-05-05,PAB,4154,1945,2209,2038,2116,ITH,ITH1,4,Provincia Autonoma Bolzano / Bozen
2021-04-23,MOL,2050,882,1168,1391,659,ITF,ITF2,14,Molise
2021-01-17,EMR,2890,887,2003,2644,246,ITH,ITH5,8,Emilia-Romagna
2021-01-25,PAB,487,183,304,3,484,ITH,ITH1,4,Provincia Autonoma Bolzano / Bozen
2021-03-01,SAR,2267,1155,1112,1608,659,ITG,ITG2,20,Sardegna
2021-06-23,LIG,13971,6691,7280,9524,4447,ITC,ITC3,7,Liguria
2021-01-12,UMB,838,248,590,838,0,ITI,ITI2,10,Umbria
2021-04-22,SIC,26820,12658,14162,20362,6458,ITG,ITG1,19,Sicilia
2021-04-04,ABR,1631,767,864,1502,129,ITF,ITF1,13,Abruzzo
2021-04-08,PAT,3132,1310,1822,2013,1119,ITH,ITH2,4,Provincia Autonoma Trento
2021-03-10,SIC,13860,6059,7801,11677,2183,ITG,ITG1,19,Sicilia
2021-04-15,PIE,29646,13580,16066,24160,5486,ITC,ITC1,1,Piemonte
2021-03-23,PAB,1554,759,795,1553,1,ITH,ITH1,4,Provincia Autonoma Bolzano / Bozen
2021-01-05,PIE,5381,1603,3778,5381,0,ITC,ITC1,1,Piemonte
2021-01-12,SIC,4323,2119,2204,4323,0,ITG,ITG1,19,Sicilia
2021-04-27,LOM,85965,39966,45999,69421,16544,ITC,ITC4,3,Lombardia
2021-06-18,SIC,42949,19850,23099,18718,24231,ITG,ITG1,19,Sicilia
2021-03-14,UMB,66,48,18,66,0,ITI,ITI2,10,Umbria
2021-04-07,VEN,35963,16162,19801,28633,7330,ITH,ITH3,5,Veneto
2021-01-07,FVG,2093,718,1375,2093,0,ITH,ITH4,6,Friuli-Venezia Giulia
2021-02-14,LIG,233,122,111,233,0,ITC,ITC3,7,Liguria
2021-04-02,EMR,23393,10552,12841,18912,4481,ITH,ITH5,8,Emilia-Romagna
2021-02-27,BAS,1993,861,1132,1829,164,ITF,ITF5,17,Basilicata
2021-06-22,UMB,8003,4058,3945,5238,2765,ITI,ITI2,10,Umbria
2021-03-05,FVG,3772,1511,2261,2698,1074,ITH,ITH4,6,Friuli-Venezia Giulia
2021-05-25,LIG,14111,6865,7246,10932,3179,ITC,ITC3,7,Liguria
2021-05-29,EMR,37788,16482,21306,17151,20637,ITH,ITH5,8,Emilia-Romagna
2021-05-15,SIC,56478,26392,30086,41235,15243,ITG,ITG1,19,Sicilia
2021-03-19,SIC,16215,7985,8230,10734,5481,ITG,ITG1,19,Sicilia
2021-06-16,ABR,10709,5357,5352,8046,2663,ITF,ITF1,13,Abruzzo
2021-01-30,VDA,439,202,237,14,425,ITC,ITC2,2,Valle d'Aosta / Vallée d'Aoste
2021-01-31,VEN,4768,1562,3206,391,4377,ITH,ITH3,5,Veneto
2021-05-27,CAM,72866,35307,37559,26370,46496,ITF,ITF3,15,Campania
2021-06-22,PIE,40234,19832,20402,18094,22140,ITC,ITC1,1,Piemonte
2021-02-16,CAM,5439,2411,3028,4668,771,ITF,ITF3,15,Campania
2021-03-29,VEN,31446,13693,17753,27628,3818,ITH,ITH3,5,Veneto
2021-02-04,LAZ,6336,2505,3831,1021,5315,ITI,ITI4,12,Lazio
2021-04-01,PAB,2786,1407,1379,2642,144,ITH,ITH1,4,Provincia Autonoma Bolzano / Bozen
2021-04-08,PUG,17464,7580,9884,11288,6176,ITF,ITF4,16,Puglia
2020-12-31,PAT,1625,449,1176,1625,0,ITH,ITH2,4,Provincia Autonoma Trento
2021-06-07,BAS,4276,1933,2343,3960,316,ITF,ITF5,17,Basilicata
2021-04-11,BAS,848,330,518,785,63,ITF,ITF5,17,Basilicata
2021-05-13,SAR,11941,5613,6328,8893,3048,ITG,ITG2,20,Sardegna
2021-04-19,FVG,6710,3133,3577,3295,3415,ITH,ITH4,6,Friuli-Venezia Giulia
2021-02-02,SAR,1498,669,829,257,1241,ITG,ITG2,20,Sardegna
2021-01-05,VEN,7330,2183,5147,7330,0,ITH,ITH3,5,Veneto
2021-02-19,CAM,9570,3559,6011,8920,650,ITF,ITF3,15,Campania
2021-02-27,PAB,2458,759,1699,2448,10,ITH,ITH1,4,Provincia Autonoma Bolzano / Bozen
2021-03-16,ABR,3485,1452,2033,1831,1654,ITF,ITF1,13,Abruzzo
2020-12-31,LAZ,5293,2121,3172,5293,0,ITI,ITI4,12,Lazio
2021-04-03,LOM,36236,14859,21377,26149,10087,ITC,ITC4,3,Lombardia
2021-05-28,TOS,30069,13909,16160,17628,12441,ITI,ITI1,9,Toscana
2021-04-10,LAZ,23918,10405,13513,16728,7190,ITI,ITI4,12,Lazio
2021-05-30,LOM,74364,35586,38778,34410,39954,ITC,ITC4,3,Lombardia
2021-05-04,PAT,4511,2448,2063,4417,94,ITH,ITH2,4,Provincia Autonoma Trento
2021-01-17,FVG,1716,523,1193,1716,0,ITH,ITH4,6,Friuli-Venezia Giulia
2021-02-05,LAZ,7310,2979,4331,1210,6100,ITI,ITI4,12,Lazio
2021-04-07,VDA,910,474,436,681,229,ITC,ITC2,2,Valle d'Aosta / Vallée d'Aoste
2021-04-12,EMR,19242,9005,10237,14796,4446,ITH,ITH5,8,Emilia-Romagna
2021-04-22,TOS,35726,15305,20421,18287,17439,ITI,ITI1,9,Toscana
2021-03-08,PAT,1411,434,977,1057,354,ITH,ITH2,4,Provincia Autonoma Trento
2021-04-06,MAR,8877,3693,5184,8065,812,ITI,ITI3,11,Marche
2021-02-24,TOS,10371,4467,5904,10174,197,ITI,ITI1,9,Toscana
2021-03-15,FVG,3952,1809,2143,1631,2321,ITH,ITH4,6,Friuli-Venezia Giulia
2021-06-08,EMR,44676,22873,21803,37244,7432,ITH,ITH5,8,Emilia-Romagna
2021-03-22,PAT,2306,973,1333,1431,875,ITH,ITH2,4,Provincia Autonoma Trento
2021-06-04,TOS,28248,13376,14872,20496,7752,ITI,ITI1,9,Toscana
2021-01-24,PAT,547,276,271,224,323,ITH,ITH2,4,Provincia Autonoma Trento
2021-05-20,UMB,9846,4593,5253,6198,3648,ITI,ITI2,10,Umbria
2021-02-09,VDA,251,84,167,68,183,ITC,ITC2,2,Valle d'Aosta / Vallée d'Aoste
2021-03-06,PUG,16146,6125,10021,14057,2089,ITF,ITF4,16,Puglia
2021-04-03,LAZ,24784,11183,13601,18084,6700,ITI,ITI4,12,Lazio
2021-04-08,TOS,29681,12555,17126,23294,6387,ITI,ITI1,9,Toscana
2020-12-31,CAM,1490,811,679,1490,0,ITF,ITF3,15,Campania
2021-02-10,VEN,4751,1588,3163,3697,1054,ITH,ITH3,5,Veneto
2021-03-23,MAR,5789,2529,3260,2262,3527,ITI,ITI3,11,Marche
2021-06-06,CAM,62319,30977,31342,61672,647,ITF,ITF3,15,Campania
2021-01-07,CAL,2191,1069,1122,2191,0,ITF,ITF6,18,Calabria
2021-01-08,PUG,5642,2367,3275,5642,0,ITF,ITF4,16,Puglia
2021-02-13,PAB,318,79,239,312,6,ITH,ITH1,4,Provincia Autonoma Bolzano / Bozen
2021-06-13,CAL,6593,3242,3351,5563,1030,ITF,ITF6,18,Calabria
2021-06-14,PUG,41532,20328,21204,29231,12301,ITF,ITF4,16,Puglia
2021-02-06,MOL,429,179,250,29,400,ITF,ITF2,14,Molise
2021-02-26,CAM,13336,4228,9108,12001,1335,ITF,ITF3,15,Campania
2021-04-08,VEN,32338,14355,17983,24459,7879,ITH,ITH3,5,Veneto
2021-04-11,PAB,2720,1291,1429,2543,177,ITH,ITH1,4,Provincia Autonoma Bolzano / Bozen
2021-04-17,CAL,10822,5072,5750,9046,1776,ITF,ITF6,18,Calabria
2021-04-18,PUG,22589,10805,11784,21526,1063,ITF,ITF4,16,Puglia
2021-02-08,MAR,833,258,575,371,462,ITI,ITI3,11,Marche
2021-04-24,CAM,36359,17525,18834,25112,11247,ITF,ITF3,15,Campania
2021-06-17,BAS,4421,2034,2387,2103,2318,ITF,ITF5,17,Basilicata
2021-02-20,PUG,2971,1080,1891,2714,257,ITF,ITF4,16,Puglia
2021-03-27,SAR,5735,2192,3543,5313,422,ITG,ITG2,20,Sardegna
2021-05-01,CAL,16631,7934,8697,12435,4196,ITF,ITF6,18,Calabria
2021-05-11,FVG,9026,4328,4698,7224,1802,ITH,ITH4,6,Friuli-Venezia Giulia
2021-04-21,BAS,3922,1835,2087,2272,1650,ITF,ITF5,17,Basilicata
2021-05-19,MAR,11472,5272,6200,8563,2909,ITI,ITI3,11,Marche
2021-01-31,FVG,2717,838,1879,385,2332,ITH,ITH4,6,Friuli-Venezia Giulia
2021-02-15,LIG,2262,839,1423,1865,397,ITC,ITC3,7,Liguria
2021-03-05,CAL,6235,3618,2617,5661,574,ITF,ITF6,18,Calabria
2021-05-23,SAR,9967,4807,5160,7722,2245,ITG,ITG2,20,Sardegna
2021-05-24,PAB,1444,762,682,1110,334,ITH,ITH1,4,Provincia Autonoma Bolzano / Bozen
2021-05-05,ABR,11654,5585,6069,6449,5205,ITF,ITF1,13,Abruzzo
2021-02-12,SAR,2237,933,1304,2178,59,ITG,ITG2,20,Sardegna
2021-03-27,SIC,15600,7353,8247,10748,4852,ITG,ITG1,19,Sicilia
2021-04-27,PIE,22608,10214,12394,17461,5147,ITC,ITC1,1,Piemonte
2021-03-09,ABR,5176,1804,3372,4238,938,ITF,ITF1,13,Abruzzo
2021-01-03,LIG,734,230,504,734,0,ITC,ITC3,7,Liguria
2021-01-17,PIE,3518,1168,2350,2870,648,ITC,ITC1,1,Piemonte
2021-01-29,SIC,9122,4229,4893,426,8696,ITG,ITG1,19,Sicilia
2021-04-10,SAR,10492,4749,5743,8555,1937,ITG,ITG2,20,Sardegna
2021-02-20,PAB,1802,540,1262,1784,18,ITH,ITH1,4,Provincia Autonoma Bolzano / Bozen
2021-06-04,VEN,49435,25738,23697,41366,8069,ITH,ITH3,5,Veneto
2021-02-12,SIC,4586,1810,2776,4319,267,ITG,ITG1,19,Sicilia
2021-03-15,PIE,10682,4184,6498,5062,5620,ITC,ITC1,1,Piemonte
2021-02-24,VEN,8616,3679,4937,8128,488,ITH,ITH3,5,Veneto
2021-04-10,CAM,28351,13492,14859,23438,4913,ITF,ITF3,15,Campania
2021-04-18,PAB,3110,1607,1503,2100,1010,ITH,ITH1,4,Provincia Autonoma Bolzano / Bozen
2021-05-11,PIE,32076,15457,16619,18864,13212,ITC,ITC1,1,Piemonte
2021-05-23,SIC,34091,16595,17496,20072,14019,ITG,ITG1,19,Sicilia
2021-01-31,PIE,4113,1753,2360,112,4001,ITC,ITC1,1,Piemonte
2021-05-23,LOM,60762,28927,31835,26809,33953,ITC,ITC4,3,Lombardia
2021-02-12,LOM,13959,4364,9595,9025,4934,ITC,ITC4,3,Lombardia
2021-02-19,LAZ,10043,5078,4965,9212,831,ITI,ITI4,12,Lazio
2021-06-17,ABR,10746,5381,5365,7303,3443,ITF,ITF1,13,Abruzzo
2021-04-10,LOM,52727,21834,30893,40772,11955,ITC,ITC4,3,Lombardia
2021-06-06,LOM,89822,46176,43646,80603,9219,ITC,ITC4,3,Lombardia
2021-01-07,LOM,11756,3634,8122,11756,0,ITC,ITC4,3,Lombardia
2021-03-03,TOS,18228,6538,11690,14622,3606,ITI,ITI1,9,Toscana
2021-06-04,MOL,3025,1485,1540,2583,442,ITF,ITF2,14,Molise
2021-01-18,BAS,463,157,306,364,99,ITF,ITF5,17,Basilicata
2021-01-05,TOS,5249,1755,3494,5249,0,ITI,ITI1,9,Toscana
2021-04-08,MOL,1766,903,863,1564,202,ITF,ITF2,14,Molise
2021-06-10,SIC,51141,24016,27125,44052,7089,ITG,ITG1,19,Sicilia
2021-01-15,PUG,4552,1866,2686,4552,0,ITF,ITF4,16,Puglia
2021-04-19,EMR,20900,9797,11103,14627,6273,ITH,ITH5,8,Emilia-Romagna
2021-01-31,PAT,75,15,60,1,74,ITH,ITH2,4,Provincia Autonoma Trento
2021-03-31,UMB,3903,1733,2170,2216,1687,ITI,ITI2,10,Umbria
2021-01-09,EMR,9986,3451,6535,9986,0,ITH,ITH5,8,Emilia-Romagna
2021-06-15,EMR,42935,22104,20831,28023,14912,ITH,ITH5,8,Emilia-Romagna
2021-03-16,BAS,1908,802,1106,229,1679,ITF,ITF5,17,Basilicata
2021-03-07,EMR,7840,2958,4882,6320,1520,ITH,ITH5,8,Emilia-Romagna
2021-03-03,EMR,15854,5253,10601,13369,2485,ITH,ITH5,8,Emilia-Romagna
2021-05-11,SIC,32271,15354,16917,19797,12474,ITG,ITG1,19,Sicilia
2021-06-13,PAT,3684,2033,1651,295,3389,ITH,ITH2,4,Provincia Autonoma Trento
2021-02-20,MOL,1018,441,577,998,20,ITF,ITF2,14,Molise
2021-02-17,SIC,5215,3203,2012,4547,668,ITG,ITG1,19,Sicilia
2021-05-17,ABR,11034,5037,5997,6180,4854,ITF,ITF1,13,Abruzzo
2021-05-30,LAZ,41175,17621,23554,33822,7353,ITI,ITI4,12,Lazio
2021-05-13,LAZ,50107,22511,27596,32329,17778,ITI,ITI4,12,Lazio
2021-05-31,MOL,2351,1139,1212,1933,418,ITF,ITF2,14,Molise
2021-05-06,PIE,33481,15796,17685,19927,13554,ITC,ITC1,1,Piemonte
2021-02-23,BAS,1901,771,1130,1763,138,ITF,ITF5,17,Basilicata
2021-05-23,PIE,28700,13130,15570,15750,12950,ITC,ITC1,1,Piemonte
2021-05-14,MOL,2644,1215,1429,1926,718,ITF,ITF2,14,Molise
2020-12-27,PAT,103,40,63,103,0,ITH,ITH2,4,Provincia Autonoma Trento
2021-02-12,PIE,6891,2215,4676,3930,2961,ITC,ITC1,1,Piemonte
2021-06-03,BAS,4919,2256,2663,3738,1181,ITF,ITF5,17,Basilicata
2021-05-25,FVG,12868,6361,6507,9557,3311,ITH,ITH4,6,Friuli-Venezia Giulia
2021-03-12,BAS,1905,980,925,805,1100,ITF,ITF5,17,Basilicata
2021-04-24,SIC,31126,14692,16434,23506,7620,ITG,ITG1,19,Sicilia
2021-03-01,PIE,12043,4846,7197,11234,809,ITC,ITC1,1,Piemonte
2021-06-14,PAB,2904,1576,1328,547,2357,ITH,ITH1,4,Provincia Autonoma Bolzano / Bozen
2021-03-13,LOM,27168,9768,17400,21079,6089,ITC,ITC4,3,Lombardia
2021-01-03,SAR,90,36,54,90,0,ITG,ITG2,20,Sardegna
2021-01-10,TOS,3001,1104,1897,3001,0,ITI,ITI1,9,Toscana
2021-06-18,VEN,52738,26317,26421,24397,28341,ITH,ITH3,5,Veneto
2021-02-05,CAL,3808,1717,2091,489,3319,ITF,ITF6,18,Calabria
2021-06-02,MOL,2805,1355,1450,2706,99,ITF,ITF2,14,Molise
2021-04-20,TOS,18157,8109,10048,12601,5556,ITI,ITI1,9,Toscana
2021-06-11,FVG,10529,5755,4774,9749,780,ITH,ITH4,6,Friuli-Venezia Giulia
2021-05-17,BAS,5540,2732,2808,3407,2133,ITF,ITF5,17,Basilicata
2021-03-03,FVG,3645,1633,2012,2371,1274,ITH,ITH4,6,Friuli-Venezia Giulia
2021-03-11,PUG,14800,6562,8238,11629,3171,ITF,ITF4,16,Puglia
2021-04-03,TOS,15014,6647,8367,13888,1126,ITI,ITI1,9,Toscana
2021-04-27,LIG,14778,6681,8097,7194,7584,ITC,ITC3,7,Liguria
2021-02-23,ABR,2781,1274,1507,2770,11,ITF,ITF1,13,Abruzzo
2021-03-18,MAR,3389,1475,1914,162,3227,ITI,ITI3,11,Marche
2021-04-29,CAL,11959,5820,6139,8390,3569,ITF,ITF6,18,Calabria
2021-01-21,VDA,33,12,21,33,0,ITC,ITC2,2,Valle d'Aosta / Vallée d'Aoste
2021-02-03,LIG,2315,791,1524,55,2260,ITC,ITC3,7,Liguria
2021-06-02,PUG,26912,13169,13743,22099,4813,ITF,ITF4,16,Puglia
2021-02-06,ABR,1610,743,867,602,1008,ITF,ITF1,13,Abruzzo
2021-04-12,CAL,6994,3383,3611,5272,1722,ITF,ITF6,18,Calabria
2021-06-01,UMB,4380,2089,2291,4225,155,ITI,ITI2,10,Umbria
2021-01-04,VDA,142,59,83,142,0,ITC,ITC2,2,Valle d'Aosta / Vallée d'Aoste
2021-05-25,EMR,25043,11182,13861,11711,13332,ITH,ITH5,8,Emilia-Romagna
2021-05-25,PIE,31130,14445,16685,15990,15140,ITC,ITC1,1,Piemonte
2021-01-19,CAL,1116,491,625,1105,11,ITF,ITF6,18,Calabria
2021-03-10,UMB,4034,1945,2089,2778,1256,ITI,ITI2,10,Umbria
2021-06-11,PIE,43413,22970,20443,40600,2813,ITC,ITC1,1,Piemonte
2021-01-27,TOS,4835,1573,3262,206,4629,ITI,ITI1,9,Toscana
2021-02-14,EMR,1403,378,1025,1283,120,ITH,ITH5,8,Emilia-Romagna
2021-03-27,VEN,32066,14010,18056,26266,5800,ITH,ITH3,5,Veneto
2021-05-23,MAR,9208,4282,4926,7537,1671,ITI,ITI3,11,Marche
2021-01-21,CAM,2092,1115,977,676,1416,ITF,ITF3,15,Campania
2021-03-28,VDA,522,212,310,521,1,ITC,ITC2,2,Valle d'Aosta / Vallée d'Aoste
2021-01-16,UMB,221,73,148,221,0,ITI,ITI2,10,Umbria
2021-03-13,PUG,10466,4134,6332,8658,1808,ITF,ITF4,16,Puglia
2021-06-03,VEN,54211,27894,26317,42268,11943,ITH,ITH3,5,Veneto
2021-05-06,MAR,12656,5822,6834,5584,7072,ITI,ITI3,11,Marche
2021-06-17,CAL,15456,7043,8413,9325,6131,ITF,ITF6,18,Calabria
2021-02-15,PAB,72,42,30,26,46,ITH,ITH1,4,Provincia Autonoma Bolzano / Bozen
2021-03-11,VDA,197,76,121,66,131,ITC,ITC2,2,Valle d'Aosta / Vallée d'Aoste
2021-04-29,LIG,15568,6978,8590,6737,8831,ITC,ITC3,7,Liguria
2021-05-01,LOM,95964,43670,52294,66757,29207,ITC,ITC4,3,Lombardia
2021-05-27,FVG,12789,6121,6668,7574,5215,ITH,ITH4,6,Friuli-Venezia Giulia
2021-01-21,LOM,5458,1594,3864,4770,688,ITC,ITC4,3,Lombardia
2021-02-12,MAR,1582,618,964,1430,152,ITI,ITI3,11,Marche
2021-03-26,CAL,8010,3794,4216,4889,3121,ITF,ITF6,18,Calabria
2021-02-02,UMB,944,274,670,32,912,ITI,ITI2,10,Umbria
2021-02-24,PUG,10040,4705,5335,9449,591,ITF,ITF4,16,Puglia
2021-04-12,LIG,12384,5475,6909,10365,2019,ITC,ITC3,7,Liguria
2021-02-08,ABR,1194,395,799,486,708,ITF,ITF1,13,Abruzzo
2021-06-02,VDA,1215,688,527,814,401,ITC,ITC2,2,Valle d'Aosta / Vallée d'Aoste
2021-06-04,PUG,52287,25310,26977,34664,17623,ITF,ITF4,16,Puglia
2021-01-19,LIG,1371,438,933,1281,90,ITC,ITC3,7,Liguria
2021-03-17,TOS,11421,4587,6834,6892,4529,ITI,ITI1,9,Toscana
2021-05-11,PAB,2844,1335,1509,1321,1523,ITH,ITH1,4,Provincia Autonoma Bolzano / Bozen
2021-05-18,PUG,28820,13405,15415,16078,12742,ITF,ITF4,16,Puglia
2021-05-19,ABR,10693,5111,5582,7654,3039,ITF,ITF1,13,Abruzzo
2021-06-19,VDA,1287,666,621,669,618,ITC,ITC2,2,Valle d'Aosta / Vallée d'Aoste
2021-02-07,LOM,7310,2824,4486,338,6972,ITC,ITC4,3,Lombardia
2021-04-14,CAM,27643,13335,14308,19074,8569,ITF,ITF3,15,Campania
2021-06-25,TOS,31374,15628,15746,11789,19585,ITI,ITI1,9,Toscana
2021-06-20,VEN,40417,19665,20752,18931,21486,ITH,ITH3,5,Veneto
2021-06-22,SAR,19329,8988,10341,7269,12060,ITG,ITG2,20,Sardegna
2021-02-05,LIG,2679,987,1692,304,2375,ITC,ITC3,7,Liguria
2021-05-01,CAM,46337,22660,23677,30234,16103,ITF,ITF3,15,Campania
2021-06-08,TOS,32476,16621,15855,32044,432,ITI,ITI1,9,Toscana
2021-02-26,TOS,10080,3834,6246,8874,1206,ITI,ITI1,9,Toscana
2021-05-27,EMR,42142,18690,23452,14011,28131,ITH,ITH5,8,Emilia-Romagna
2021-02-10,MAR,1439,452,987,1080,359,ITI,ITI3,11,Marche
2021-01-14,LAZ,5488,2145,3343,5488,0,ITI,ITI4,12,Lazio
2021-02-16,EMR,5772,2446,3326,5241,531,ITH,ITH5,8,Emilia-Romagna
2021-04-26,SIC,21719,10279,11440,13639,8080,ITG,ITG1,19,Sicilia
2021-06-06,TOS,28294,13648,14646,22939,5355,ITI,ITI1,9,Toscana
2021-03-31,SAR,10274,4164,6110,7826,2448,ITG,ITG2,20,Sardegna
2021-01-19,LOM,8052,2329,5723,7584,468,ITC,ITC4,3,Lombardia
2021-04-02,VDA,873,344,529,648,225,ITC,ITC2,2,Valle d'Aosta / Vallée d'Aoste
2021-05-18,UMB,7733,3345,4388,3890,3843,ITI,ITI2,10,Umbria
2021-02-26,EMR,9634,3673,5961,8586,1048,ITH,ITH5,8,Emilia-Romagna
2021-04-01,MAR,7576,3182,4394,4160,3416,ITI,ITI3,11,Marche
2021-06-25,FVG,9899,4954,4945,1814,8085,ITH,ITH4,6,Friuli-Venezia Giulia
2021-03-22,UMB,3560,1655,1905,2314,1246,ITI,ITI2,10,Umbria
2021-05-29,VDA,798,434,364,561,237,ITC,ITC2,2,Valle d'Aosta / Vallée d'Aoste
2021-06-16,PUG,41090,20214,20876,26801,14289,ITF,ITF4,16,Puglia
2021-04-05,UMB,4251,1729,2522,2196,2055,ITI,ITI2,10,Umbria
2021-04-06,MOL,1494,701,793,1151,343,ITF,ITF2,14,Molise
2021-02-22,TOS,9818,4253,5565,9541,277,ITI,ITI1,9,Toscana
2021-02-07,UMB,54,17,37,1,53,ITI,ITI2,10,Umbria
2021-02-08,MOL,334,141,193,216,118,ITF,ITF2,14,Molise
2021-05-19,MOL,2340,1205,1135,1915,425,ITF,ITF2,14,Molise
2021-06-01,SIC,38737,17629,21108,24969,13768,ITG,ITG1,19,Sicilia
2020-12-30,PAB,388,182,206,388,0,ITH,ITH1,4,Provincia Autonoma Bolzano / Bozen
2021-03-03,CAL,5051,2757,2294,3971,1080,ITF,ITF6,18,Calabria
2021-02-21,BAS,284,113,171,284,0,ITF,ITF5,17,Basilicata
2021-03-23,MOL,1642,694,948,1435,207,ITF,ITF2,14,Molise
2021-04-05,SIC,8021,3958,4063,6581,1440,ITG,ITG1,19,Sicilia
2021-01-15,PAT,595,132,463,595,0,ITH,ITH2,4,Provincia Autonoma Trento
2021-02-17,LIG,2689,1182,1507,2263,426,ITC,ITC3,7,Liguria
2021-03-17,FVG,3236,1267,1969,745,2491,ITH,ITH4,6,Friuli-Venezia Giulia
2021-03-07,BAS,889,309,580,851,38,ITF,ITF5,17,Basilicata
2021-05-13,FVG,11139,5367,5772,9082,2057,ITH,ITH4,6,Friuli-Venezia Giulia
2021-05-28,LIG,16284,8128,8156,11749,4535,ITC,ITC3,7,Liguria
2020-12-30,PUG,1,0,1,1,0,ITF,ITF4,16,Puglia
2021-01-09,BAS,557,160,397,557,0,ITF,ITF5,17,Basilicata
2021-01-05,LIG,2878,895,1983,2878,0,ITC,ITC3,7,Liguria
2021-06-09,PAB,3789,1884,1905,1315,2474,ITH,ITH1,4,Provincia Autonoma Bolzano / Bozen
2021-02-26,VEN,8295,3270,5025,7037,1258,ITH,ITH3,5,Veneto
2021-01-09,LAZ,6298,2562,3736,6298,0,ITI,ITI4,12,Lazio
2021-03-01,PAB,922,221,701,921,1,ITH,ITH1,4,Provincia Autonoma Bolzano / Bozen
2021-04-24,VEN,24748,10824,13924,15669,9079,ITH,ITH3,5,Veneto
2021-05-07,ABR,12193,5706,6487,7775,4418,ITF,ITF1,13,Abruzzo
2021-02-16,FVG,2516,1135,1381,2400,116,ITH,ITH4,6,Friuli-Venezia Giulia
2021-03-03,LIG,4580,1847,2733,3554,1026,ITC,ITC3,7,Liguria
2021-04-12,SAR,6997,3184,3813,5279,1718,ITG,ITG2,20,Sardegna
2021-01-02,SAR,60,21,39,60,0,ITG,ITG2,20,Sardegna
2021-03-15,PAB,1192,451,741,710,482,ITH,ITH1,4,Provincia Autonoma Bolzano / Bozen
2021-05-13,PIE,35674,17523,18151,20558,15116,ITC,ITC1,1,Piemonte
2021-06-08,SAR,14822,7066,7756,11320,3502,ITG,ITG2,20,Sardegna
2021-04-22,MAR,10796,4931,5865,9218,1578,ITI,ITI3,11,Marche
2021-05-20,PAT,5010,2355,2655,3375,1635,ITH,ITH2,4,Provincia Autonoma Trento
2021-02-02,PIE,10242,3509,6733,816,9426,ITC,ITC1,1,Piemonte
2021-02-28,SAR,368,169,199,142,226,ITG,ITG2,20,Sardegna
2021-02-24,MAR,3490,1519,1971,3412,78,ITI,ITI3,11,Marche
2021-03-24,PAT,2376,940,1436,1556,820,ITH,ITH2,4,Provincia Autonoma Trento
2021-03-22,PUG,9859,5038,4821,4213,5646,ITF,ITF4,16,Puglia
2021-03-31,PIE,19110,8104,11006,10416,8694,ITC,ITC1,1,Piemonte
2021-04-19,LAZ,30100,13680,16420,19421,10679,ITI,ITI4,12,Lazio
2021-04-26,SAR,6824,3266,3558,5948,876,ITG,ITG2,20,Sardegna
2021-04-27,PAB,2226,1013,1213,1149,1077,ITH,ITH1,4,Provincia Autonoma Bolzano / Bozen
2021-01-14,VEN,7063,1924,5139,7063,0,ITH,ITH3,5,Veneto
2021-01-17,PAB,2328,1044,1284,2317,11,ITH,ITH1,4,Provincia Autonoma Bolzano / Bozen
2021-01-24,PUG,1670,750,920,154,1516,ITF,ITF4,16,Puglia
2021-02-21,LAZ,6989,3180,3809,6526,463,ITI,ITI4,12,Lazio
2021-02-25,VDA,201,101,100,194,7,ITC,ITC2,2,Valle d'Aosta / Vallée d'Aoste
2021-05-27,PIE,37358,17384,19974,19249,18109,ITC,ITC1,1,Piemonte
2021-06-23,PAB,1132,584,548,369,763,ITH,ITH1,4,Provincia Autonoma Bolzano / Bozen
2021-02-09,PAT,917,287,630,442,475,ITH,ITH2,4,Provincia Autonoma Trento
2021-03-12,VEN,18651,8189,10462,11903,6748,ITH,ITH3,5,Veneto
2021-06-01,LOM,93869,46062,47807,76850,17019,ITC,ITC4,3,Lombardia
2021-01-02,LOM,200,72,128,200,0,ITC,ITC4,3,Lombardia
2021-02-16,PIE,3967,1756,2211,3209,758,ITC,ITC1,1,Piemonte
2021-06-08,LOM,102289,52008,50281,88279,14010,ITC,ITC4,3,Lombardia
2021-03-15,PUG,12259,6076,6183,5756,6503,ITF,ITF4,16,Puglia
2021-06-22,CAM,51239,24396,26843,12318,38921,ITF,ITF3,15,Campania
2021-02-28,LOM,7882,3253,4629,7672,210,ITC,ITC4,3,Lombardia
2021-05-03,CAL,14759,6765,7994,10546,4213,ITF,ITF6,18,Calabria
2021-01-17,PUG,1308,590,718,1239,69,ITF,ITF4,16,Puglia
2021-03-14,CAM,8618,3827,4791,4478,4140,ITF,ITF3,15,Campania
2021-06-23,PUG,27876,13634,14242,16497,11379,ITF,ITF4,16,Puglia
2021-02-15,MOL,144,70,74,141,3,ITF,ITF2,14,Molise
2021-03-17,PAT,2071,792,1279,1200,871,ITH,ITH2,4,Provincia Autonoma Trento
2021-04-26,LOM,87936,40923,47013,68778,19158,ITC,ITC4,3,Lombardia
2021-04-27,PUG,26653,12067,14586,21066,5587,ITF,ITF4,16,Puglia
2021-05-07,BAS,4649,2284,2365,3295,1354,ITF,ITF5,17,Basilicata
2021-05-10,CAM,35461,16386,19075,25540,9921,ITF,ITF3,15,Campania
2021-06-04,MAR,14333,7288,7045,11896,2437,ITI,ITI3,11,Marche
2021-03-21,CAL,4454,1924,2530,2734,1720,ITF,ITF6,18,Calabria
2021-04-08,MAR,7521,3286,4235,7194,327,ITI,ITI3,11,Marche
2021-04-12,SIC,18771,9121,9650,11520,7251,ITG,ITG1,19,Sicilia
2021-05-08,TOS,29150,13114,16036,13693,15457,ITI,ITI1,9,Toscana
2021-03-24,FVG,3968,1713,2255,2488,1480,ITH,ITH4,6,Friuli-Venezia Giulia
2021-03-25,ABR,5797,2666,3131,3180,2617,ITF,ITF1,13,Abruzzo
2021-02-14,SIC,1055,402,653,915,140,ITG,ITG1,19,Sicilia
2021-03-12,TOS,16973,6611,10362,13445,3528,ITI,ITI1,9,Toscana
2021-04-28,EMR,33713,15586,18127,20825,12888,ITH,ITH5,8,Emilia-Romagna
2021-01-27,ABR,1364,515,849,39,1325,ITF,ITF1,13,Abruzzo
2021-05-20,FVG,12682,6297,6385,10168,2514,ITH,ITH4,6,Friuli-Venezia Giulia
2021-06-08,CAM,51472,25038,26434,44485,6987,ITF,ITF3,15,Campania
2021-01-14,TOS,3255,1179,2076,3255,0,ITI,ITI1,9,Toscana
2021-03-07,CAL,3391,1730,1661,3300,91,ITF,ITF6,18,Calabria
2021-06-20,TOS,25129,12451,12678,15647,9482,ITI,ITI1,9,Toscana
2021-06-24,EMR,38948,19455,19493,19563,19385,ITH,ITH5,8,Emilia-Romagna
2021-06-05,UMB,8222,3775,4447,5569,2653,ITI,ITI2,10,Umbria
2021-01-09,FVG,2513,841,1672,2513,0,ITH,ITH4,6,Friuli-Venezia Giulia
2021-02-27,ABR,2812,1338,1474,2546,266,ITF,ITF1,13,Abruzzo
2021-03-22,MAR,5652,2375,3277,2524,3128,ITI,ITI3,11,Marche
2021-06-15,FVG,11694,5909,5785,5300,6394,ITH,ITH4,6,Friuli-Venezia Giulia
2021-01-07,PIE,5387,1739,3648,5387,0,ITC,ITC1,1,Piemonte
2021-03-12,UMB,2698,1082,1616,2202,496,ITI,ITI2,10,Umbria
2021-06-06,PUG,30508,15361,15147,25482,5026,ITF,ITF4,16,Puglia
2021-02-09,CAL,2157,911,1246,956,1201,ITF,ITF6,18,Calabria
2021-03-05,PIE,15375,6059,9316,11557,3818,ITC,ITC1,1,Piemonte
2021-05-20,TOS,29718,13875,15843,18906,10812,ITI,ITI1,9,Toscana
2021-06-22,PAT,6163,3373,2790,3635,2528,ITH,ITH2,4,Provincia Autonoma Trento
2021-04-10,PUG,30824,13062,17762,26601,4223,ITF,ITF4,16,Puglia
2021-01-25,VDA,147,65,82,0,147,ITC,ITC2,2,Valle d'Aosta / Vallée d'Aoste
2021-03-17,LOM,26253,10493,15760,15254,10999,ITC,ITC4,3,Lombardia
2021-03-22,LIG,7743,3466,4277,4807,2936,ITC,ITC3,7,Liguria
2021-05-22,CAM,67890,32472,35418,46450,21440,ITF,ITF3,15,Campania
2021-01-31,TOS,3050,1129,1921,106,2944,ITI,ITI1,9,Toscana
2021-05-13,VEN,44203,21812,22391,34320,9883,ITH,ITH3,5,Veneto
2021-05-29,CAL,19228,8933,10295,9398,9830,ITF,ITF6,18,Calabria
2021-02-02,VEN,6511,1880,4631,397,6114,ITH,ITH3,5,Veneto
2021-03-13,MOL,1189,594,595,200,989,ITF,ITF2,14,Molise
2021-01-24,MAR,881,339,542,5,876,ITI,ITI3,11,Marche
2021-02-07,LIG,407,153,254,2,405,ITC,ITC3,7,Liguria
2021-03-07,FVG,2547,932,1615,2546,1,ITH,ITH4,6,Friuli-Venezia Giulia
2021-06-07,ABR,10992,5241,5751,9176,1816,ITF,ITF1,13,Abruzzo
2021-01-15,MOL,538,242,296,538,0,ITF,ITF2,14,Molise
2021-04-11,ABR,5330,2606,2724,4847,483,ITF,ITF1,13,Abruzzo
2021-05-04,MAR,10857,4791,6066,4958,5899,ITI,ITI3,11,Marche
2021-05-18,LIG,13459,6117,7342,10168,3291,ITC,ITC3,7,Liguria
2021-05-30,PAB,4760,2514,2246,752,4008,ITH,ITH1,4,Provincia Autonoma Bolzano / Bozen
2021-03-05,PAT,2247,703,1544,1681,566,ITH,ITH2,4,Provincia Autonoma Trento
2021-03-12,SIC,12772,5490,7282,10777,1995,ITG,ITG1,19,Sicilia
2021-06-09,ABR,11361,5992,5369,9683,1678,ITF,ITF1,13,Abruzzo
2021-05-15,SAR,13791,6427,7364,10358,3433,ITG,ITG2,20,Sardegna
2021-01-07,PAT,1270,310,960,1270,0,ITH,ITH2,4,Provincia Autonoma Trento
2021-05-14,VDA,960,442,518,291,669,ITC,ITC2,2,Valle d'Aosta / Vallée d'Aoste
2020-12-31,FVG,1053,384,669,1053,0,ITH,ITH4,6,Friuli-Venezia Giulia
2021-04-05,TOS,15280,6823,8457,14543,737,ITI,ITI1,9,Toscana
2021-06-15,PIE,38818,19991,18827,27073,11745,ITC,ITC1,1,Piemonte
2021-03-21,UMB,675,338,337,675,0,ITI,ITI2,10,Umbria
2021-03-31,VEN,38797,16380,22417,31305,7492,ITH,ITH3,5,Veneto
2021-02-07,TOS,2806,952,1854,886,1920,ITI,ITI1,9,Toscana
2021-03-07,PIE,11977,4658,7319,11099,878,ITC,ITC1,1,Piemonte
2021-04-03,PAB,831,364,467,22,809,ITH,ITH1,4,Provincia Autonoma Bolzano / Bozen
2021-03-25,PAB,2150,1063,1087,1707,443,ITH,ITH1,4,Provincia Autonoma Bolzano / Bozen
2021-04-14,CAL,8128,3921,4207,6682,1446,ITF,ITF6,18,Calabria
2021-05-22,LAZ,55065,26969,28096,44396,10669,ITI,ITI4,12,Lazio
2021-04-04,BAS,610,225,385,197,413,ITF,ITF5,17,Basilicata
2021-02-16,CAL,1738,734,1004,1460,278,ITF,ITF6,18,Calabria
2021-06-23,MOL,2787,1284,1503,230,2557,ITF,ITF2,14,Molise
2021-05-17,UMB,6371,3062,3309,4193,2178,ITI,ITI2,10,Umbria
2021-04-01,PUG,13858,6477,7381,7512,6346,ITF,ITF4,16,Puglia
2021-01-14,UMB,752,201,551,752,0,ITI,ITI2,10,Umbria
2021-03-20,MAR,4136,1740,2396,1049,3087,ITI,ITI3,11,Marche
2021-04-17,PAT,2230,1138,1092,2173,57,ITH,ITH2,4,Provincia Autonoma Trento
2020-12-31,PIE,3909,1334,2575,3909,0,ITC,ITC1,1,Piemonte
2021-01-26,SAR,1336,453,883,27,1309,ITG,ITG2,20,Sardegna
2021-01-27,PAB,84,28,56,1,83,ITH,ITH1,4,Provincia Autonoma Bolzano / Bozen
2021-02-03,PUG,5037,2005,3032,730,4307,ITF,ITF4,16,Puglia
2021-03-31,EMR,25265,11043,14222,19809,5456,ITH,ITH5,8,Emilia-Romagna
2021-01-22,MAR,488,168,320,194,294,ITI,ITI3,11,Marche
2021-06-17,FVG,11187,5656,5531,2267,8920,ITH,ITH4,6,Friuli-Venezia Giulia
2021-02-01,VDA,404,127,277,87,317,ITC,ITC2,2,Valle d'Aosta / Vallée d'Aoste
2021-03-19,UMB,1743,565,1178,1087,656,ITI,ITI2,10,Umbria
2021-04-19,PAT,2625,1235,1390,2603,22,ITH,ITH2,4,Provincia Autonoma Trento
2021-03-30,VDA,402,223,179,382,20,ITC,ITC2,2,Valle d'Aosta / Vallée d'Aoste
2021-03-24,CAM,17920,8368,9552,14963,2957,ITF,ITF3,15,Campania
2021-05-20,LIG,12856,5968,6888,8831,4025,ITC,ITC3,7,Liguria
2021-05-27,CAL,17585,8679,8906,9818,7767,ITF,ITF6,18,Calabria
2021-05-15,LAZ,57327,27389,29938,40821,16506,ITI,ITI4,12,Lazio
2021-05-20,CAM,60733,28074,32659,43177,17556,ITF,ITF3,15,Campania
2021-05-12,VDA,1140,549,591,470,670,ITC,ITC2,2,Valle d'Aosta / Vallée d'Aoste
2021-06-15,PAT,6237,3280,2957,1723,4514,ITH,ITH2,4,Provincia Autonoma Trento
2021-02-09,CAM,4643,2202,2441,4391,252,ITF,ITF3,15,Campania
2021-03-06,ABR,4177,1358,2819,3607,570,ITF,ITF1,13,Abruzzo
2021-03-19,LAZ,17411,7535,9876,11083,6328,ITI,ITI4,12,Lazio
2021-03-20,MOL,2321,968,1353,1000,1321,ITF,ITF2,14,Molise
2021-03-24,LOM,43230,15605,27625,31352,11878,ITC,ITC4,3,Lombardia
2021-05-18,TOS,28844,14271,14573,20016,8828,ITI,ITI1,9,Toscana
2021-05-29,CAM,67795,32250,35545,43939,23856,ITF,ITF3,15,Campania
2021-02-09,LOM,12209,3331,8878,4035,8174,ITC,ITC4,3,Lombardia
2021-03-26,EMR,23702,10109,13593,17265,6437,ITH,ITH5,8,Emilia-Romagna
2021-05-08,SAR,13088,5971,7117,10799,2289,ITG,ITG2,20,Sardegna
2021-06-22,FVG,11225,5787,5438,2264,8961,ITH,ITH4,6,Friuli-Venezia Giulia
2021-06-25,LIG,13293,6338,6955,7160,6133,ITC,ITC3,7,Liguria
2021-01-10,MOL,270,72,198,270,0,ITF,ITF2,14,Molise
2021-04-05,LOM,27377,11694,15683,19274,8103,ITC,ITC4,3,Lombardia
2021-04-06,VDA,741,381,360,629,112,ITC,ITC2,2,Valle d'Aosta / Vallée d'Aoste
2021-04-20,MOL,2318,1025,1293,1220,1098,ITF,ITF2,14,Molise
2021-06-18,MAR,15117,7550,7567,8370,6747,ITI,ITI3,11,Marche
2021-06-09,MOL,1023,565,458,523,500,ITF,ITF2,14,Molise
2021-06-22,SIC,39314,18077,21237,18136,21178,ITG,ITG1,19,Sicilia
2021-01-13,BAS,916,387,529,916,0,ITF,ITF5,17,Basilicata
2020-12-31,TOS,802,201,601,802,0,ITI,ITI1,9,Toscana
2021-04-14,PIE,27713,12564,15149,23187,4526,ITC,ITC1,1,Piemonte
2021-04-23,BAS,4536,2185,2351,3536,1000,ITF,ITF5,17,Basilicata
2021-05-23,MOL,1699,863,836,1694,5,ITF,ITF2,14,Molise
2021-04-10,TOS,11720,5349,6371,10977,743,ITI,ITI1,9,Toscana
2021-04-14,EMR,27035,12839,14196,20932,6103,ITH,ITH5,8,Emilia-Romagna
2021-01-19,PAT,406,77,329,406,0,ITH,ITH2,4,Provincia Autonoma Trento
2021-01-30,BAS,706,229,477,129,577,ITF,ITF5,17,Basilicata
2021-03-01,PUG,15105,5868,9237,13733,1372,ITF,ITF4,16,Puglia
2021-02-13,ABR,854,385,469,438,416,ITF,ITF1,13,Abruzzo
2021-04-19,CAL,7858,3793,4065,6187,1671,ITF,ITF6,18,Calabria
2021-01-21,EMR,2165,729,1436,819,1346,ITH,ITH5,8,Emilia-Romagna
2021-02-11,UMB,842,349,493,837,5,ITI,ITI2,10,Umbria
2021-05-22,SIC,47954,22778,25176,28645,19309,ITG,ITG1,19,Sicilia
2021-05-22,UMB,6962,2753,4209,2642,4320,ITI,ITI2,10,Umbria
2021-02-28,SIC,7164,3062,4102,6534,630,ITG,ITG1,19,Sicilia
2021-02-28,CAM,10411,3206,7205,8511,1900,ITF,ITF3,15,Campania
2021-01-09,CAL,1935,1043,892,1935,0,ITF,ITF6,18,Calabria
2021-06-08,SIC,47469,22306,25163,40952,6517,ITG,ITG1,19,Sicilia
2021-03-18,VDA,136,43,93,99,37,ITC,ITC2,2,Valle d'Aosta / Vallée d'Aoste
2021-06-03,FVG,12231,6668,5563,10257,1974,ITH,ITH4,6,Friuli-Venezia Giulia
2021-06-22,LAZ,61674,28375,33299,29011,32663,ITI,ITI4,12,Lazio
2021-03-04,ABR,5937,2360,3577,5015,922,ITF,ITF1,13,Abruzzo
2021-04-05,SAR,2036,784,1252,2035,1,ITG,ITG2,20,Sardegna
2021-01-31,LOM,9734,3762,5972,29,9705,ITC,ITC4,3,Lombardia
2021-02-14,CAM,3928,1923,2005,3894,34,ITF,ITF3,15,Campania
2021-02-22,PAB,526,143,383,514,12,ITH,ITH1,4,Provincia Autonoma Bolzano / Bozen
2021-03-14,LAZ,17239,6752,10487,12085,5154,ITI,ITI4,12,Lazio
2021-05-06,LIG,14515,6439,8076,6190,8325,ITC,ITC3,7,Liguria
2021-03-19,VEN,13791,5668,8123,7696,6095,ITH,ITH3,5,Veneto
2021-05-25,LOM,91073,43582,47491,44631,46442,ITC,ITC4,3,Lombardia
2021-03-04,VDA,291,139,152,42,249,ITC,ITC2,2,Valle d'Aosta / Vallée d'Aoste
2021-02-14,LOM,3581,1545,2036,2946,635,ITC,ITC4,3,Lombardia
2021-05-26,VDA,1209,587,622,576,633,ITC,ITC2,2,Valle d'Aosta / Vallée d'Aoste
2021-03-01,MOL,661,274,387,447,214,ITF,ITF2,14,Molise
2021-04-29,MAR,13268,6067,7201,7170,6098,ITI,ITI3,11,Marche
2021-01-26,LIG,2487,806,1681,16,2471,ITC,ITC3,7,Liguria
2021-01-12,LOM,20219,6698,13521,20219,0,ITC,ITC4,3,Lombardia
2021-01-26,CAM,7340,3726,3614,351,6989,ITF,ITF3,15,Campania
2021-03-10,PAT,2403,929,1474,1482,921,ITH,ITH2,4,Provincia Autonoma Trento
2021-01-19,FVG,6,2,4,6,0,ITH,ITH4,6,Friuli-Venezia Giulia
2021-03-04,BAS,1881,892,989,1085,796,ITF,ITF5,17,Basilicata
2021-04-03,MOL,1773,851,922,1738,35,ITF,ITF2,14,Molise
2021-01-09,SIC,7183,3388,3795,7183,0,ITG,ITG1,19,Sicilia
2021-02-19,TOS,8294,2953,5341,7781,513,ITI,ITI1,9,Toscana
2021-06-03,EMR,37849,18416,19433,30345,7504,ITH,ITH5,8,Emilia-Romagna
2021-06-03,PIE,34563,17842,16721,30185,4378,ITC,ITC1,1,Piemonte
2021-01-10,PUG,2348,1061,1287,2348,0,ITF,ITF4,16,Puglia
2021-02-23,EMR,8215,3218,4997,7829,386,ITH,ITH5,8,Emilia-Romagna
2021-04-20,PUG,21138,9814,11324,17673,3465,ITF,ITF4,16,Puglia
2021-05-03,SIC,23327,10798,12529,13540,9787,ITG,ITG1,19,Sicilia
2021-03-12,EMR,18306,7701,10605,11589,6717,ITH,ITH5,8,Emilia-Romagna
2020-12-27,PUG,509,252,257,509,0,ITF,ITF4,16,Puglia
2021-04-02,UMB,4352,1782,2570,3595,757,ITI,ITI2,10,Umbria
2021-04-19,CAM,30770,14830,15940,19200,11570,ITF,ITF3,15,Campania
2021-05-28,ABR,13991,6296,7695,7640,6351,ITF,ITF1,13,Abruzzo
2021-06-12,BAS,3674,1687,1987,2988,686,ITF,ITF5,17,Basilicata
2021-01-09,UMB,1745,499,1246,1745,0,ITI,ITI2,10,Umbria
2021-04-19,SIC,18214,8623,9591,12635,5579,ITG,ITG1,19,Sicilia
2021-01-09,CAM,10567,5024,5543,10567,0,ITF,ITF3,15,Campania
2021-02-28,CAL,2329,1056,1273,2176,153,ITF,ITF6,18,Calabria
2021-04-19,UMB,5025,2221,2804,2976,2049,ITI,ITI2,10,Umbria
2021-02-16,UMB,1308,655,653,1299,9,ITI,ITI2,10,Umbria
2021-05-27,SIC,47443,21785,25658,24855,22588,ITG,ITG1,19,Sicilia
2021-05-03,EMR,28697,13556,15141,17819,10878,ITH,ITH5,8,Emilia-Romagna
2021-01-07,CAM,8911,4167,4744,8911,0,ITF,ITF3,15,Campania
2021-05-27,UMB,9974,4863,5111,8655,1319,ITI,ITI2,10,Umbria
2021-01-19,TOS,1105,532,573,1105,0,ITI,ITI1,9,Toscana
2021-03-12,CAL,5151,2464,2687,4089,1062,ITF,ITF6,18,Calabria
2021-01-04,UMB,810,398,412,810,0,ITI,ITI2,10,Umbria
2021-03-05,CAM,16810,6663,10147,10147,6663,ITF,ITF3,15,Campania
2021-04-14,SIC,20113,9721,10392,11417,8696,ITG,ITG1,19,Sicilia
2021-01-14,CAL,2639,1252,1387,2639,0,ITF,ITF6,18,Calabria
2021-04-14,UMB,8158,3677,4481,6179,1979,ITI,ITI2,10,Umbria
2021-05-29,FVG,12009,5840,6169,7022,4987,ITH,ITH4,6,Friuli-Venezia Giulia
2021-06-17,LAZ,66232,31771,34461,32143,34089,ITI,ITI4,12,Lazio
2021-01-15,PAB,3282,1228,2054,3282,0,ITH,ITH1,4,Provincia Autonoma Bolzano / Bozen
2021-04-21,LAZ,33035,15012,18023,20662,12373,ITI,ITI4,12,Lazio
2021-01-07,LIG,3230,1095,2135,3230,0,ITC,ITC3,7,Liguria
2021-06-13,LIG,5616,2695,2921,5163,453,ITC,ITC3,7,Liguria
2021-04-17,LIG,7382,3216,4166,6632,750,ITC,ITC3,7,Liguria
2021-01-07,SAR,3113,1077,2036,3113,0,ITG,ITG2,20,Sardegna
2021-04-18,VDA,522,254,268,518,4,ITC,ITC2,2,Valle d'Aosta / Vallée d'Aoste
2021-06-22,VEN,43063,21287,21776,18807,24256,ITH,ITH3,5,Veneto
2021-04-17,MAR,11701,5315,6386,10628,1073,ITI,ITI3,11,Marche
2021-05-01,LIG,7142,3256,3886,1342,5800,ITC,ITC3,7,Liguria
2021-02-07,PIE,3088,974,2114,445,2643,ITC,ITC1,1,Piemonte
2021-06-14,VDA,306,163,143,12,294,ITC,ITC2,2,Valle d'Aosta / Vallée d'Aoste
2021-03-05,LIG,4869,2150,2719,3737,1132,ITC,ITC3,7,Liguria
2021-06-10,SAR,17808,8479,9329,11772,6036,ITG,ITG2,20,Sardegna
2021-02-19,LOM,14211,5399,8812,13488,723,ITC,ITC4,3,Lombardia
2021-04-22,MOL,1845,864,981,1066,779,ITF,ITF2,14,Molise
2021-05-31,VDA,879,395,484,500,379,ITC,ITC2,2,Valle d'Aosta / Vallée d'Aoste
2021-04-17,LOM,48478,21293,27185,37640,10838,ITC,ITC4,3,Lombardia
2021-04-26,VEN,20714,9452,11262,15576,5138,ITH,ITH3,5,Veneto
2021-06-18,PAB,4052,2107,1945,1154,2898,ITH,ITH1,4,Provincia Autonoma Bolzano / Bozen
2021-06-03,LAZ,56246,28443,27803,38571,17675,ITI,ITI4,12,Lazio
2021-06-13,MAR,10437,5414,5023,9200,1237,ITI,ITI3,11,Marche
2020-12-27,MAR,204,99,105,204,0,ITI,ITI3,11,Marche
2021-05-05,BAS,4335,2048,2287,3445,890,ITF,ITF5,17,Basilicata
2021-02-17,MOL,72,32,40,57,15,ITF,ITF2,14,Molise
2021-02-26,LOM,18390,7554,10836,16518,1872,ITC,ITC4,3,Lombardia
2021-03-09,BAS,1400,713,687,794,606,ITF,ITF5,17,Basilicata
2021-04-21,SIC,22377,10742,11635,16269,6108,ITG,ITG1,19,Sicilia
2021-01-21,CAL,962,447,515,932,30,ITF,ITF6,18,Calabria
2021-01-22,PUG,1409,578,831,991,418,ITF,ITF4,16,Puglia
2021-05-28,MOL,2644,1362,1282,2097,547,ITF,ITF2,14,Molise
2021-02-28,EMR,6818,2526,4292,4973,1845,ITH,ITH5,8,Emilia-Romagna
2021-01-25,BAS,1024,429,595,74,950,ITF,ITF5,17,Basilicata
2021-04-26,EMR,27900,12936,14964,18579,9321,ITH,ITH5,8,Emilia-Romagna
2021-04-07,SIC,15463,7609,7854,8351,7112,ITG,ITG1,19,Sicilia
2021-06-03,UMB,9047,4472,4575,8762,285,ITI,ITI2,10,Umbria
2021-01-16,EMR,5628,1718,3910,5628,0,ITH,ITH5,8,Emilia-Romagna
2021-04-07,UMB,5574,2292,3282,3568,2006,ITI,ITI2,10,Umbria
2021-02-01,ABR,1632,573,1059,271,1361,ITF,ITF1,13,Abruzzo
2021-03-14,EMR,8801,3839,4962,5004,3797,ITH,ITH5,8,Emilia-Romagna
2021-01-11,BAS,183,66,117,183,0,ITF,ITF5,17,Basilicata
2021-01-14,CAM,7074,2978,4096,7074,0,ITF,ITF3,15,Campania
2021-02-23,UMB,1693,658,1035,1651,42,ITI,ITI2,10,Umbria
2021-06-03,SIC,45765,20988,24777,34257,11508,ITG,ITG1,19,Sicilia
2021-01-12,TOS,3581,1398,2183,3581,0,ITI,ITI1,9,Toscana
2021-01-08,PAB,1521,479,1042,1521,0,ITH,ITH1,4,Provincia Autonoma Bolzano / Bozen
2021-06-06,LIG,3818,2033,1785,2948,870,ITC,ITC3,7,Liguria
2021-06-10,LAZ,71244,33545,37699,37636,33608,ITI,ITI4,12,Lazio
2021-03-23,ABR,4832,2187,2645,2266,2566,ITF,ITF1,13,Abruzzo
2021-04-24,LIG,8218,3795,4423,5067,3151,ITC,ITC3,7,Liguria
2021-05-22,FVG,11549,5187,6362,7317,4232,ITH,ITH4,6,Friuli-Venezia Giulia
2020-12-31,SAR,32,16,16,32,0,ITG,ITG2,20,Sardegna
2021-04-25,VDA,849,408,441,710,139,ITC,ITC2,2,Valle d'Aosta / Vallée d'Aoste
2021-01-25,ABR,1604,632,972,17,1587,ITF,ITF1,13,Abruzzo
2021-02-26,LIG,3764,1523,2241,3436,328,ITC,ITC3,7,Liguria
2021-06-21,VDA,1122,600,522,617,505,ITC,ITC2,2,Valle d'Aosta / Vallée d'Aoste
2021-06-07,VDA,710,347,363,649,61,ITC,ITC2,2,Valle d'Aosta / Vallée d'Aoste
2021-06-06,MAR,12388,6104,6284,10811,1577,ITI,ITI3,11,Marche
2021-06-20,LIG,1241,615,626,983,258,ITC,ITC3,7,Liguria
2021-02-27,VDA,231,85,146,124,107,ITC,ITC2,2,Valle d'Aosta / Vallée d'Aoste
2021-04-14,LAZ,29294,13275,16019,19171,10123,ITI,ITI4,12,Lazio
2021-06-11,MOL,3420,1644,1776,2008,1412,ITF,ITF2,14,Molise
2021-06-15,VEN,47516,24130,23386,30039,17477,ITH,ITH3,5,Veneto
2021-05-22,PIE,33471,15110,18361,17252,16219,ITC,ITC1,1,Piemonte
2021-06-25,PUG,43434,21185,22249,21603,21831,ITF,ITF4,16,Puglia
2020-12-31,LOM,713,301,412,713,0,ITC,ITC4,3,Lombardia
2021-04-15,MOL,1925,793,1132,1080,845,ITF,ITF2,14,Molise
2021-01-02,SIC,4844,2522,2322,4844,0,ITG,ITG1,19,Sicilia
2021-04-24,TOS,13439,6169,7270,5991,7448,ITI,ITI1,9,Toscana
2021-06-15,CAL,9571,4428,5143,6260,3311,ITF,ITF6,18,Calabria
2021-01-26,FVG,1977,647,1330,217,1760,ITH,ITH4,6,Friuli-Venezia Giulia
2021-04-26,CAM,34031,16647,17384,28409,5622,ITF,ITF3,15,Campania
2021-05-21,ABR,13017,6326,6691,8036,4981,ITF,ITF1,13,Abruzzo
2021-04-17,VEN,22414,9083,13331,15135,7279,ITH,ITH3,5,Veneto
2021-02-24,LIG,3764,1560,2204,3506,258,ITC,ITC3,7,Liguria
2021-04-20,PAB,1561,784,777,1560,1,ITH,ITH1,4,Provincia Autonoma Bolzano / Bozen
2021-01-07,VEN,8360,2318,6042,8360,0,ITH,ITH3,5,Veneto
2021-06-13,VEN,36887,19042,17845,29927,6960,ITH,ITH3,5,Veneto
2020-12-29,LIG,125,33,92,125,0,ITC,ITC3,7,Liguria
2021-01-10,PAB,2,2,0,2,0,ITH,ITH1,4,Provincia Autonoma Bolzano / Bozen
2021-06-16,PAB,3809,2017,1792,8,3801,ITH,ITH1,4,Provincia Autonoma Bolzano / Bozen
2021-03-18,ABR,3896,1651,2245,2065,1831,ITF,ITF1,13,Abruzzo
2021-01-12,LIG,2469,887,1582,2469,0,ITC,ITC3,7,Liguria
2021-02-09,FVG,1842,555,1287,1556,286,ITH,ITH4,6,Friuli-Venezia Giulia
2021-06-01,SAR,14318,6653,7665,9728,4590,ITG,ITG2,20,Sardegna
2021-02-21,SAR,1589,710,879,1559,30,ITG,ITG2,20,Sardegna
2021-04-22,LIG,13851,6209,7642,8778,5073,ITC,ITC3,7,Liguria
2021-01-21,VEN,2293,719,1574,21,2272,ITH,ITH3,5,Veneto
2021-02-02,PAT,908,240,668,191,717,ITH,ITH2,4,Provincia Autonoma Trento
2021-03-03,MAR,6648,3047,3601,5764,884,ITI,ITI3,11,Marche
2021-01-06,VDA,65,33,32,65,0,ITC,ITC2,2,Valle d'Aosta / Vallée d'Aoste
2021-04-19,SAR,10193,4621,5572,8763,1430,ITG,ITG2,20,Sardegna
2021-01-05,MAR,1571,589,982,1571,0,ITI,ITI3,11,Marche
2021-05-13,PAT,3406,1579,1827,2305,1101,ITH,ITH2,4,Provincia Autonoma Trento
2021-05-14,BAS,5907,2799,3108,3376,2531,ITF,ITF5,17,Basilicata
2021-01-09,SAR,4026,1417,2609,4026,0,ITG,ITG2,20,Sardegna
2021-02-14,LAZ,5777,2372,3405,5306,471,ITI,ITI4,12,Lazio
2021-03-24,PIE,15521,6354,9167,6394,9127,ITC,ITC1,1,Piemonte
2021-06-15,SAR,14660,6787,7873,9929,4731,ITG,ITG2,20,Sardegna
2021-03-05,VEN,13336,5020,8316,9666,3670,ITH,ITH3,5,Veneto
2021-02-18,VDA,349,153,196,261,88,ITC,ITC2,2,Valle d'Aosta / Vallée d'Aoste
2021-02-28,LAZ,10263,4017,6246,9748,515,ITI,ITI4,12,Lazio
2021-03-07,SAR,1657,750,907,1117,540,ITG,ITG2,20,Sardegna
2021-03-08,PAB,1210,534,676,1183,27,ITH,ITH1,4,Provincia Autonoma Bolzano / Bozen
2021-05-20,PIE,38611,17934,20677,13667,24944,ITC,ITC1,1,Piemonte
2021-03-31,PAT,2584,983,1601,1727,857,ITH,ITH2,4,Provincia Autonoma Trento
2021-04-12,LOM,47221,20574,26647,32887,14334,ITC,ITC4,3,Lombardia
2021-01-02,LAZ,6707,2631,4076,6707,0,ITI,ITI4,12,Lazio
2021-02-09,PIE,7392,2316,5076,722,6670,ITC,ITC1,1,Piemonte
2021-05-04,PAB,3449,1843,1606,2412,1037,ITH,ITH1,4,Provincia Autonoma Bolzano / Bozen
2021-05-11,PUG,32532,14348,18184,14117,18415,ITF,ITF4,16,Puglia
2021-03-07,CAM,11973,5404,6569,8130,3843,ITF,ITF3,15,Campania
2021-05-04,PUG,35016,14810,20206,18581,16435,ITF,ITF4,16,Puglia
2021-02-21,LOM,5053,1864,3189,5036,17,ITC,ITC4,3,Lombardia
2021-02-22,MOL,265,129,136,250,15,ITF,ITF2,14,Molise
2021-03-14,CAL,2705,1049,1656,2285,420,ITF,ITF6,18,Calabria
2021-04-07,PIE,23611,9999,13612,18150,5461,ITC,ITC1,1,Piemonte
2021-03-08,PUG,14986,6434,8552,12586,2400,ITF,ITF4,16,Puglia
2021-05-03,CAM,40765,19892,20873,28911,11854,ITF,ITF3,15,Campania
2020-12-27,MOL,50,20,30,50,0,ITF,ITF2,14,Molise
2021-04-19,LOM,60096,27342,32754,50691,9405,ITC,ITC4,3,Lombardia
2021-06-22,CAL,14229,6709,7520,7146,7083,ITF,ITF6,18,Calabria
2021-03-18,BAS,1350,564,786,25,1325,ITF,ITF5,17,Basilicata
2021-04-15,MAR,10376,4674,5702,9811,565,ITI,ITI3,11,Marche
2021-01-26,PAT,542,154,388,27,515,ITH,ITH2,4,Provincia Autonoma Trento
2021-06-15,LOM,95409,48565,46844,49556,45853,ITC,ITC4,3,Lombardia
2021-02-17,MAR,1792,668,1124,1675,117,ITI,ITI3,11,Marche
2021-05-06,PAT,5531,2739,2792,4751,780,ITH,ITH2,4,Provincia Autonoma Trento
2021-05-10,CAL,13120,6086,7034,7725,5395,ITF,ITF6,18,Calabria
2021-02-02,FVG,2467,806,1661,217,2250,ITH,ITH4,6,Friuli-Venezia Giulia
2021-06-17,EMR,45608,23051,22557,21565,24043,ITH,ITH5,8,Emilia-Romagna
2021-03-31,FVG,8113,3558,4555,7267,846,ITH,ITH4,6,Friuli-Venezia Giulia
2021-05-14,ABR,10594,5069,5525,5445,5149,ITF,ITF1,13,Abruzzo
2021-05-01,TOS,23315,10064,13251,14139,9176,ITI,ITI1,9,Toscana
2021-03-05,TOS,16875,6686,10189,12133,4742,ITI,ITI1,9,Toscana
2021-04-26,CAL,10190,5061,5129,7769,2421,ITF,ITF6,18,Calabria
2021-04-01,ABR,5593,2505,3088,3506,2087,ITF,ITF1,13,Abruzzo
2021-06-15,CAM,18063,8793,9270,10677,7386,ITF,ITF3,15,Campania
2021-02-21,SIC,5168,2501,2667,5062,106,ITG,ITG1,19,Sicilia
2021-06-13,TOS,24604,12345,12259,22941,1663,ITI,ITI1,9,Toscana
2021-02-02,SIC,5271,2472,2799,628,4643,ITG,ITG1,19,Sicilia
2021-02-08,BAS,557,193,364,151,406,ITF,ITF5,17,Basilicata
2021-01-29,PAB,1497,510,987,24,1473,ITH,ITH1,4,Provincia Autonoma Bolzano / Bozen
2021-04-07,LAZ,25689,11900,13789,18377,7312,ITI,ITI4,12,Lazio
2021-04-12,CAM,23302,10918,12384,20267,3035,ITF,ITF3,15,Campania
2021-05-25,PAT,4767,2268,2499,1867,2900,ITH,ITH2,4,Provincia Autonoma Trento
2021-05-08,PAT,3162,1726,1436,2740,422,ITH,ITH2,4,Provincia Autonoma Trento
2021-05-19,BAS,2870,1497,1373,1193,1677,ITF,ITF5,17,Basilicata
2021-01-02,CAM,3672,1962,1710,3672,0,ITF,ITF3,15,Campania
2021-03-09,VDA,206,96,110,174,32,ITC,ITC2,2,Valle d'Aosta / Vallée d'Aoste
2021-04-22,PAB,2924,1501,1423,1982,942,ITH,ITH1,4,Provincia Autonoma Bolzano / Bozen
2021-04-26,UMB,5378,2329,3049,3126,2252,ITI,ITI2,10,Umbria
2021-02-25,BAS,1788,737,1051,1742,46,ITF,ITF5,17,Basilicata
2021-02-20,VDA,251,210,41,241,10,ITC,ITC2,2,Valle d'Aosta / Vallée d'Aoste
2020-12-28,LAZ,959,412,547,959,0,ITI,ITI4,12,Lazio
2021-02-14,PAT,246,186,60,11,235,ITH,ITH2,4,Provincia Autonoma Trento
2021-04-09,UMB,6802,3164,3638,6583,219,ITI,ITI2,10,Umbria
2021-05-09,PAB,4241,2410,1831,3089,1152,ITH,ITH1,4,Provincia Autonoma Bolzano / Bozen
2021-04-29,PUG,26158,12103,14055,19496,6662,ITF,ITF4,16,Puglia
2021-04-30,ABR,12424,5828,6596,6697,5727,ITF,ITF1,13,Abruzzo
2021-01-16,LAZ,5647,2282,3365,5647,0,ITI,ITI4,12,Lazio
2021-06-17,CAM,57538,27563,29975,30794,26744,ITF,ITF3,15,Campania
2021-04-19,PIE,22549,10771,11778,18185,4364,ITC,ITC1,1,Piemonte
2021-01-14,SIC,5184,2444,2740,5184,0,ITG,ITG1,19,Sicilia
2021-04-13,ABR,5855,2739,3116,4655,1200,ITF,ITF1,13,Abruzzo
2021-04-26,LAZ,29234,13457,15777,20030,9204,ITI,ITI4,12,Lazio
2021-01-09,PIE,6184,2185,3999,6184,0,ITC,ITC1,1,Piemonte
2021-02-02,LAZ,5911,2213,3698,639,5272,ITI,ITI4,12,Lazio
2021-01-20,ABR,447,156,291,445,2,ITF,ITF1,13,Abruzzo
2021-02-19,VEN,7322,3140,4182,7118,204,ITH,ITH3,5,Veneto
2021-03-26,CAM,19857,9317,10540,16042,3815,ITF,ITF3,15,Campania
2021-02-03,MOL,731,249,482,338,393,ITF,ITF2,14,Molise
2021-01-28,FVG,2239,794,1445,354,1885,ITH,ITH4,6,Friuli-Venezia Giulia
2021-01-26,PIE,6333,1880,4453,735,5598,ITC,ITC1,1,Piemonte
2021-06-11,MAR,13755,7034,6721,11434,2321,ITI,ITI3,11,Marche
2021-02-06,BAS,903,367,536,146,757,ITF,ITF5,17,Basilicata
2021-04-27,MOL,1593,767,826,465,1128,ITF,ITF2,14,Molise
2021-05-27,PAT,4289,1990,2299,1251,3038,ITH,ITH2,4,Provincia Autonoma Trento
2021-03-24,LIG,9177,4031,5146,5890,3287,ITC,ITC3,7,Liguria
2021-05-10,EMR,33839,16125,17714,26594,7245,ITH,ITH5,8,Emilia-Romagna
2021-05-08,FVG,10268,4642,5626,5487,4781,ITH,ITH4,6,Friuli-Venezia Giulia
2020-12-31,LIG,990,353,637,990,0,ITC,ITC3,7,Liguria
2021-04-30,BAS,5284,2373,2911,4122,1162,ITF,ITF5,17,Basilicata
2021-02-21,VEN,4637,1211,3426,4632,5,ITH,ITH3,5,Veneto
2021-04-28,UMB,5377,2328,3049,2989,2388,ITI,ITI2,10,Umbria
2021-03-06,PAB,3973,2081,1892,3762,211,ITH,ITH1,4,Provincia Autonoma Bolzano / Bozen
2021-04-10,LIG,7884,3557,4327,6970,914,ITC,ITC3,7,Liguria
2021-02-04,UMB,733,226,507,25,708,ITI,ITI2,10,Umbria
2021-05-15,VEN,36187,17487,18700,26198,9989,ITH,ITH3,5,Veneto
2021-01-17,LIG,866,301,565,866,0,ITC,ITC3,7,Liguria
2021-05-02,ABR,10458,5110,5348,5230,5228,ITF,ITF1,13,Abruzzo
2021-05-25,MAR,11647,5745,5902,8717,2930,ITI,ITI3,11,Marche
2021-05-28,PAB,5681,2895,2786,3791,1890,ITH,ITH1,4,Provincia Autonoma Bolzano / Bozen
2021-01-20,BAS,84,22,62,84,0,ITF,ITF5,17,Basilicata
2021-05-15,UMB,4992,1882,3110,1827,3165,ITI,ITI2,10,Umbria
2021-05-16,MOL,1247,571,676,1065,182,ITF,ITF2,14,Molise
2021-02-17,PAB,156,51,105,139,17,ITH,ITH1,4,Provincia Autonoma Bolzano / Bozen
2021-04-21,EMR,23953,10962,12991,14207,9746,ITH,ITH5,8,Emilia-Romagna
2021-06-01,VEN,26904,13539,13365,16403,10501,ITH,ITH3,5,Veneto
2021-02-22,PUG,9630,4537,5093,9298,332,ITF,ITF4,16,Puglia
2021-05-08,PIE,34264,16263,18001,18627,15637,ITC,ITC1,1,Piemonte
2021-06-03,SAR,16369,7631,8738,10699,5670,ITG,ITG2,20,Sardegna
2021-01-02,CAL,166,94,72,166,0,ITF,ITF6,18,Calabria
2021-01-28,PIE,5591,1809,3782,384,5207,ITC,ITC1,1,Piemonte
2021-05-08,EMR,32341,15092,17249,20920,11421,ITH,ITH5,8,Emilia-Romagna
2021-05-20,LOM,94390,45620,48770,31862,62528,ITC,ITC4,3,Lombardia
2021-03-01,MAR,3725,1488,2237,3477,248,ITI,ITI3,11,Marche
2021-05-10,FVG,7939,3527,4412,6398,1541,ITH,ITH4,6,Friuli-Venezia Giulia
2021-06-20,SAR,6276,2795,3481,3656,2620,ITG,ITG2,20,Sardegna
2021-01-28,EMR,10255,3339,6916,348,9907,ITH,ITH5,8,Emilia-Romagna
2021-03-10,VEN,19037,8725,10312,13354,5683,ITH,ITH3,5,Veneto
2021-02-05,PUG,5635,2273,3362,1333,4302,ITF,ITF4,16,Puglia
2021-03-12,SAR,5982,2623,3359,4674,1308,ITG,ITG2,20,Sardegna
2021-02-14,PIE,1476,498,978,876,600,ITC,ITC1,1,Piemonte
2021-05-16,PUG,24517,11051,13466,12697,11820,ITF,ITF4,16,Puglia
2021-02-13,VEN,3266,1473,1793,3246,20,ITH,ITH3,5,Veneto
2021-01-20,PIE,6617,2089,4528,5899,718,ITC,ITC1,1,Piemonte
2021-02-15,SAR,958,349,609,927,31,ITG,ITG2,20,Sardegna
2021-01-22,LAZ,4006,1636,2370,491,3515,ITI,ITI4,12,Lazio
2021-03-11,PAT,2298,851,1447,1474,824,ITH,ITH2,4,Provincia Autonoma Trento
2021-01-20,EMR,1325,270,1055,1324,1,ITH,ITH5,8,Emilia-Romagna
2021-05-24,PUG,35923,16957,18966,24941,10982,ITF,ITF4,16,Puglia
2021-06-17,MAR,14908,7422,7486,8851,6057,ITI,ITI3,11,Marche
2021-02-15,CAM,5471,2516,2955,5297,174,ITF,ITF3,15,Campania
2021-01-12,VDA,302,72,230,302,0,ITC,ITC2,2,Valle d'Aosta / Vallée d'Aoste
2021-02-16,PUG,3382,1454,1928,2736,646,ITF,ITF4,16,Puglia
2021-05-08,ABR,10292,4871,5421,6460,3832,ITF,ITF1,13,Abruzzo
2021-01-10,CAL,932,526,406,932,0,ITF,ITF6,18,Calabria
2021-01-30,PUG,5529,2514,3015,410,5119,ITF,ITF4,16,Puglia
2021-02-03,PIE,10202,3304,6898,611,9591,ITC,ITC1,1,Piemonte
2021-02-27,LAZ,11448,4284,7164,10470,978,ITI,ITI4,12,Lazio
2021-05-26,LOM,93561,44621,48940,43585,49976,ITC,ITC4,3,Lombardia
2021-06-09,CAM,52398,25730,26668,41515,10883,ITF,ITF3,15,Campania
2021-02-15,LOM,8944,3133,5811,8527,417,ITC,ITC4,3,Lombardia
2021-03-09,MAR,5427,2290,3137,4547,880,ITI,ITI3,11,Marche
2021-04-20,CAL,7843,3955,3888,6120,1723,ITF,ITF6,18,Calabria
2021-05-10,PUG,37682,16648,21034,19743,17939,ITF,ITF4,16,Puglia
2021-02-28,MOL,832,334,498,790,42,ITF,ITF2,14,Molise
2021-03-01,CAM,12130,4247,7883,8017,4113,ITF,ITF3,15,Campania
2021-01-01,TOS,2369,787,1582,2369,0,ITI,ITI1,9,Toscana
2021-02-22,FVG,2485,1193,1292,2067,418,ITH,ITH4,6,Friuli-Venezia Giulia
2021-04-24,ABR,8724,3975,4749,7195,1529,ITF,ITF1,13,Abruzzo
2021-04-11,TOS,3645,1680,1965,3490,155,ITI,ITI1,9,Toscana
2021-03-30,SIC,14513,6752,7761,9750,4763,ITG,ITG1,19,Sicilia
2021-05-09,CAM,43196,20284,22912,32101,11095,ITF,ITF3,15,Campania
2021-01-11,LIG,2655,990,1665,2655,0,ITC,ITC3,7,Liguria
2021-04-15,EMR,29335,13977,15358,19659,9676,ITH,ITH5,8,Emilia-Romagna
2021-06-02,FVG,9403,4949,4454,9124,279,ITH,ITH4,6,Friuli-Venezia Giulia
2021-01-14,ABR,530,189,341,530,0,ITF,ITF1,13,Abruzzo
2021-03-13,SIC,12208,5386,6822,7717,4491,ITG,ITG1,19,Sicilia
2021-02-27,MOL,1366,568,798,1347,19,ITF,ITF2,14,Molise
2021-03-19,BAS,2295,995,1300,265,2030,ITF,ITF5,17,Basilicata
2021-03-06,TOS,7109,2852,4257,2914,4195,ITI,ITI1,9,Toscana
2021-03-17,UMB,3331,1313,2018,1859,1472,ITI,ITI2,10,Umbria
2021-05-24,VDA,1136,516,620,689,447,ITC,ITC2,2,Valle d'Aosta / Vallée d'Aoste
2021-06-07,MOL,1947,857,1090,1128,819,ITF,ITF2,14,Molise
2021-06-18,EMR,41712,20863,20849,16099,25613,ITH,ITH5,8,Emilia-Romagna
2021-03-10,EMR,18797,7742,11055,13153,5644,ITH,ITH5,8,Emilia-Romagna
2021-05-10,VDA,782,381,401,547,235,ITC,ITC2,2,Valle d'Aosta / Vallée d'Aoste
2021-05-20,LAZ,51484,24744,26740,37775,13709,ITI,ITI4,12,Lazio
2021-02-13,MOL,132,80,52,132,0,ITF,ITF2,14,Molise
2021-04-13,MAR,9839,4260,5579,9605,234,ITI,ITI3,11,Marche
2021-01-07,UMB,1301,387,914,1301,0,ITI,ITI2,10,Umbria
2021-01-10,CAM,8165,3736,4429,8165,0,ITF,ITF3,15,Campania
2021-02-07,FVG,1563,482,1081,385,1178,ITH,ITH4,6,Friuli-Venezia Giulia
2021-04-17,SIC,26016,13149,12867,18950,7066,ITG,ITG1,19,Sicilia
2021-01-03,PAT,492,160,332,492,0,ITH,ITH2,4,Provincia Autonoma Trento
2021-05-24,MOL,1963,852,1111,1297,666,ITF,ITF2,14,Molise
2021-03-20,SAR,5197,2076,3121,2919,2278,ITG,ITG2,20,Sardegna
2021-02-16,BAS,906,377,529,808,98,ITF,ITF5,17,Basilicata
2021-05-07,MOL,2643,1228,1415,2046,597,ITF,ITF2,14,Molise
2021-02-06,PAB,2626,1171,1455,19,2607,ITH,ITH1,4,Provincia Autonoma Bolzano / Bozen
2021-02-13,PUG,3727,1456,2271,3031,696,ITF,ITF4,16,Puglia
2021-05-18,FVG,10774,5391,5383,8700,2074,ITH,ITH4,6,Friuli-Venezia Giulia
2021-01-10,LIG,648,262,386,648,0,ITC,ITC3,7,Liguria
2021-02-12,CAL,1710,668,1042,947,763,ITF,ITF6,18,Calabria
2021-03-03,VEN,12095,4646,7449,8596,3499,ITH,ITH3,5,Veneto
2021-03-17,SIC,14984,7398,7586,9196,5788,ITG,ITG1,19,Sicilia
2021-03-20,LOM,32579,12159,20420,22730,9849,ITC,ITC4,3,Lombardia
2021-04-20,LIG,14216,6505,7711,9868,4348,ITC,ITC3,7,Liguria
2021-06-20,LAZ,49224,22419,26805,24333,24891,ITI,ITI4,12,Lazio
2021-04-03,CAM,21115,10315,10800,18734,2381,ITF,ITF3,15,Campania
2021-06-21,PAB,3137,1596,1541,270,2867,ITH,ITH1,4,Provincia Autonoma Bolzano / Bozen
2021-06-25,SIC,38699,18117,20582,16963,21736,ITG,ITG1,19,Sicilia
2021-06-01,FVG,10069,5097,4972,7948,2121,ITH,ITH4,6,Friuli-Venezia Giulia
2021-06-11,VEN,46846,24368,22478,35755,11091,ITH,ITH3,5,Veneto
2021-05-18,PIE,32088,14806,17282,19436,12652,ITC,ITC1,1,Piemonte
2021-06-06,LAZ,57894,27899,29995,35411,22483,ITI,ITI4,12,Lazio
2021-06-13,SAR,9495,4671,4824,6235,3260,ITG,ITG2,20,Sardegna
2020-12-27,LOM,718,414,304,718,0,ITC,ITC4,3,Lombardia
2021-05-18,EMR,29086,13244,15842,18572,10514,ITH,ITH5,8,Emilia-Romagna
2021-06-16,MAR,13521,6793,6728,9156,4365,ITI,ITI3,11,Marche
2021-02-16,ABR,1917,842,1075,1905,12,ITF,ITF1,13,Abruzzo
2021-02-03,TOS,4221,1452,2769,241,3980,ITI,ITI1,9,Toscana
2021-02-07,EMR,4785,1536,3249,1724,3061,ITH,ITH5,8,Emilia-Romagna
2021-03-02,ABR,3962,1675,2287,3278,684,ITF,ITF1,13,Abruzzo
2021-06-25,UMB,9868,5115,4753,5309,4559,ITI,ITI2,10,Umbria
2021-06-25,VEN,50405,25517,24888,15035,35370,ITH,ITH3,5,Veneto
2021-02-26,LAZ,13119,5728,7391,11724,1395,ITI,ITI4,12,Lazio
2021-02-24,EMR,9351,3566,5785,8467,884,ITH,ITH5,8,Emilia-Romagna
2021-04-21,VDA,868,410,458,620,248,ITC,ITC2,2,Valle d'Aosta / Vallée d'Aoste
2021-06-10,ABR,12499,6221,6278,10338,2161,ITF,ITF1,13,Abruzzo
2021-01-05,EMR,9361,3170,6191,9361,0,ITH,ITH5,8,Emilia-Romagna
2021-06-02,MAR,11898,5937,5961,11221,677,ITI,ITI3,11,Marche
2021-01-28,BAS,904,402,502,119,785,ITF,ITF5,17,Basilicata
2021-01-15,TOS,3878,1347,2531,3878,0,ITI,ITI1,9,Toscana
2021-01-26,UMB,816,390,426,18,798,ITI,ITI2,10,Umbria
2021-04-18,MOL,1083,483,600,149,934,ITF,ITF2,14,Molise
2021-06-20,FVG,6437,3188,3249,1513,4924,ITH,ITH4,6,Friuli-Venezia Giulia
2021-03-21,VDA,355,165,190,355,0,ITC,ITC2,2,Valle d'Aosta / Vallée d'Aoste
2021-04-29,EMR,44952,21134,23818,27403,17549,ITH,ITH5,8,Emilia-Romagna
2021-01-19,EMR,2046,505,1541,2029,17,ITH,ITH5,8,Emilia-Romagna
2021-02-22,MAR,3421,1505,1916,3346,75,ITI,ITI3,11,Marche
2021-02-12,UMB,671,224,447,665,6,ITI,ITI2,10,Umbria
2021-02-22,PAT,745,259,486,661,84,ITH,ITH2,4,Provincia Autonoma Trento
2021-04-04,MOL,253,141,112,238,15,ITF,ITF2,14,Molise
2021-02-26,UMB,660,253,407,652,8,ITI,ITI2,10,Umbria
2021-03-29,FVG,7018,3124,3894,5437,1581,ITH,ITH4,6,Friuli-Venezia Giulia
2021-06-06,SIC,49504,23910,25594,41682,7822,ITG,ITG1,19,Sicilia
2021-01-29,SAR,2955,1069,1886,48,2907,ITG,ITG2,20,Sardegna
2021-03-18,MOL,1156,476,680,692,464,ITF,ITF2,14,Molise
2021-01-03,PIE,3063,967,2096,3063,0,ITC,ITC1,1,Piemonte
2021-03-28,PAB,569,212,357,11,558,ITH,ITH1,4,Provincia Autonoma Bolzano / Bozen
2021-05-23,LIG,2305,1119,1186,1182,1123,ITC,ITC3,7,Liguria
2021-01-14,BAS,969,413,556,969,0,ITF,ITF5,17,Basilicata
2021-02-26,SIC,11882,5810,6072,10202,1680,ITG,ITG1,19,Sicilia
2021-06-18,TOS,30694,16172,14522,25369,5325,ITI,ITI1,9,Toscana
2021-04-22,VEN,31986,13912,18074,16240,15746,ITH,ITH3,5,Veneto
2021-01-28,ABR,1433,495,938,12,1421,ITF,ITF1,13,Abruzzo
2021-03-01,LIG,3527,1444,2083,3404,123,ITC,ITC3,7,Liguria
2021-04-03,CAL,9133,3929,5204,4418,4715,ITF,ITF6,18,Calabria
2021-05-06,SIC,29311,13946,15365,18512,10799,ITG,ITG1,19,Sicilia
2021-05-23,CAM,58737,28634,30103,37842,20895,ITF,ITF3,15,Campania
2021-05-01,LAZ,37951,17082,20869,25988,11963,ITI,ITI4,12,Lazio
2021-05-09,LOM,69689,32879,36810,56429,13260,ITC,ITC4,3,Lombardia
2021-06-09,LIG,18667,9376,9291,12111,6556,ITC,ITC3,7,Liguria
2021-02-12,CAM,6531,2861,3670,6343,188,ITF,ITF3,15,Campania
2021-04-07,BAS,1212,551,661,1174,38,ITF,ITF5,17,Basilicata
2021-01-29,LOM,13480,4126,9354,685,12795,ITC,ITC4,3,Lombardia
2021-04-17,LAZ,32359,14202,18157,20386,11973,ITI,ITI4,12,Lazio
2021-05-18,PAT,4249,2009,2240,3405,844,ITH,ITH2,4,Provincia Autonoma Trento
2021-03-29,EMR,21424,9613,11811,16774,4650,ITH,ITH5,8,Emilia-Romagna
2021-03-29,PIE,15168,6388,8780,8556,6612,ITC,ITC1,1,Piemonte
2021-01-11,ABR,1553,557,996,1553,0,ITF,ITF1,13,Abruzzo
2021-05-06,UMB,9476,4323,5153,6159,3317,ITI,ITI2,10,Umbria
2021-06-10,VDA,1002,558,444,960,42,ITC,ITC2,2,Valle d'Aosta / Vallée d'Aoste
2021-03-25,TOS,23894,10377,13517,15543,8351,ITI,ITI1,9,Toscana
2021-01-29,CAM,10052,4812,5240,47,10005,ITF,ITF3,15,Campania
2021-03-02,VDA,339,166,173,336,3,ITC,ITC2,2,Valle d'Aosta / Vallée d'Aoste
2021-04-21,ABR,6388,3100,3288,4714,1674,ITF,ITF1,13,Abruzzo
2021-01-28,CAL,2246,1115,1131,83,2163,ITF,ITF6,18,Calabria
2021-04-25,BAS,2986,1457,1529,2934,52,ITF,ITF5,17,Basilicata
2021-05-09,PUG,30632,12553,18079,15023,15609,ITF,ITF4,16,Puglia
2021-06-13,LOM,75237,40180,35057,73112,2125,ITC,ITC4,3,Lombardia
2021-01-28,SAR,2972,1046,1926,69,2903,ITG,ITG2,20,Sardegna
2021-04-12,PIE,22945,10364,12581,19955,2990,ITC,ITC1,1,Piemonte
2021-04-12,TOS,2612,1183,1429,1958,654,ITI,ITI1,9,Toscana
2021-02-21,EMR,4450,1708,2742,4010,440,ITH,ITH5,8,Emilia-Romagna
2021-03-05,LOM,28918,11925,16993,20506,8412,ITC,ITC4,3,Lombardia
2021-03-27,MAR,7381,3075,4306,5023,2358,ITI,ITI3,11,Marche
2021-05-08,CAL,18426,8384,10042,10604,7822,ITF,ITF6,18,Calabria
2021-01-02,PIE,3545,1134,2411,3545,0,ITC,ITC1,1,Piemonte
2021-03-19,CAM,11143,4974,6169,7271,3872,ITF,ITF3,15,Campania
2021-02-10,MOL,151,79,72,131,20,ITF,ITF2,14,Molise
2021-03-12,PAT,2515,938,1577,1709,806,ITH,ITH2,4,Provincia Autonoma Trento
2021-04-10,MAR,10915,4620,6295,10602,313,ITI,ITI3,11,Marche
2021-05-22,CAL,22173,10551,11622,14323,7850,ITF,ITF6,18,Calabria
2021-01-03,MAR,907,354,553,907,0,ITI,ITI3,11,Marche
2021-04-22,PUG,23003,10528,12475,18084,4919,ITF,ITF4,16,Puglia
2021-05-12,BAS,4724,2327,2397,2842,1882,ITF,ITF5,17,Basilicata
2021-05-21,MOL,2096,1050,1046,1774,322,ITF,ITF2,14,Molise
2021-06-20,PAT,1869,1034,835,32,1837,ITH,ITH2,4,Provincia Autonoma Trento
2021-03-19,LOM,32421,12913,19508,19224,13197,ITC,ITC4,3,Lombardia
2021-05-13,TOS,35026,15445,19581,13842,21184,ITI,ITI1,9,Toscana
2021-01-27,MOL,674,251,423,8,666,ITF,ITF2,14,Molise
2021-03-31,SIC,14451,6692,7759,9519,4932,ITG,ITG1,19,Sicilia
2021-05-15,FVG,12653,6101,6552,7957,4696,ITH,ITH4,6,Friuli-Venezia Giulia
2021-04-03,LIG,5403,2497,2906,4461,942,ITC,ITC3,7,Liguria
2021-04-21,CAL,11579,5812,5767,8648,2931,ITF,ITF6,18,Calabria
2021-05-01,FVG,7189,3244,3945,6146,1043,ITH,ITH4,6,Friuli-Venezia Giulia
2021-06-10,UMB,7457,3716,3741,6690,767,ITI,ITI2,10,Umbria
2021-01-07,SIC,8916,4124,4792,8916,0,ITG,ITG1,19,Sicilia
2021-04-06,ABR,7678,3579,4099,5360,2318,ITF,ITF1,13,Abruzzo
2021-04-29,TOS,39318,17708,21610,19247,20071,ITI,ITI1,9,Toscana
2021-06-10,CAM,73334,35379,37955,66316,7018,ITF,ITF3,15,Campania
2021-01-21,FVG,896,345,551,1,895,ITH,ITH4,6,Friuli-Venezia Giulia
2021-03-12,LAZ,23890,10987,12903,17573,6317,ITI,ITI4,12,Lazio
2021-06-04,PAB,6459,3237,3222,4929,1530,ITH,ITH1,4,Provincia Autonoma Bolzano / Bozen
2021-02-24,PAB,1367,406,961,1355,12,ITH,ITH1,4,Provincia Autonoma Bolzano / Bozen
2021-06-08,VEN,43425,22461,20964,37324,6101,ITH,ITH3,5,Veneto
2021-01-02,PAT,502,143,359,502,0,ITH,ITH2,4,Provincia Autonoma Trento
2021-05-25,VEN,27737,13390,14347,11725,16012,ITH,ITH3,5,Veneto
2021-05-27,SAR,17467,8984,8483,12256,5211,ITG,ITG2,20,Sardegna
2021-02-14,VEN,126,56,70,113,13,ITH,ITH3,5,Veneto
2021-02-21,FVG,801,281,520,423,378,ITH,ITH4,6,Friuli-Venezia Giulia
2021-02-16,SAR,700,289,411,673,27,ITG,ITG2,20,Sardegna
2021-03-24,TOS,20011,8300,11711,10555,9456,ITI,ITI1,9,Toscana
2021-05-01,PIE,28539,12998,15541,16740,11799,ITC,ITC1,1,Piemonte
2021-02-12,PUG,4212,1672,2540,3120,1092,ITF,ITF4,16,Puglia
2021-03-08,MAR,6266,2746,3520,5264,1002,ITI,ITI3,11,Marche
2021-01-11,VDA,325,112,213,325,0,ITC,ITC2,2,Valle d'Aosta / Vallée d'Aoste
2021-01-21,PIE,6881,2314,4567,3385,3496,ITC,ITC1,1,Piemonte
2021-01-24,LIG,756,237,519,113,643,ITC,ITC3,7,Liguria
2021-03-05,SAR,5211,2605,2606,2857,2354,ITG,ITG2,20,Sardegna
2021-02-09,LAZ,8802,3770,5032,4581,4221,ITI,ITI4,12,Lazio
2021-03-27,PAB,3051,1554,1497,1543,1508,ITH,ITH1,4,Provincia Autonoma Bolzano / Bozen
2021-03-29,PAT,2493,966,1527,1758,735,ITH,ITH2,4,Provincia Autonoma Trento
2021-04-02,CAL,8260,3763,4497,4385,3875,ITF,ITF6,18,Calabria
2021-02-28,VEN,4136,1389,2747,3299,837,ITH,ITH3,5,Veneto
2021-02-23,LAZ,11092,4782,6310,10329,763,ITI,ITI4,12,Lazio
2021-03-13,PAB,2885,1459,1426,2784,101,ITH,ITH1,4,Provincia Autonoma Bolzano / Bozen
2021-04-12,PAT,3084,1407,1677,2588,496,ITH,ITH2,4,Provincia Autonoma Trento
2021-05-15,PIE,33762,15739,18023,20059,13703,ITC,ITC1,1,Piemonte
2021-01-29,PUG,6201,2663,3538,436,5765,ITF,ITF4,16,Puglia
2021-04-06,BAS,1269,462,807,1084,185,ITF,ITF5,17,Basilicata
2021-06-01,PIE,29236,14647,14589,24862,4374,ITC,ITC1,1,Piemonte
2021-03-17,VEN,14645,5992,8653,7849,6796,ITH,ITH3,5,Veneto
2021-05-27,LOM,94731,45398,49333,41377,53354,ITC,ITC4,3,Lombardia
2021-01-08,MOL,429,141,288,429,0,ITF,ITF2,14,Molise
2021-02-21,PIE,5090,2083,3007,4988,102,ITC,ITC1,1,Piemonte
2021-02-21,TOS,5105,2089,3016,4935,170,ITI,ITI1,9,Toscana
2021-03-19,SAR,7271,3051,4220,5056,2215,ITG,ITG2,20,Sardegna
2021-06-24,CAL,14947,6785,8162,6680,8267,ITF,ITF6,18,Calabria
2021-02-05,MAR,2154,653,1501,439,1715,ITI,ITI3,11,Marche
2021-03-19,CAL,4185,1953,2232,1894,2291,ITF,ITF6,18,Calabria
2021-03-20,PUG,8414,3878,4536,3820,4594,ITF,ITF4,16,Puglia
2021-06-14,BAS,4811,2148,2663,2103,2708,ITF,ITF5,17,Basilicata
2021-03-03,PUG,16774,6796,9978,14858,1916,ITF,ITF4,16,Puglia
2021-04-04,VDA,572,253,319,571,1,ITC,ITC2,2,Valle d'Aosta / Vallée d'Aoste
2021-05-08,CAM,56421,27133,29288,40592,15829,ITF,ITF3,15,Campania
2021-06-01,TOS,26881,13352,13529,23079,3802,ITI,ITI1,9,Toscana
2021-01-02,EMR,2375,916,1459,2375,0,ITH,ITH5,8,Emilia-Romagna
2021-04-24,LOM,75767,33579,42188,54644,21123,ITC,ITC4,3,Lombardia
2021-05-16,MAR,10898,4957,5941,6670,4228,ITI,ITI3,11,Marche
2021-01-28,CAM,8832,4121,4711,134,8698,ITF,ITF3,15,Campania
2021-02-05,PAB,3195,1181,2014,8,3187,ITH,ITH1,4,Provincia Autonoma Bolzano / Bozen
2021-03-23,BAS,1591,610,981,1423,168,ITF,ITF5,17,Basilicata
2021-06-11,PUG,47258,23126,24132,33429,13829,ITF,ITF4,16,Puglia
2021-01-14,LOM,26905,7801,19104,26905,0,ITC,ITC4,3,Lombardia
2021-01-21,PAT,352,95,257,228,124,ITH,ITH2,4,Provincia Autonoma Trento
2021-04-01,MOL,1469,667,802,743,726,ITF,ITF2,14,Molise
2021-05-30,MAR,9732,4690,5042,6743,2989,ITI,ITI3,11,Marche
2021-06-05,EMR,44009,22251,21758,37154,6855,ITH,ITH5,8,Emilia-Romagna
2021-05-01,PAT,4848,2468,2380,4812,36,ITH,ITH2,4,Provincia Autonoma Trento
2021-05-08,LOM,87696,40750,46946,65673,22023,ITC,ITC4,3,Lombardia
2021-06-22,EMR,35396,17624,17772,16069,19327,ITH,ITH5,8,Emilia-Romagna
2021-02-09,SIC,4397,1828,2569,3315,1082,ITG,ITG1,19,Sicilia
2021-03-26,FVG,5997,2600,3397,3981,2016,ITH,ITH4,6,Friuli-Venezia Giulia
2021-05-09,ABR,9153,4088,5065,4283,4870,ITF,ITF1,13,Abruzzo
2021-02-12,LIG,1935,690,1245,897,1038,ITC,ITC3,7,Liguria
2021-03-12,FVG,4101,1695,2406,2720,1381,ITH,ITH4,6,Friuli-Venezia Giulia
2021-04-21,UMB,5318,2313,3005,3092,2226,ITI,ITI2,10,Umbria
2021-06-15,TOS,31173,16044,15129,26620,4553,ITI,ITI1,9,Toscana
2021-02-15,ABR,1794,831,963,1752,42,ITF,ITF1,13,Abruzzo
2021-03-10,TOS,18367,7403,10964,14349,4018,ITI,ITI1,9,Toscana
2021-06-10,CAL,15310,7038,8272,12538,2772,ITF,ITF6,18,Calabria
2021-04-21,CAM,30225,14723,15502,17999,12226,ITF,ITF3,15,Campania
2021-05-26,ABR,13546,6038,7508,8551,4995,ITF,ITF1,13,Abruzzo
2021-05-17,EMR,32387,15387,17000,22901,9486,ITH,ITH5,8,Emilia-Romagna
2021-01-02,FVG,1216,470,746,1216,0,ITH,ITH4,6,Friuli-Venezia Giulia
2021-01-21,LAZ,5604,2349,3255,551,5053,ITI,ITI4,12,Lazio
2021-04-15,PAB,4399,2307,2092,4136,263,ITH,ITH1,4,Provincia Autonoma Bolzano / Bozen
2021-06-14,ABR,10858,5370,5488,7490,3368,ITF,ITF1,13,Abruzzo
2021-01-12,VEN,5230,1516,3714,5230,0,ITH,ITH3,5,Veneto
2021-02-21,PAT,155,92,63,43,112,ITH,ITH2,4,Provincia Autonoma Trento
2021-03-02,UMB,3642,1346,2296,3638,4,ITI,ITI2,10,Umbria
2021-04-19,VEN,21540,8921,12619,5129,16411,ITH,ITH3,5,Veneto
2021-05-20,SIC,43534,20848,22686,27632,15902,ITG,ITG1,19,Sicilia
2021-06-20,PIE,33983,17024,16959,19267,14716,ITC,ITC1,1,Piemonte
2021-04-05,VEN,19142,8366,10776,13703,5439,ITH,ITH3,5,Veneto
2021-02-02,TOS,3743,1475,2268,196,3547,ITI,ITI1,9,Toscana
2021-03-12,PIE,13977,5208,8769,11042,2935,ITC,ITC1,1,Piemonte
2021-04-07,SAR,13544,6052,7492,7896,5648,ITG,ITG2,20,Sardegna
2021-04-12,FVG,7258,3182,4076,6126,1132,ITH,ITH4,6,Friuli-Venezia Giulia
2021-06-24,UMB,10063,5078,4985,6093,3970,ITI,ITI2,10,Umbria
2021-01-26,VEN,6917,2090,4827,150,6767,ITH,ITH3,5,Veneto
2021-04-24,SAR,10369,4851,5518,8031,2338,ITG,ITG2,20,Sardegna
2021-04-27,MAR,9414,4317,5097,5428,3986,ITI,ITI3,11,Marche
2021-05-15,PAT,1567,815,752,679,888,ITH,ITH2,4,Provincia Autonoma Trento
2021-03-31,LAZ,27609,13314,14295,20514,7095,ITI,ITI4,12,Lazio
2021-01-14,SAR,1106,426,680,1106,0,ITG,ITG2,20,Sardegna
2021-02-01,BAS,242,91,151,46,196,ITF,ITF5,17,Basilicata
2021-03-15,LIG,7246,3097,4149,4540,2706,ITC,ITC3,7,Liguria
2021-04-03,PUG,10557,4643,5914,6998,3559,ITF,ITF4,16,Puglia
2021-03-26,PIE,17759,6985,10774,8852,8907,ITC,ITC1,1,Piemonte
2021-05-02,PAB,2457,1288,1169,1536,921,ITH,ITH1,4,Provincia Autonoma Bolzano / Bozen
2021-06-01,PAT,4011,1874,2137,1157,2854,ITH,ITH2,4,Provincia Autonoma Trento
2021-02-13,VDA,216,196,20,215,1,ITC,ITC2,2,Valle d'Aosta / Vallée d'Aoste
2021-01-22,PAB,248,143,105,124,124,ITH,ITH1,4,Provincia Autonoma Bolzano / Bozen
2021-04-07,LOM,50573,20915,29658,34767,15806,ITC,ITC4,3,Lombardia
2021-05-06,VEN,46938,22016,24922,38467,8471,ITH,ITH3,5,Veneto
2021-01-07,LAZ,7750,2904,4846,7750,0,ITI,ITI4,12,Lazio
2021-01-17,MAR,1615,692,923,1555,60,ITI,ITI3,11,Marche
2021-05-26,BAS,4489,2260,2229,1707,2782,ITF,ITF5,17,Basilicata
