data_somministrazione,area,totale,sesso_maschile,sesso_femminile,categoria_operatori_sanitari_sociosanitari,categoria_personale_non_sanitario,categoria_ospiti_rsa,categoria_over80,categoria_forze_armate,categoria_personale_scolastico,prima_dose,seconda_dose,codice_NUTS1,codice_NUTS2,codice_regione_ISTAT,nome_area
2021-02-01,PIE,8639,3053,5586,6163,1402,1074,0,0,0,578,8061,ITC,ITC1,1,Piemonte
2021-02-01,UMB,1260,333,927,876,32,352,0,0,0,47,1213,ITI,ITI2,10,Umbria
2020-12-31,LOM,713,300,413,656,57,0,0,0,0,713,0,ITC,ITC4,3,Lombardia
2021-01-04,PAB,469,191,278,397,72,0,0,0,0,469,0,ITH,ITH1,4,Provincia Autonoma Bolzano / Bozen
2021-01-30,CAL,2173,1147,1026,1974,199,0,0,0,0,358,1815,ITF,ITF6,18,Calabria
2021-02-23,MOL,527,202,325,136,382,8,0,0,1,362,165,ITF,ITF2,14,Molise
2021-01-27,LAZ,5768,2170,3598,4797,385,457,129,0,0,651,5117,ITI,ITI4,12,Lazio
2021-02-19,PIE,3501,1136,2365,1981,827,663,30,0,0,3002,499,ITC,ITC1,1,Piemonte
2021-01-04,TOS,5063,1893,3170,4099,32,932,0,0,0,5063,0,ITI,ITI1,9,Toscana
2021-01-25,UMB,647,322,325,645,2,0,0,0,0,5,642,ITI,ITI2,10,Umbria
2021-01-17,EMR,2889,887,2002,1913,426,547,0,0,3,2643,246,ITH,ITH5,8,Emilia-Romagna
2021-01-24,PUG,1667,748,919,1286,231,150,0,0,0,151,1516,ITF,ITF4,16,Puglia
2021-02-17,SIC,5425,3289,2136,1527,1126,880,8,1882,2,4753,672,ITG,ITG1,19,Sicilia
2021-01-14,PAT,696,201,495,477,11,208,0,0,0,696,0,ITH,ITH2,4,Provincia Autonoma Trento
2021-02-15,LOM,8435,2966,5469,5577,1917,934,4,1,2,8016,419,ITC,ITC4,3,Lombardia
2021-01-07,LIG,2936,1015,1921,2168,405,358,0,1,4,2936,0,ITC,ITC3,7,Liguria
2020-12-31,EMR,2205,776,1429,1675,203,327,0,0,0,2205,0,ITH,ITH5,8,Emilia-Romagna
2021-01-12,CAM,5214,2563,2651,3439,1435,340,0,0,0,5214,0,ITF,ITF3,15,Campania
2021-01-12,CAL,2058,1017,1041,1706,323,29,0,0,0,2058,0,ITF,ITF6,18,Calabria
2021-01-08,LIG,2685,927,1758,1952,384,345,0,1,3,2685,0,ITC,ITC3,7,Liguria
2021-01-17,ABR,187,59,128,136,51,0,0,0,0,180,7,ITF,ITF1,13,Abruzzo
2021-02-05,PIE,9445,3073,6372,5760,2041,1644,0,0,0,654,8791,ITC,ITC1,1,Piemonte
2021-01-24,FVG,305,119,186,277,27,1,0,0,0,1,304,ITH,ITH4,6,Friuli-Venezia Giulia
2021-01-02,UMB,301,110,191,301,0,0,0,0,0,301,0,ITI,ITI2,10,Umbria
2021-02-10,LAZ,7770,3112,4658,2645,580,633,3912,0,0,4836,2934,ITI,ITI4,12,Lazio
2021-02-19,CAM,9553,3559,5994,1648,1129,161,4453,0,2162,8902,651,ITF,ITF3,15,Campania
2021-01-30,PAT,383,130,253,345,7,31,0,0,0,151,232,ITH,ITH2,4,Provincia Autonoma Trento
2021-02-20,PAB,1502,471,1031,196,124,24,469,1,688,1484,18,ITH,ITH1,4,Provincia Autonoma Bolzano / Bozen
2021-01-31,LAZ,4279,1783,2496,3572,339,244,124,0,0,296,3983,ITI,ITI4,12,Lazio
2021-02-20,TOS,4640,1790,2850,3349,1038,203,17,15,18,4127,513,ITI,ITI1,9,Toscana
2021-01-11,UMB,1271,336,935,878,20,373,0,0,0,1271,0,ITI,ITI2,10,Umbria
2021-02-18,LOM,13454,4750,8704,5846,1911,1492,3335,857,13,12522,932,ITC,ITC4,3,Lombardia
2021-01-07,PAB,892,317,575,613,227,0,52,0,0,892,0,ITH,ITH1,4,Provincia Autonoma Bolzano / Bozen
2021-01-13,MOL,474,160,314,256,73,144,0,0,1,474,0,ITF,ITF2,14,Molise
2021-01-02,VEN,5740,1765,3975,4796,398,544,2,0,0,5740,0,ITH,ITH3,5,Veneto
2021-01-26,BAS,794,350,444,481,277,35,0,0,1,102,692,ITF,ITF5,17,Basilicata
2021-01-08,LOM,12590,3893,8697,8634,3704,218,32,2,0,12590,0,ITC,ITC4,3,Lombardia
2021-01-30,PUG,5519,2511,3008,4747,344,419,3,0,6,409,5110,ITF,ITF4,16,Puglia
2021-02-21,LOM,4999,1848,3151,1735,1007,32,2182,40,3,4979,20,ITC,ITC4,3,Lombardia
2020-12-30,LOM,113,42,71,105,8,0,0,0,0,113,0,ITC,ITC4,3,Lombardia
2021-01-19,TOS,1104,531,573,392,221,491,0,0,0,1104,0,ITI,ITI1,9,Toscana
2021-02-13,LAZ,6270,2434,3836,2122,213,279,3656,0,0,6182,88,ITI,ITI4,12,Lazio
2021-01-31,BAS,77,24,53,75,2,0,0,0,0,0,77,ITF,ITF5,17,Basilicata
2021-02-20,PIE,1669,440,1229,1033,392,215,29,0,0,1494,175,ITC,ITC1,1,Piemonte
2021-01-01,CAM,919,506,413,831,88,0,0,0,0,919,0,ITF,ITF3,15,Campania
2021-02-20,UMB,282,100,182,83,8,39,152,0,0,258,24,ITI,ITI2,10,Umbria
2021-01-14,FVG,2587,788,1799,1607,550,430,0,0,0,2587,0,ITH,ITH4,6,Friuli-Venezia Giulia
2021-01-23,ABR,263,114,149,223,14,26,0,0,0,57,206,ITF,ITF1,13,Abruzzo
2021-01-31,SIC,4110,1958,2152,2600,1216,294,0,0,0,113,3997,ITG,ITG1,19,Sicilia
2021-02-11,CAM,6275,2703,3572,1861,1922,129,2363,0,0,6209,66,ITF,ITF3,15,Campania
2021-02-13,TOS,7782,2359,5423,3664,3768,163,0,186,1,7556,226,ITI,ITI1,9,Toscana
2021-02-19,LIG,2681,1145,1536,770,501,41,1368,0,1,2530,151,ITC,ITC3,7,Liguria
2021-02-01,PAB,1383,404,979,704,382,296,0,0,1,11,1372,ITH,ITH1,4,Provincia Autonoma Bolzano / Bozen
2021-01-02,SAR,60,21,39,60,0,0,0,0,0,60,0,ITG,ITG2,20,Sardegna
2021-02-09,ABR,908,311,597,612,165,131,0,0,0,499,409,ITF,ITF1,13,Abruzzo
2021-01-21,PAT,349,93,256,318,15,16,0,0,0,227,122,ITH,ITH2,4,Provincia Autonoma Trento
2021-02-01,TOS,5465,1942,3523,4441,407,617,0,0,0,521,4944,ITI,ITI1,9,Toscana
2021-02-02,MOL,486,155,331,295,63,128,0,0,0,163,323,ITF,ITF2,14,Molise
2021-02-16,MAR,1288,475,813,734,462,92,0,0,0,1258,30,ITI,ITI3,11,Marche
2021-02-04,ABR,1681,616,1065,1168,456,57,0,0,0,609,1072,ITF,ITF1,13,Abruzzo
2021-02-25,LAZ,6428,2838,3590,865,534,212,2917,680,1220,5853,575,ITI,ITI4,12,Lazio
2021-02-10,SIC,4426,1816,2610,1975,1711,740,0,0,0,4001,425,ITG,ITG1,19,Sicilia
2021-02-09,LOM,11815,3238,8577,5606,2307,3827,75,0,0,3891,7924,ITC,ITC4,3,Lombardia
2021-02-25,TOS,2287,940,1347,330,294,96,951,149,467,1891,396,ITI,ITI1,9,Toscana
2021-02-07,EMR,4786,1534,3252,3653,676,444,10,0,3,1727,3059,ITH,ITH5,8,Emilia-Romagna
2021-02-24,VDA,183,82,101,30,15,13,65,53,7,164,19,ITC,ITC2,2,Valle d'Aosta / Vallée d'Aoste
2021-01-23,MAR,557,190,367,440,54,63,0,0,0,123,434,ITI,ITI3,11,Marche
2021-01-26,LAZ,7602,2907,4695,6590,256,631,125,0,0,372,7230,ITI,ITI4,12,Lazio
2021-01-02,FVG,1217,471,746,1150,67,0,0,0,0,1217,0,ITH,ITH4,6,Friuli-Venezia Giulia
2021-01-24,PAT,545,274,271,533,12,0,0,0,0,222,323,ITH,ITH2,4,Provincia Autonoma Trento
2021-01-14,PUG,4055,1581,2474,3160,396,497,0,0,2,4055,0,ITF,ITF4,16,Puglia
2021-02-18,LIG,2573,1054,1519,856,434,306,974,0,3,2340,233,ITC,ITC3,7,Liguria
2021-02-10,BAS,531,237,294,172,146,122,90,0,1,479,52,ITF,ITF5,17,Basilicata
2021-01-29,VDA,316,138,178,259,41,16,0,0,0,2,314,ITC,ITC2,2,Valle d'Aosta / Vallée d'Aoste
2021-02-06,TOS,4527,1550,2977,3725,575,227,0,0,0,1294,3233,ITI,ITI1,9,Toscana
2021-01-29,BAS,612,228,384,277,265,70,0,0,0,63,549,ITF,ITF5,17,Basilicata
2021-01-03,TOS,3336,1052,2284,2565,9,762,0,0,0,3336,0,ITI,ITI1,9,Toscana
2020-12-28,SAR,65,25,40,65,0,0,0,0,0,65,0,ITG,ITG2,20,Sardegna
2021-01-20,LAZ,4360,1648,2712,3251,398,425,286,0,0,2848,1512,ITI,ITI4,12,Lazio
2021-02-07,BAS,372,158,214,257,74,40,0,0,1,49,323,ITF,ITF5,17,Basilicata
2021-02-06,PAB,2298,1025,1273,447,375,6,1470,0,0,18,2280,ITH,ITH1,4,Provincia Autonoma Bolzano / Bozen
2021-01-13,SAR,573,178,395,494,79,0,0,0,0,573,0,ITG,ITG2,20,Sardegna
2021-02-15,ABR,1793,830,963,625,487,221,214,246,0,1751,42,ITF,ITF1,13,Abruzzo
2021-01-18,CAM,957,399,558,576,194,187,0,0,0,713,244,ITF,ITF3,15,Campania
2021-02-23,SAR,1552,1043,509,601,519,89,6,337,0,1278,274,ITG,ITG2,20,Sardegna
2020-12-29,LIG,118,32,86,87,10,21,0,0,0,118,0,ITC,ITC3,7,Liguria
2021-01-02,MAR,453,139,314,444,9,0,0,0,0,453,0,ITI,ITI3,11,Marche
2021-02-19,LOM,13585,5239,8346,5304,1817,1003,4516,927,18,12999,586,ITC,ITC4,3,Lombardia
2021-02-22,CAM,10533,3255,7278,511,2275,76,3855,0,3816,10270,263,ITF,ITF3,15,Campania
2021-01-10,LAZ,4036,1700,2336,3421,363,252,0,0,0,4036,0,ITI,ITI4,12,Lazio
2021-01-30,EMR,10035,3507,6528,7560,1706,769,0,0,0,143,9892,ITH,ITH5,8,Emilia-Romagna
2021-02-03,PAB,1445,457,988,615,441,321,68,0,0,5,1440,ITH,ITH1,4,Provincia Autonoma Bolzano / Bozen
2021-01-13,PUG,4527,1724,2803,3961,334,230,0,0,2,4527,0,ITF,ITF4,16,Puglia
2021-02-24,BAS,1205,480,725,85,18,2,1099,1,0,1136,69,ITF,ITF5,17,Basilicata
2021-02-23,PUG,8067,3775,4292,1739,465,156,4421,317,969,7611,456,ITF,ITF4,16,Puglia
2021-02-15,MAR,971,412,559,543,427,1,0,0,0,958,13,ITI,ITI3,11,Marche
2021-02-05,UMB,780,234,546,645,51,84,0,0,0,18,762,ITI,ITI2,10,Umbria
2021-01-19,PIE,6310,2075,4235,3573,1291,1446,0,0,0,6297,13,ITC,ITC1,1,Piemonte
2021-02-11,LIG,1590,654,936,1004,251,329,0,0,6,1188,402,ITC,ITC3,7,Liguria
2021-01-07,FVG,2091,718,1373,1759,222,110,0,0,0,2091,0,ITH,ITH4,6,Friuli-Venezia Giulia
2021-01-19,UMB,103,23,80,21,2,80,0,0,0,103,0,ITI,ITI2,10,Umbria
2021-01-11,EMR,9323,3266,6057,6545,1511,1267,0,0,0,9323,0,ITH,ITH5,8,Emilia-Romagna
2021-01-16,CAM,3370,1675,1695,1356,1641,373,0,0,0,3370,0,ITF,ITF3,15,Campania
2021-01-08,FVG,2322,747,1575,1680,246,396,0,0,0,2322,0,ITH,ITH4,6,Friuli-Venezia Giulia
2021-01-06,CAM,7651,3748,3903,5780,1571,300,0,0,0,7651,0,ITF,ITF3,15,Campania
2021-01-01,LIG,144,55,89,139,5,0,0,0,0,144,0,ITC,ITC3,7,Liguria
2021-01-12,LOM,19676,6561,13115,10928,7210,1377,158,3,0,19676,0,ITC,ITC4,3,Lombardia
2021-02-03,TOS,4220,1452,2768,3475,240,505,0,0,0,240,3980,ITI,ITI1,9,Toscana
2021-01-22,TOS,2861,1063,1798,2022,81,758,0,0,0,525,2336,ITI,ITI1,9,Toscana
2021-01-25,EMR,6411,2127,4284,5224,509,678,0,0,0,220,6191,ITH,ITH5,8,Emilia-Romagna
2021-02-12,TOS,7603,2682,4921,3740,3272,189,0,402,0,7390,213,ITI,ITI1,9,Toscana
2021-02-05,VEN,8352,2529,5823,4253,1928,2158,5,5,3,1414,6938,ITH,ITH3,5,Veneto
2021-02-08,CAM,5111,2448,2663,1387,2120,226,1378,0,0,4309,802,ITF,ITF3,15,Campania
2021-01-07,SAR,3111,1077,2034,2720,380,0,0,11,0,3111,0,ITG,ITG2,20,Sardegna
2021-01-22,PAB,241,138,103,129,23,85,3,0,1,124,117,ITH,ITH1,4,Provincia Autonoma Bolzano / Bozen
2021-02-25,CAL,515,263,252,74,103,29,263,46,0,479,36,ITF,ITF6,18,Calabria
2021-01-16,PIE,7754,2631,5123,4796,1590,1368,0,0,0,7754,0,ITC,ITC1,1,Piemonte
2021-02-13,PIE,4085,1284,2801,2304,669,1111,1,0,0,2860,1225,ITC,ITC1,1,Piemonte
2021-01-18,PIE,6093,2037,4056,3222,1401,1470,0,0,0,5845,248,ITC,ITC1,1,Piemonte
2021-01-21,ABR,157,47,110,10,6,141,0,0,0,157,0,ITF,ITF1,13,Abruzzo
2021-01-07,UMB,1291,383,908,883,4,404,0,0,0,1291,0,ITI,ITI2,10,Umbria
2021-01-13,VEN,5975,1600,4375,2790,1302,1880,3,0,0,5975,0,ITH,ITH3,5,Veneto
2021-02-21,VDA,18,3,15,0,0,18,0,0,0,0,18,ITC,ITC2,2,Valle d'Aosta / Vallée d'Aoste
2020-12-27,MOL,50,20,30,29,4,17,0,0,0,50,0,ITF,ITF2,14,Molise
2021-01-01,LOM,24,7,17,21,3,0,0,0,0,24,0,ITC,ITC4,3,Lombardia
2021-01-09,VDA,443,199,244,225,196,22,0,0,0,443,0,ITC,ITC2,2,Valle d'Aosta / Vallée d'Aoste
2021-01-21,EMR,2150,725,1425,1281,216,653,0,0,0,809,1341,ITH,ITH5,8,Emilia-Romagna
2021-02-03,PIE,10145,3292,6853,6614,2298,1233,0,0,0,609,9536,ITC,ITC1,1,Piemonte
2021-02-03,UMB,725,174,551,560,37,128,0,0,0,67,658,ITI,ITI2,10,Umbria
2021-01-21,VDA,33,12,21,0,0,33,0,0,0,33,0,ITC,ITC2,2,Valle d'Aosta / Vallée d'Aoste
2021-02-12,PIE,6789,2162,4627,3515,1614,1660,0,0,0,3878,2911,ITC,ITC1,1,Piemonte
2021-02-05,PAB,2788,1035,1753,640,677,394,1077,0,0,6,2782,ITH,ITH1,4,Provincia Autonoma Bolzano / Bozen
2021-02-16,VDA,325,53,272,10,58,12,5,4,236,320,5,ITC,ITC2,2,Valle d'Aosta / Vallée d'Aoste
2021-01-07,VEN,8361,2321,6040,5467,1087,1807,0,0,0,8361,0,ITH,ITH3,5,Veneto
2021-02-21,MAR,377,142,235,204,115,57,0,0,1,376,1,ITI,ITI3,11,Marche
2021-01-04,PIE,5559,1676,3883,4587,737,235,0,0,0,5559,0,ITC,ITC1,1,Piemonte
2021-01-04,UMB,809,397,412,808,1,0,0,0,0,809,0,ITI,ITI2,10,Umbria
2021-01-19,PAB,810,349,461,170,65,0,575,0,0,680,130,ITH,ITH1,4,Provincia Autonoma Bolzano / Bozen
2021-02-11,CAL,2120,933,1187,1282,597,241,0,0,0,1014,1106,ITF,ITF6,18,Calabria
2021-01-21,LOM,5292,1555,3737,1864,3180,245,2,0,1,4605,687,ITC,ITC4,3,Lombardia
2021-01-13,PAT,420,123,297,391,6,23,0,0,0,420,0,ITH,ITH2,4,Provincia Autonoma Trento
2021-02-18,FVG,3172,1456,1716,229,139,331,1495,0,978,2766,406,ITH,ITH4,6,Friuli-Venezia Giulia
2021-02-19,FVG,3200,1259,1941,564,322,312,1584,4,414,2771,429,ITH,ITH4,6,Friuli-Venezia Giulia
2021-01-18,LIG,1632,624,1008,1031,373,219,0,0,9,1483,149,ITC,ITC3,7,Liguria
2021-02-05,SAR,1897,749,1148,1214,515,164,1,3,0,433,1464,ITG,ITG2,20,Sardegna
2021-02-06,UMB,396,138,258,333,47,16,0,0,0,34,362,ITI,ITI2,10,Umbria
2021-01-17,BAS,327,132,195,95,178,54,0,0,0,326,1,ITF,ITF5,17,Basilicata
2021-01-10,SIC,3618,1615,2003,2126,1028,464,0,0,0,3618,0,ITG,ITG1,19,Sicilia
2021-01-16,LIG,1254,544,710,732,222,299,0,0,1,1254,0,ITC,ITC3,7,Liguria
2021-02-22,LIG,2908,1244,1664,583,177,56,2092,0,0,2824,84,ITC,ITC3,7,Liguria
2021-02-07,VDA,292,120,172,110,72,0,105,2,3,190,102,ITC,ITC2,2,Valle d'Aosta / Vallée d'Aoste
2021-02-23,VEN,6941,3040,3901,726,496,132,5372,67,148,6688,253,ITH,ITH3,5,Veneto
2021-02-21,ABR,1218,550,668,2,4,3,1207,2,0,1217,1,ITF,ITF1,13,Abruzzo
2021-02-23,PAT,1012,370,642,270,22,17,703,0,0,801,211,ITH,ITH2,4,Provincia Autonoma Trento
2021-01-03,PIE,3061,966,2095,2714,295,52,0,0,0,3061,0,ITC,ITC1,1,Piemonte
2021-02-24,PUG,8228,3857,4371,1793,691,80,4854,351,459,7661,567,ITF,ITF4,16,Puglia
2021-02-17,SAR,1384,563,821,679,369,311,0,25,0,1310,74,ITG,ITG2,20,Sardegna
2021-01-29,PUG,6184,2655,3529,5458,435,288,0,0,3,436,5748,ITF,ITF4,16,Puglia
2021-01-29,CAM,10052,4812,5240,6405,3388,259,0,0,0,47,10005,ITF,ITF3,15,Campania
2020-12-27,CAL,275,150,125,274,1,0,0,0,0,275,0,ITF,ITF6,18,Calabria
2021-01-06,UMB,843,323,520,840,3,0,0,0,0,843,0,ITI,ITI2,10,Umbria
2021-01-22,SAR,83,47,36,45,38,0,0,0,0,55,28,ITG,ITG2,20,Sardegna
2021-01-22,ABR,118,57,61,2,4,112,0,0,0,118,0,ITF,ITF1,13,Abruzzo
2021-01-05,LIG,2767,862,1905,2218,299,243,0,0,7,2767,0,ITC,ITC3,7,Liguria
2021-01-21,BAS,30,10,20,0,30,0,0,0,0,30,0,ITF,ITF5,17,Basilicata
2021-01-22,EMR,1828,477,1351,941,165,722,0,0,0,1089,739,ITH,ITH5,8,Emilia-Romagna
2021-02-03,MAR,2124,741,1383,1344,614,166,0,0,0,119,2005,ITI,ITI3,11,Marche
2021-02-08,FVG,2354,693,1661,1399,521,434,0,0,0,91,2263,ITH,ITH4,6,Friuli-Venezia Giulia
2021-01-10,MOL,270,72,198,82,19,169,0,0,0,270,0,ITF,ITF2,14,Molise
2021-02-09,MOL,359,170,189,161,88,110,0,0,0,197,162,ITF,ITF2,14,Molise
2021-02-13,PAT,536,333,203,370,11,0,155,0,0,171,365,ITH,ITH2,4,Provincia Autonoma Trento
2021-01-31,MOL,268,70,198,85,18,164,0,0,1,6,262,ITF,ITF2,14,Molise
2021-02-12,PUG,4052,1613,2439,2893,452,690,2,10,5,2962,1090,ITF,ITF4,16,Puglia
2021-02-16,SAR,699,288,411,373,212,114,0,0,0,670,29,ITG,ITG2,20,Sardegna
2021-01-15,MAR,1771,500,1271,985,420,366,0,0,0,1771,0,ITI,ITI3,11,Marche
2021-01-22,LOM,2889,814,2075,1081,1658,142,6,0,2,2837,52,ITC,ITC4,3,Lombardia
2021-01-30,VDA,436,202,234,232,192,12,0,0,0,13,423,ITC,ITC2,2,Valle d'Aosta / Vallée d'Aoste
2021-01-12,ABR,1804,666,1138,1470,334,0,0,0,0,1804,0,ITF,ITF1,13,Abruzzo
2021-02-16,PAB,528,205,323,10,7,0,511,0,0,528,0,ITH,ITH1,4,Provincia Autonoma Bolzano / Bozen
2021-01-08,MOL,429,141,288,244,65,120,0,0,0,429,0,ITF,ITF2,14,Molise
2021-02-12,ABR,968,319,649,438,220,310,0,0,0,779,189,ITF,ITF1,13,Abruzzo
2021-01-04,MAR,1500,563,937,1290,199,11,0,0,0,1500,0,ITI,ITI3,11,Marche
2021-01-03,MAR,896,348,548,759,137,0,0,0,0,896,0,ITI,ITI3,11,Marche
2021-01-24,TOS,3348,1072,2276,2601,37,709,1,0,0,200,3148,ITI,ITI1,9,Toscana
2021-02-08,LOM,9594,2817,6777,5119,2195,2227,53,0,0,2001,7593,ITC,ITC4,3,Lombardia
2021-01-09,SAR,4026,1417,2609,3181,845,0,0,0,0,4026,0,ITG,ITG2,20,Sardegna
2021-01-15,LIG,2165,727,1438,1269,385,509,0,0,2,2165,0,ITC,ITC3,7,Liguria
2021-01-29,SAR,2951,1067,1884,2580,368,3,0,0,0,48,2903,ITG,ITG2,20,Sardegna
2020-12-27,CAM,720,422,298,703,17,0,0,0,0,720,0,ITF,ITF3,15,Campania
2021-02-21,MOL,573,227,346,1,572,0,0,0,0,571,2,ITF,ITF2,14,Molise
2021-01-28,SIC,9327,4399,4928,7463,1569,295,0,0,0,414,8913,ITG,ITG1,19,Sicilia
2021-02-20,FVG,2037,913,1124,11,19,148,1578,0,281,1893,144,ITH,ITH4,6,Friuli-Venezia Giulia
2021-02-08,CAL,1641,650,991,1040,480,121,0,0,0,459,1182,ITF,ITF6,18,Calabria
2021-01-29,PIE,5847,1853,3994,4117,1058,672,0,0,0,454,5393,ITC,ITC1,1,Piemonte
2021-02-17,PIE,3626,1189,2437,2171,1013,441,1,0,0,2638,988,ITC,ITC1,1,Piemonte
2021-01-14,VDA,237,69,168,151,84,0,2,0,0,237,0,ITC,ITC2,2,Valle d'Aosta / Vallée d'Aoste
2021-01-24,LAZ,5467,2109,3358,4945,262,134,126,0,0,385,5082,ITI,ITI4,12,Lazio
2021-01-27,PUG,4573,1927,2646,3914,261,396,0,0,2,610,3963,ITF,ITF4,16,Puglia
2021-02-24,CAL,1820,940,880,657,366,93,653,47,4,1368,452,ITF,ITF6,18,Calabria
2021-02-16,VEN,6702,2897,3805,733,384,559,5025,1,0,6526,176,ITH,ITH3,5,Veneto
2021-02-22,VDA,316,94,222,62,41,37,103,6,67,213,103,ITC,ITC2,2,Valle d'Aosta / Vallée d'Aoste
2021-01-28,LAZ,7954,2998,4956,6810,496,514,134,0,0,459,7495,ITI,ITI4,12,Lazio
2021-01-22,VEN,1080,332,748,946,77,57,0,0,0,26,1054,ITH,ITH3,5,Veneto
2021-01-29,CAL,2047,984,1063,1751,247,49,0,0,0,234,1813,ITF,ITF6,18,Calabria
2021-02-17,VEN,6005,2765,3240,406,278,363,4953,5,0,5911,94,ITH,ITH3,5,Veneto
2021-02-12,PAT,986,333,653,332,70,55,529,0,0,565,421,ITH,ITH2,4,Provincia Autonoma Trento
2021-01-24,MAR,890,341,549,772,118,0,0,0,0,17,873,ITI,ITI3,11,Marche
2021-01-22,CAL,656,274,382,298,248,110,0,0,0,654,2,ITF,ITF6,18,Calabria
2021-01-27,FVG,1269,425,844,849,356,64,0,0,0,447,822,ITH,ITH4,6,Friuli-Venezia Giulia
2021-02-05,VDA,294,102,192,159,82,0,53,0,0,101,193,ITC,ITC2,2,Valle d'Aosta / Vallée d'Aoste
2021-01-30,LAZ,6649,2730,3919,5298,574,651,126,0,0,448,6201,ITI,ITI4,12,Lazio
2021-01-06,PAB,59,18,41,59,0,0,0,0,0,59,0,ITH,ITH1,4,Provincia Autonoma Bolzano / Bozen
2021-01-18,FVG,1960,607,1353,1358,492,110,0,0,0,1866,94,ITH,ITH4,6,Friuli-Venezia Giulia
2021-02-16,UMB,1307,655,652,33,12,0,1262,0,0,1298,9,ITI,ITI2,10,Umbria
2021-01-13,VDA,337,110,227,166,143,28,0,0,0,337,0,ITC,ITC2,2,Valle d'Aosta / Vallée d'Aoste
2021-02-13,ABR,841,380,461,545,224,72,0,0,0,437,404,ITF,ITF1,13,Abruzzo
2021-02-13,FVG,562,175,387,334,228,0,0,0,0,556,6,ITH,ITH4,6,Friuli-Venezia Giulia
2021-01-20,LIG,1185,449,736,564,300,319,0,0,2,1174,11,ITC,ITC3,7,Liguria
2021-01-29,VEN,8995,2780,6215,6035,1522,1434,3,1,0,367,8628,ITH,ITH3,5,Veneto
2021-01-27,PAT,733,257,476,395,34,304,0,0,0,73,660,ITH,ITH2,4,Provincia Autonoma Trento
2021-01-27,CAL,1457,734,723,1226,208,23,0,0,0,396,1061,ITF,ITF6,18,Calabria
2021-01-14,TOS,3254,1179,2075,2459,475,320,0,0,0,3254,0,ITI,ITI1,9,Toscana
2021-01-25,BAS,1019,426,593,672,346,1,0,0,0,74,945,ITF,ITF5,17,Basilicata
2021-01-29,PAT,1349,331,1018,722,86,541,0,0,0,54,1295,ITH,ITH2,4,Provincia Autonoma Trento
2021-02-02,LIG,2534,952,1582,1877,218,437,0,0,2,222,2312,ITC,ITC3,7,Liguria
2021-01-23,TOS,3949,1354,2595,2936,172,841,0,0,0,640,3309,ITI,ITI1,9,Toscana
2021-01-19,MAR,225,81,144,120,20,85,0,0,0,141,84,ITI,ITI3,11,Marche
2021-01-07,BAS,640,319,321,352,259,29,0,0,0,640,0,ITF,ITF5,17,Basilicata
2021-02-18,MOL,319,74,245,296,23,0,0,0,0,306,13,ITF,ITF2,14,Molise
2021-01-06,LIG,1628,601,1027,1199,249,113,64,0,3,1628,0,ITC,ITC3,7,Liguria
2021-01-02,SIC,4872,2533,2339,4311,561,0,0,0,0,4872,0,ITG,ITG1,19,Sicilia
2021-01-10,LIG,643,258,385,365,102,176,0,0,0,643,0,ITC,ITC3,7,Liguria
2021-02-13,PUG,3770,1478,2292,2892,516,332,4,18,8,3010,760,ITF,ITF4,16,Puglia
2021-02-17,UMB,1618,748,870,363,14,0,1240,0,1,1267,351,ITI,ITI2,10,Umbria
2021-01-26,MOL,450,184,266,444,5,0,0,0,1,8,442,ITF,ITF2,14,Molise
2021-02-01,FVG,2093,687,1406,1587,371,135,0,0,0,14,2079,ITH,ITH4,6,Friuli-Venezia Giulia
2021-02-14,SIC,1057,402,655,433,388,236,0,0,0,917,140,ITG,ITG1,19,Sicilia
2021-02-23,BAS,1564,647,917,159,41,35,1329,0,0,1426,138,ITF,ITF5,17,Basilicata
2021-01-21,CAL,958,444,514,735,108,115,0,0,0,929,29,ITF,ITF6,18,Calabria
2021-02-15,PUG,3119,1212,1907,2187,477,452,0,0,3,2501,618,ITF,ITF4,16,Puglia
2021-01-11,LAZ,5525,2103,3422,4553,403,569,0,0,0,5525,0,ITI,ITI4,12,Lazio
2021-02-09,SAR,2283,836,1447,1306,478,497,1,0,1,1287,996,ITG,ITG2,20,Sardegna
2021-01-06,EMR,8256,2938,5318,6823,782,650,0,1,0,8256,0,ITH,ITH5,8,Emilia-Romagna
2021-01-21,PUG,2129,904,1225,1430,173,526,0,0,0,1270,859,ITF,ITF4,16,Puglia
2020-12-27,ABR,37,19,18,34,1,2,0,0,0,37,0,ITF,ITF1,13,Abruzzo
2021-02-15,TOS,8760,3369,5391,4531,2026,215,53,795,1140,7941,819,ITI,ITI1,9,Toscana
2021-01-31,EMR,7692,2758,4934,6172,1259,261,0,0,0,242,7450,ITH,ITH5,8,Emilia-Romagna
2021-01-09,PAT,184,40,144,139,14,31,0,0,0,184,0,ITH,ITH2,4,Provincia Autonoma Trento
2021-01-07,PIE,5370,1731,3639,4145,884,341,0,0,0,5370,0,ITC,ITC1,1,Piemonte
2021-01-22,PUG,1408,578,830,876,157,373,1,0,1,991,417,ITF,ITF4,16,Puglia
2021-02-09,VEN,5077,1834,3243,3065,866,1126,20,0,0,3387,1690,ITH,ITH3,5,Veneto
2021-01-28,LIG,2743,935,1808,2148,283,306,0,1,5,34,2709,ITC,ITC3,7,Liguria
2021-01-11,PAB,1501,476,1025,532,645,174,150,0,0,1501,0,ITH,ITH1,4,Provincia Autonoma Bolzano / Bozen
2021-02-16,CAM,5430,2408,3022,910,1182,169,3169,0,0,4659,771,ITF,ITF3,15,Campania
2021-01-11,SIC,5903,2590,3313,3923,1598,382,0,0,0,5903,0,ITG,ITG1,19,Sicilia
2020-12-28,SIC,207,124,83,205,2,0,0,0,0,207,0,ITG,ITG1,19,Sicilia
2021-01-02,LIG,686,245,441,590,96,0,0,0,0,686,0,ITC,ITC3,7,Liguria
2021-02-16,PIE,3224,1076,2148,1816,857,551,0,0,0,2468,756,ITC,ITC1,1,Piemonte
2021-01-02,PAB,91,48,43,69,22,0,0,0,0,91,0,ITH,ITH1,4,Provincia Autonoma Bolzano / Bozen
2021-02-02,SIC,5537,2621,2916,3152,1956,429,0,0,0,633,4904,ITG,ITG1,19,Sicilia
2021-02-04,LOM,26697,7822,18875,15145,5952,5408,192,0,0,1864,24833,ITC,ITC4,3,Lombardia
2021-02-10,PUG,3624,1428,2196,2504,251,868,0,0,1,2114,1510,ITF,ITF4,16,Puglia
2021-01-26,EMR,8324,3000,5324,6595,697,1032,0,0,0,218,8106,ITH,ITH5,8,Emilia-Romagna
2021-01-13,MAR,2105,746,1359,1408,621,76,0,0,0,2105,0,ITI,ITI3,11,Marche
2021-01-11,LIG,2467,910,1557,1869,325,272,0,0,1,2467,0,ITC,ITC3,7,Liguria
2021-01-25,CAM,5744,2926,2818,4743,945,56,0,0,0,164,5580,ITF,ITF3,15,Campania
2021-02-09,CAL,2091,886,1205,1377,483,231,0,0,0,941,1150,ITF,ITF6,18,Calabria
2021-02-17,LOM,11396,3592,7804,7347,2201,1767,35,37,9,10043,1353,ITC,ITC4,3,Lombardia
2021-02-25,EMR,2496,1011,1485,208,94,18,2176,0,0,2325,171,ITH,ITH5,8,Emilia-Romagna
2021-01-31,VEN,4689,1541,3148,3649,672,360,4,2,2,386,4303,ITH,ITH3,5,Veneto
2021-02-14,PIE,1410,456,954,793,332,285,0,0,0,812,598,ITC,ITC1,1,Piemonte
2021-01-26,VEN,6903,2081,4822,5309,628,962,0,1,3,155,6748,ITH,ITH3,5,Veneto
2021-01-09,VEN,7924,2535,5389,5170,1165,1573,3,11,2,7924,0,ITH,ITH3,5,Veneto
2021-02-18,CAM,9072,3810,5262,1708,1340,70,5518,0,436,8365,707,ITF,ITF3,15,Campania
2021-02-24,PAT,1174,487,687,189,121,0,864,0,0,793,381,ITH,ITH2,4,Provincia Autonoma Trento
2021-02-06,MAR,2431,889,1542,1396,639,396,0,0,0,521,1910,ITI,ITI3,11,Marche
2021-02-04,VEN,7288,2012,5276,3430,1467,2378,12,0,1,552,6736,ITH,ITH3,5,Veneto
2021-01-22,PAT,1624,420,1204,873,128,623,0,0,0,313,1311,ITH,ITH2,4,Provincia Autonoma Trento
2021-01-09,PUG,4865,2245,2620,4311,303,246,4,0,1,4865,0,ITF,ITF4,16,Puglia
2021-01-09,CAL,1916,1036,880,1529,387,0,0,0,0,1916,0,ITF,ITF6,18,Calabria
2020-12-27,LOM,702,407,295,551,137,13,1,0,0,702,0,ITC,ITC4,3,Lombardia
2021-01-08,CAM,10455,4969,5486,6714,3529,212,0,0,0,10455,0,ITF,ITF3,15,Campania
2021-01-26,SAR,1336,453,883,1296,39,0,0,0,1,27,1309,ITG,ITG2,20,Sardegna
2021-02-05,MAR,2134,650,1484,1309,418,407,0,0,0,440,1694,ITI,ITI3,11,Marche
2021-02-17,CAM,7384,3206,4178,996,1083,38,4905,0,362,6324,1060,ITF,ITF3,15,Campania
2021-02-19,MOL,169,93,76,95,70,1,0,0,3,167,2,ITF,ITF2,14,Molise
2021-02-04,EMR,9899,3189,6710,6391,1717,1673,118,0,0,1239,8660,ITH,ITH5,8,Emilia-Romagna
2021-02-16,PAT,644,240,404,71,26,3,544,0,0,639,5,ITH,ITH2,4,Provincia Autonoma Trento
2021-02-21,VEN,4624,1202,3422,492,15,18,417,2,3680,4619,5,ITH,ITH3,5,Veneto
2020-12-30,PAB,362,168,194,321,41,0,0,0,0,362,0,ITH,ITH1,4,Provincia Autonoma Bolzano / Bozen
2021-02-21,SAR,1584,709,875,66,32,59,1421,6,0,1554,30,ITG,ITG2,20,Sardegna
2021-01-15,SIC,5078,2233,2845,2824,1775,479,0,0,0,5078,0,ITG,ITG1,19,Sicilia
2021-01-13,LAZ,5559,2063,3496,4145,402,1009,3,0,0,5559,0,ITI,ITI4,12,Lazio
2021-01-09,PIE,6183,2185,3998,4488,1127,568,0,0,0,6183,0,ITC,ITC1,1,Piemonte
2021-02-02,EMR,9439,3035,6404,6224,1494,1630,90,0,1,505,8934,ITH,ITH5,8,Emilia-Romagna
2021-02-24,PIE,7046,2886,4160,1615,610,271,4550,0,0,6630,416,ITC,ITC1,1,Piemonte
2021-01-22,BAS,66,24,42,6,60,0,0,0,0,66,0,ITF,ITF5,17,Basilicata
2021-02-12,FVG,1195,424,771,673,394,126,2,0,0,1145,50,ITH,ITH4,6,Friuli-Venezia Giulia
2021-01-17,TOS,2531,868,1663,2002,293,236,0,0,0,2018,513,ITI,ITI1,9,Toscana
2021-01-09,CAM,10567,5024,5543,6760,3538,269,0,0,0,10567,0,ITF,ITF3,15,Campania
2021-02-23,ABR,2781,1272,1509,323,423,215,1434,286,100,2770,11,ITF,ITF1,13,Abruzzo
2021-01-28,MOL,613,217,396,430,28,154,0,0,1,17,596,ITF,ITF2,14,Molise
2021-01-18,VDA,213,74,139,29,111,27,46,0,0,213,0,ITC,ITC2,2,Valle d'Aosta / Vallée d'Aoste
2021-01-05,UMB,850,428,422,845,5,0,0,0,0,850,0,ITI,ITI2,10,Umbria
2021-01-31,SAR,2121,750,1371,1544,576,0,1,0,0,48,2073,ITG,ITG2,20,Sardegna
2021-02-15,BAS,601,226,375,185,137,40,237,2,0,560,41,ITF,ITF5,17,Basilicata
2021-01-02,VDA,6,5,1,0,0,6,0,0,0,6,0,ITC,ITC2,2,Valle d'Aosta / Vallée d'Aoste
2021-02-22,LAZ,11370,4961,6409,1775,306,472,5205,1390,2222,10869,501,ITI,ITI4,12,Lazio
2021-02-19,MAR,1963,713,1250,1268,489,203,1,0,2,1828,135,ITI,ITI3,11,Marche
2021-01-04,PUG,4503,2012,2491,4367,120,11,0,0,5,4503,0,ITF,ITF4,16,Puglia
2021-01-29,FVG,2413,813,1600,1855,321,237,0,0,0,264,2149,ITH,ITH4,6,Friuli-Venezia Giulia
2021-01-06,PIE,3114,1110,2004,2368,433,313,0,0,0,3114,0,ITC,ITC1,1,Piemonte
2021-02-16,LIG,2051,854,1197,801,366,171,711,0,2,1872,179,ITC,ITC3,7,Liguria
2021-01-21,TOS,1589,686,903,579,220,790,0,0,0,867,722,ITI,ITI1,9,Toscana
2021-02-18,MAR,2102,745,1357,1149,549,402,1,0,1,1815,287,ITI,ITI3,11,Marche
2021-02-06,VDA,288,103,185,169,44,0,74,1,0,91,197,ITC,ITC2,2,Valle d'Aosta / Vallée d'Aoste
2021-02-08,PAB,1,1,0,0,1,0,0,0,0,1,0,ITH,ITH1,4,Provincia Autonoma Bolzano / Bozen
2021-01-31,ABR,1502,488,1014,1154,245,103,0,0,0,287,1215,ITF,ITF1,13,Abruzzo
2021-02-09,PIE,7264,2293,4971,4139,1365,1760,0,0,0,717,6547,ITC,ITC1,1,Piemonte
2021-01-14,PAB,1807,539,1268,476,760,285,286,0,0,1807,0,ITH,ITH1,4,Provincia Autonoma Bolzano / Bozen
2021-02-07,VEN,2313,861,1452,1924,337,50,2,0,0,714,1599,ITH,ITH3,5,Veneto
2021-02-08,UMB,637,203,434,368,112,153,0,4,0,88,549,ITI,ITI2,10,Umbria
2021-01-19,PUG,1222,452,770,527,117,578,0,0,0,1212,10,ITF,ITF4,16,Puglia
2021-01-22,MOL,126,35,91,21,32,73,0,0,0,126,0,ITF,ITF2,14,Molise
2021-01-17,LAZ,4443,1784,2659,3120,335,177,811,0,0,4337,106,ITI,ITI4,12,Lazio
2021-01-23,PAT,570,330,240,480,2,88,0,0,0,384,186,ITH,ITH2,4,Provincia Autonoma Trento
2021-02-24,LAZ,11886,5155,6731,1794,933,329,5103,1327,2400,10898,988,ITI,ITI4,12,Lazio
2021-01-15,PAB,3026,1119,1907,532,898,336,1260,0,0,3026,0,ITH,ITH1,4,Provincia Autonoma Bolzano / Bozen
2020-12-30,VEN,699,245,454,598,62,39,0,0,0,699,0,ITH,ITH3,5,Veneto
2021-01-31,LOM,9681,3733,5948,7420,2167,87,7,0,0,33,9648,ITC,ITC4,3,Lombardia
2021-02-05,CAL,3533,1596,1937,2191,810,532,0,0,0,456,3077,ITF,ITF6,18,Calabria
2021-02-04,SIC,6874,3157,3717,4414,1920,540,0,0,0,1458,5416,ITG,ITG1,19,Sicilia
2021-01-16,SIC,2776,1195,1581,1329,1149,298,0,0,0,2776,0,ITG,ITG1,19,Sicilia
2021-01-28,PUG,5463,2270,3193,4758,376,327,0,0,2,474,4989,ITF,ITF4,16,Puglia
2021-01-27,ABR,1364,515,849,1301,63,0,0,0,0,39,1325,ITF,ITF1,13,Abruzzo
2021-01-18,VEN,2761,782,1979,1216,538,999,8,0,0,2562,199,ITH,ITH3,5,Veneto
2021-01-14,CAM,7073,2977,4096,3707,3016,350,0,0,0,7073,0,ITF,ITF3,15,Campania
2021-02-10,MAR,1439,452,987,881,343,215,0,0,0,1080,359,ITI,ITI3,11,Marche
2021-01-09,LIG,1309,467,842,974,146,188,0,0,1,1309,0,ITC,ITC3,7,Liguria
2021-02-09,BAS,489,212,277,200,235,54,0,0,0,314,175,ITF,ITF5,17,Basilicata
2021-01-17,SAR,860,277,583,747,113,0,0,0,0,859,1,ITG,ITG2,20,Sardegna
2021-01-10,EMR,7121,2660,4461,5553,1067,499,1,0,1,7121,0,ITH,ITH5,8,Emilia-Romagna
2020-12-29,LAZ,418,150,268,418,0,0,0,0,0,418,0,ITI,ITI4,12,Lazio
2021-01-17,CAL,867,418,449,527,292,48,0,0,0,801,66,ITF,ITF6,18,Calabria
2021-02-11,SIC,5330,2102,3228,2457,1984,889,0,0,0,4866,464,ITG,ITG1,19,Sicilia
2020-12-31,VEN,3220,1044,2176,2701,265,252,0,0,2,3220,0,ITH,ITH3,5,Veneto
2020-12-30,LAZ,1601,621,980,1575,0,26,0,0,0,1601,0,ITI,ITI4,12,Lazio
2021-01-09,PAB,600,317,283,75,439,74,12,0,0,600,0,ITH,ITH1,4,Provincia Autonoma Bolzano / Bozen
2021-01-27,PIE,4193,1452,2741,2981,655,557,0,0,0,999,3194,ITC,ITC1,1,Piemonte
2021-02-04,CAL,3108,1506,1602,2407,479,222,0,0,0,644,2464,ITF,ITF6,18,Calabria
2021-02-03,PUG,5023,1998,3025,4359,477,184,0,0,3,727,4296,ITF,ITF4,16,Puglia
2021-02-18,TOS,8765,3274,5491,2914,1510,196,208,796,3141,7908,857,ITI,ITI1,9,Toscana
2021-01-22,VDA,56,21,35,36,0,20,0,0,0,20,36,ITC,ITC2,2,Valle d'Aosta / Vallée d'Aoste
2021-01-23,PUG,3036,1291,1745,2522,206,307,0,0,1,885,2151,ITF,ITF4,16,Puglia
2021-01-23,SIC,4149,2147,2002,3912,221,16,0,0,0,225,3924,ITG,ITG1,19,Sicilia
2021-02-01,VEN,8520,2489,6031,4204,1960,2108,245,0,3,166,8354,ITH,ITH3,5,Veneto
2021-02-01,LOM,15795,5215,10580,11391,3466,895,43,0,0,324,15471,ITC,ITC4,3,Lombardia
2021-02-25,CAM,4829,1933,2896,242,1108,19,2029,0,1431,4108,721,ITF,ITF3,15,Campania
2021-02-24,UMB,1482,549,933,1075,42,66,292,7,0,1469,13,ITI,ITI2,10,Umbria
2021-01-16,SAR,1492,525,967,1282,209,0,0,0,1,1492,0,ITG,ITG2,20,Sardegna
2021-01-19,VEN,1309,472,837,726,253,324,6,0,0,1160,149,ITH,ITH3,5,Veneto
2021-01-14,LIG,2614,926,1688,1670,512,431,0,0,1,2614,0,ITC,ITC3,7,Liguria
2021-01-12,EMR,9313,3084,6229,6344,1338,1631,0,0,0,9313,0,ITH,ITH5,8,Emilia-Romagna
2021-02-24,SAR,2358,1262,1096,1175,614,268,2,299,0,2169,189,ITG,ITG2,20,Sardegna
2021-01-18,MAR,673,230,443,370,171,132,0,0,0,547,126,ITI,ITI3,11,Marche
2021-01-31,MAR,1922,770,1152,1530,392,0,0,0,0,105,1817,ITI,ITI3,11,Marche
2021-01-09,BAS,558,161,397,282,207,67,0,0,2,558,0,ITF,ITF5,17,Basilicata
2021-02-15,PIE,4049,1292,2757,2298,844,906,1,0,0,2844,1205,ITC,ITC1,1,Piemonte
2021-02-06,CAL,2908,1337,1571,2094,567,247,0,0,0,442,2466,ITF,ITF6,18,Calabria
2021-01-24,ABR,50,22,28,49,1,0,0,0,0,6,44,ITF,ITF1,13,Abruzzo
2021-01-16,UMB,221,73,148,146,32,43,0,0,0,221,0,ITI,ITI2,10,Umbria
2021-01-04,VEN,6726,2029,4697,5238,570,913,1,0,4,6726,0,ITH,ITH3,5,Veneto
2021-02-02,PAB,1730,499,1231,617,499,605,9,0,0,7,1723,ITH,ITH1,4,Provincia Autonoma Bolzano / Bozen
2021-01-15,TOS,3878,1347,2531,2758,676,444,0,0,0,3878,0,ITI,ITI1,9,Toscana
2021-01-14,MAR,2010,692,1318,1112,600,298,0,0,0,2010,0,ITI,ITI3,11,Marche
2021-02-03,LOM,24904,7744,17160,15044,5842,3879,139,0,0,958,23946,ITC,ITC4,3,Lombardia
2021-01-15,UMB,692,212,480,588,44,60,0,0,0,692,0,ITI,ITI2,10,Umbria
2020-12-30,MAR,17,5,12,14,3,0,0,0,0,17,0,ITI,ITI3,11,Marche
2021-01-21,VEN,2290,719,1571,1985,162,141,0,0,2,21,2269,ITH,ITH3,5,Veneto
2021-01-08,PAT,1442,312,1130,764,152,526,0,0,0,1442,0,ITH,ITH2,4,Provincia Autonoma Trento
2021-02-22,FVG,2482,1190,1292,430,324,115,1362,246,5,2064,418,ITH,ITH4,6,Friuli-Venezia Giulia
2021-02-20,MAR,4122,1706,2416,118,411,261,3329,3,0,4011,111,ITI,ITI3,11,Marche
2021-01-31,CAL,1107,554,553,764,285,58,0,0,0,155,952,ITF,ITF6,18,Calabria
2021-01-05,BAS,946,410,536,736,210,0,0,0,0,946,0,ITF,ITF5,17,Basilicata
2021-02-05,MOL,593,269,324,460,70,63,0,0,0,55,538,ITF,ITF2,14,Molise
2021-01-20,BAS,84,22,62,0,84,0,0,0,0,84,0,ITF,ITF5,17,Basilicata
2021-01-04,ABR,1401,575,826,1396,5,0,0,0,0,1401,0,ITF,ITF1,13,Abruzzo
2021-01-27,BAS,410,174,236,151,233,26,0,0,0,113,297,ITF,ITF5,17,Basilicata
2021-02-20,CAM,8562,3078,5484,1013,857,145,4582,0,1965,8259,303,ITF,ITF3,15,Campania
2021-01-03,LOM,852,316,536,710,137,4,1,0,0,852,0,ITC,ITC4,3,Lombardia
2021-02-24,TOS,9663,4130,5533,74,1559,188,3723,1178,2941,9502,161,ITI,ITI1,9,Toscana
2021-01-13,EMR,9062,2938,6124,5967,1349,1745,0,0,1,9062,0,ITH,ITH5,8,Emilia-Romagna
2021-02-07,LAZ,4667,1865,2802,3251,385,218,813,0,0,381,4286,ITI,ITI4,12,Lazio
2021-02-09,PAT,913,287,626,441,21,73,378,0,0,441,472,ITH,ITH2,4,Provincia Autonoma Trento
2021-02-15,SIC,3944,1859,2085,1695,1343,563,10,307,26,3380,564,ITG,ITG1,19,Sicilia
2021-01-03,VEN,5157,1563,3594,4596,311,249,0,0,1,5157,0,ITH,ITH3,5,Veneto
2021-02-10,CAM,6903,3421,3482,1944,2714,88,2157,0,0,6738,165,ITF,ITF3,15,Campania
2020-12-31,PUG,1635,783,852,1550,38,44,0,0,3,1635,0,ITF,ITF4,16,Puglia
2021-01-04,LOM,5977,2058,3919,4599,1197,166,15,0,0,5977,0,ITC,ITC4,3,Lombardia
2021-01-20,PIE,6374,2033,4341,3560,1153,1661,0,0,0,5648,726,ITC,ITC1,1,Piemonte
2021-02-12,CAL,1711,669,1042,815,760,136,0,0,0,943,768,ITF,ITF6,18,Calabria
2021-02-03,VEN,5925,1658,4267,2851,1337,1734,1,0,2,474,5451,ITH,ITH3,5,Veneto
2021-02-19,SIC,5133,2736,2397,1482,1349,599,74,1390,239,4565,568,ITG,ITG1,19,Sicilia
2021-01-11,SAR,1182,505,677,656,526,0,0,0,0,1182,0,ITG,ITG2,20,Sardegna
2021-01-18,PUG,1844,770,1074,1181,216,446,0,0,1,1495,349,ITF,ITF4,16,Puglia
2021-02-06,EMR,7511,2372,5139,5307,994,1171,39,0,0,2106,5405,ITH,ITH5,8,Emilia-Romagna
2021-02-17,TOS,8146,3161,4985,3458,1172,238,208,584,2486,7407,739,ITI,ITI1,9,Toscana
2021-01-28,LOM,12063,3654,8409,8889,2305,839,30,0,0,771,11292,ITC,ITC4,3,Lombardia
2021-02-20,VDA,249,209,40,6,51,7,2,174,9,240,9,ITC,ITC2,2,Valle d'Aosta / Vallée d'Aoste
2021-01-06,PUG,3943,1664,2279,3221,349,373,0,0,0,3943,0,ITF,ITF4,16,Puglia
2021-02-25,FVG,296,133,163,0,3,0,269,0,24,296,0,ITH,ITH4,6,Friuli-Venezia Giulia
2021-01-25,SAR,588,212,376,553,35,0,0,0,0,22,566,ITG,ITG2,20,Sardegna
2021-01-09,UMB,1719,492,1227,888,10,821,0,0,0,1719,0,ITI,ITI2,10,Umbria
2021-02-08,LAZ,9332,3867,5465,3787,873,918,3754,0,0,4485,4847,ITI,ITI4,12,Lazio
2021-01-02,BAS,948,379,569,850,94,0,0,0,4,948,0,ITF,ITF5,17,Basilicata
2021-02-18,SIC,5483,3164,2319,1635,1235,813,9,1695,96,5052,431,ITG,ITG1,19,Sicilia
2021-01-05,PIE,5376,1602,3774,4363,728,285,0,0,0,5376,0,ITC,ITC1,1,Piemonte
2021-02-24,MAR,3439,1506,1933,226,234,165,2810,3,1,3360,79,ITI,ITI3,11,Marche
2021-01-09,LAZ,6288,2556,3732,5110,558,620,0,0,0,6288,0,ITI,ITI4,12,Lazio
2020-12-31,PAT,1596,439,1157,818,108,670,0,0,0,1596,0,ITH,ITH2,4,Provincia Autonoma Trento
2021-01-30,VEN,8715,2662,6053,6200,1292,1206,4,12,1,674,8041,ITH,ITH3,5,Veneto
2021-02-14,CAM,3932,1925,2007,550,905,17,2460,0,0,3889,43,ITF,ITF3,15,Campania
2021-02-23,TOS,7652,3299,4353,1485,1569,172,492,1104,2830,7491,161,ITI,ITI1,9,Toscana
2021-01-11,VDA,325,112,213,238,57,30,0,0,0,325,0,ITC,ITC2,2,Valle d'Aosta / Vallée d'Aoste
2021-01-17,MAR,1598,682,916,964,588,46,0,0,0,1549,49,ITI,ITI3,11,Marche
2021-01-14,UMB,749,200,549,696,35,17,0,0,1,749,0,ITI,ITI2,10,Umbria
2021-01-18,PAT,640,154,486,527,40,73,0,0,0,586,54,ITH,ITH2,4,Provincia Autonoma Trento
2021-01-20,VDA,23,8,15,0,0,6,17,0,0,23,0,ITC,ITC2,2,Valle d'Aosta / Vallée d'Aoste
2021-01-20,ABR,447,156,291,147,96,204,0,0,0,445,2,ITF,ITF1,13,Abruzzo
2021-01-13,PAB,1316,409,907,367,588,255,106,0,0,1316,0,ITH,ITH1,4,Provincia Autonoma Bolzano / Bozen
2021-01-31,LIG,617,264,353,412,71,134,0,0,0,7,610,ITC,ITC3,7,Liguria
2021-02-21,FVG,799,280,519,213,177,25,383,1,0,422,377,ITH,ITH4,6,Friuli-Venezia Giulia
2021-01-06,PAT,42,13,29,42,0,0,0,0,0,42,0,ITH,ITH2,4,Provincia Autonoma Trento
2021-02-18,CAL,1798,802,996,585,509,299,344,0,61,1575,223,ITF,ITF6,18,Calabria
2021-02-13,CAL,1330,582,748,731,488,111,0,0,0,967,363,ITF,ITF6,18,Calabria
2020-12-28,LAZ,516,228,288,515,1,0,0,0,0,516,0,ITI,ITI4,12,Lazio
2021-02-12,SAR,2233,931,1302,985,748,499,1,0,0,2169,64,ITG,ITG2,20,Sardegna
2021-01-15,SAR,1563,573,990,1170,390,0,0,3,0,1563,0,ITG,ITG2,20,Sardegna
2021-01-18,SIC,1548,646,902,721,619,208,0,0,0,1432,116,ITG,ITG1,19,Sicilia
2021-01-08,PUG,5571,2335,3236,4841,402,325,0,0,3,5571,0,ITF,ITF4,16,Puglia
2021-01-25,CAL,1064,512,552,1021,43,0,0,0,0,156,908,ITF,ITF6,18,Calabria
2021-02-19,CAL,1461,652,809,544,341,195,380,1,0,1200,261,ITF,ITF6,18,Calabria
2021-02-10,LIG,2138,781,1357,1252,388,494,0,0,4,1099,1039,ITC,ITC3,7,Liguria
2021-02-21,SIC,5171,2503,2668,376,650,173,3681,138,153,5066,105,ITG,ITG1,19,Sicilia
2021-02-25,LOM,4346,1837,2509,818,395,142,2588,401,2,4091,255,ITC,ITC4,3,Lombardia
2021-02-05,EMR,9282,2954,6328,6187,1319,1607,169,0,0,1614,7668,ITH,ITH5,8,Emilia-Romagna
2021-02-15,PAT,519,185,334,144,31,27,317,0,0,406,113,ITH,ITH2,4,Provincia Autonoma Trento
2021-02-01,ABR,1632,573,1059,1384,247,1,0,0,0,271,1361,ITF,ITF1,13,Abruzzo
2021-02-09,PUG,3792,1550,2242,2512,660,615,0,0,5,2120,1672,ITF,ITF4,16,Puglia
2021-01-19,LOM,7900,2300,5600,3092,2926,1768,113,1,0,7424,476,ITC,ITC4,3,Lombardia
2021-01-05,LAZ,7370,2802,4568,6690,102,577,0,1,0,7370,0,ITI,ITI4,12,Lazio
2021-02-14,LOM,3500,1514,1986,2601,875,24,0,0,0,2936,564,ITC,ITC4,3,Lombardia
2021-02-02,UMB,942,274,668,713,17,212,0,0,0,32,910,ITI,ITI2,10,Umbria
2020-12-27,BAS,106,41,65,104,2,0,0,0,0,106,0,ITF,ITF5,17,Basilicata
2021-01-11,CAL,2154,1040,1114,1759,392,3,0,0,0,2154,0,ITF,ITF6,18,Calabria
2021-01-13,TOS,4063,1398,2665,3308,350,405,0,0,0,4063,0,ITI,ITI1,9,Toscana
2021-01-26,CAM,7296,3701,3595,5741,1333,222,0,0,0,352,6944,ITF,ITF3,15,Campania
2021-01-15,PIE,8961,2951,6010,5493,1924,1544,0,0,0,8961,0,ITC,ITC1,1,Piemonte
2021-01-04,CAL,996,492,504,969,27,0,0,0,0,996,0,ITF,ITF6,18,Calabria
2021-02-24,SIC,9582,4854,4728,1421,1241,499,4024,1474,923,8990,592,ITG,ITG1,19,Sicilia
2021-01-21,LIG,831,308,523,472,161,197,1,0,0,460,371,ITC,ITC3,7,Liguria
2021-02-05,CAM,7254,3460,3794,3445,3496,304,9,0,0,2128,5126,ITF,ITF3,15,Campania
2021-02-10,UMB,715,349,366,606,106,3,0,0,0,700,15,ITI,ITI2,10,Umbria
2021-02-06,CAM,5340,2665,2675,1990,2877,458,15,0,0,2102,3238,ITF,ITF3,15,Campania
2021-01-14,SAR,1105,426,679,885,220,0,0,0,0,1105,0,ITG,ITG2,20,Sardegna
2021-01-25,MAR,1595,558,1037,1425,114,56,0,0,0,97,1498,ITI,ITI3,11,Marche
2021-01-24,EMR,2442,882,1560,2077,115,250,0,0,0,301,2141,ITH,ITH5,8,Emilia-Romagna
2021-02-07,FVG,1558,483,1075,863,693,2,0,0,0,384,1174,ITH,ITH4,6,Friuli-Venezia Giulia
2021-01-09,MAR,1709,605,1104,1406,303,0,0,0,0,1709,0,ITI,ITI3,11,Marche
2021-01-03,ABR,471,185,286,464,7,0,0,0,0,471,0,ITF,ITF1,13,Abruzzo
2021-02-06,VEN,4084,1349,2735,3016,698,367,3,0,0,705,3379,ITH,ITH3,5,Veneto
2021-02-16,TOS,9260,3337,5923,5078,982,178,7,691,2324,8550,710,ITI,ITI1,9,Toscana
2021-01-26,LOM,8312,2697,5615,6559,1543,203,7,0,0,322,7990,ITC,ITC4,3,Lombardia
2021-01-23,SAR,60,22,38,60,0,0,0,0,0,0,60,ITG,ITG2,20,Sardegna
2021-01-07,MAR,1802,633,1169,1480,322,0,0,0,0,1802,0,ITI,ITI3,11,Marche
2021-01-05,CAM,7239,3640,3599,5812,1321,106,0,0,0,7239,0,ITF,ITF3,15,Campania
2021-01-19,ABR,111,55,56,27,34,50,0,0,0,91,20,ITF,ITF1,13,Abruzzo
2021-01-13,UMB,450,139,311,379,29,42,0,0,0,450,0,ITI,ITI2,10,Umbria
2021-02-22,MOL,265,129,136,56,147,62,0,0,0,250,15,ITF,ITF2,14,Molise
2021-02-25,PIE,2959,1220,1739,434,153,128,2244,0,0,2754,205,ITC,ITC1,1,Piemonte
2021-02-13,VEN,3194,1455,1739,1549,621,1021,3,0,0,3178,16,ITH,ITH3,5,Veneto
2021-01-10,CAM,8167,3738,4429,5180,2890,97,0,0,0,8167,0,ITF,ITF3,15,Campania
2021-02-23,VDA,216,123,93,0,165,0,0,35,16,216,0,ITC,ITC2,2,Valle d'Aosta / Vallée d'Aoste
2021-01-14,CAL,2557,1214,1343,1962,592,3,0,0,0,2557,0,ITF,ITF6,18,Calabria
2021-02-12,MAR,1583,618,965,815,680,88,0,0,0,1431,152,ITI,ITI3,11,Marche
2021-02-13,SIC,3105,1167,1938,1295,1241,569,0,0,0,2848,257,ITG,ITG1,19,Sicilia
2020-12-30,FVG,630,246,384,601,29,0,0,0,0,630,0,ITH,ITH4,6,Friuli-Venezia Giulia
2021-02-03,ABR,2061,717,1344,1541,402,118,0,0,0,419,1642,ITF,ITF1,13,Abruzzo
2021-02-13,EMR,3600,1076,2524,2765,524,145,166,0,0,3003,597,ITH,ITH5,8,Emilia-Romagna
2021-02-12,SIC,4740,1850,2890,2296,1801,643,0,0,0,4409,331,ITG,ITG1,19,Sicilia
2021-01-17,MOL,78,38,40,78,0,0,0,0,0,48,30,ITF,ITF2,14,Molise
2021-01-28,PIE,5554,1801,3753,4107,876,571,0,0,0,350,5204,ITC,ITC1,1,Piemonte
2021-02-07,LOM,7042,2749,4293,5019,1773,233,17,0,0,339,6703,ITC,ITC4,3,Lombardia
2021-02-09,VDA,251,84,167,78,30,14,75,1,53,68,183,ITC,ITC2,2,Valle d'Aosta / Vallée d'Aoste
2021-01-27,SIC,7529,3834,3695,6327,1050,152,0,0,0,189,7340,ITG,ITG1,19,Sicilia
2020-12-31,FVG,1053,384,669,1011,42,0,0,0,0,1053,0,ITH,ITH4,6,Friuli-Venezia Giulia
2021-02-17,VDA,327,144,183,25,19,30,237,16,0,227,100,ITC,ITC2,2,Valle d'Aosta / Vallée d'Aoste
2020-12-28,LOM,103,44,59,102,1,0,0,0,0,103,0,ITC,ITC4,3,Lombardia
2021-01-25,SIC,7510,3695,3815,6632,808,70,0,0,0,322,7188,ITG,ITG1,19,Sicilia
2021-02-02,CAL,2009,993,1016,1626,308,75,0,0,0,171,1838,ITF,ITF6,18,Calabria
2021-01-05,PAT,707,231,476,494,52,161,0,0,0,707,0,ITH,ITH2,4,Provincia Autonoma Trento
2021-01-11,PIE,8740,2980,5760,6053,1561,1126,0,0,0,8740,0,ITC,ITC1,1,Piemonte
2021-01-24,VEN,4116,1219,2897,3750,142,222,1,0,1,28,4088,ITH,ITH3,5,Veneto
2021-01-07,TOS,6018,1751,4267,5308,30,680,0,0,0,6018,0,ITI,ITI1,9,Toscana
2021-01-09,TOS,4483,1596,2887,3779,144,560,0,0,0,4483,0,ITI,ITI1,9,Toscana
2021-01-12,SAR,865,408,457,504,361,0,0,0,0,865,0,ITG,ITG2,20,Sardegna
2021-01-31,PUG,1806,826,980,1500,104,198,2,0,2,74,1732,ITF,ITF4,16,Puglia
2021-01-28,ABR,1432,494,938,1369,62,1,0,0,0,12,1420,ITF,ITF1,13,Abruzzo
2021-01-30,CAM,10721,5079,5642,6930,3564,227,0,0,0,39,10682,ITF,ITF3,15,Campania
2021-02-08,MOL,334,141,193,206,43,85,0,0,0,216,118,ITF,ITF2,14,Molise
2021-02-11,SAR,1311,489,822,588,354,368,1,0,0,1200,111,ITG,ITG2,20,Sardegna
2021-02-01,MOL,562,201,361,301,149,111,0,0,1,14,548,ITF,ITF2,14,Molise
2021-02-06,PAT,572,296,276,178,21,0,373,0,0,432,140,ITH,ITH2,4,Provincia Autonoma Trento
2021-01-15,BAS,812,349,463,454,183,174,0,0,1,812,0,ITF,ITF5,17,Basilicata
2021-01-04,FVG,1510,559,951,1392,118,0,0,0,0,1510,0,ITH,ITH4,6,Friuli-Venezia Giulia
2021-01-11,BAS,183,66,117,78,64,41,0,0,0,183,0,ITF,ITF5,17,Basilicata
2021-02-02,PIE,10171,3485,6686,6825,2034,1312,0,0,0,808,9363,ITC,ITC1,1,Piemonte
2021-02-04,LAZ,6044,2281,3763,4460,620,892,72,0,0,941,5103,ITI,ITI4,12,Lazio
2021-01-18,PAB,1656,638,1018,369,299,7,981,0,0,1651,5,ITH,ITH1,4,Provincia Autonoma Bolzano / Bozen
2021-01-28,BAS,903,401,502,471,353,79,0,0,0,119,784,ITF,ITF5,17,Basilicata
2021-01-22,LAZ,3662,1442,2220,3379,90,70,123,0,0,148,3514,ITI,ITI4,12,Lazio
2021-02-20,LIG,1299,618,681,145,461,115,578,0,0,1298,1,ITC,ITC3,7,Liguria
2021-01-19,FVG,7,2,5,5,0,2,0,0,0,7,0,ITH,ITH4,6,Friuli-Venezia Giulia
2021-01-18,UMB,588,215,373,315,149,124,0,0,0,504,84,ITI,ITI2,10,Umbria
2021-02-15,UMB,1367,692,675,10,8,0,1349,0,0,1366,1,ITI,ITI2,10,Umbria
2021-01-17,LOM,8043,3258,4785,5100,2771,122,45,5,0,7845,198,ITC,ITC4,3,Lombardia
2021-01-03,FVG,312,122,190,285,26,1,0,0,0,312,0,ITH,ITH4,6,Friuli-Venezia Giulia
2021-01-11,CAM,4071,1871,2200,2385,1434,252,0,0,0,4071,0,ITF,ITF3,15,Campania
2021-02-08,EMR,5176,1516,3660,2814,725,1478,158,0,1,2282,2894,ITH,ITH5,8,Emilia-Romagna
2021-02-05,FVG,2613,784,1829,1613,510,490,0,0,0,90,2523,ITH,ITH4,6,Friuli-Venezia Giulia
2021-01-14,PIE,9761,3150,6611,6175,2102,1484,0,0,0,9761,0,ITC,ITC1,1,Piemonte
2021-01-23,PIE,4218,1321,2897,3189,523,506,0,0,0,878,3340,ITC,ITC1,1,Piemonte
2021-02-15,CAL,994,467,527,489,279,159,66,0,1,849,145,ITF,ITF6,18,Calabria
2021-02-04,MAR,2337,806,1531,1405,657,275,0,0,0,112,2225,ITI,ITI3,11,Marche
2021-02-08,SIC,4085,1758,2327,2345,1343,397,0,0,0,2127,1958,ITG,ITG1,19,Sicilia
2021-01-20,PUG,1551,544,1007,785,165,601,0,0,0,1543,8,ITF,ITF4,16,Puglia
2021-01-14,BAS,969,413,556,423,223,323,0,0,0,969,0,ITF,ITF5,17,Basilicata
2021-01-18,BAS,463,157,306,363,54,45,0,0,1,364,99,ITF,ITF5,17,Basilicata
2021-02-22,PAB,517,141,376,336,167,0,4,0,10,510,7,ITH,ITH1,4,Provincia Autonoma Bolzano / Bozen
2021-01-07,SIC,9173,4239,4934,7694,1269,210,0,0,0,9173,0,ITG,ITG1,19,Sicilia
2021-01-24,LOM,1184,453,731,798,361,24,1,0,0,522,662,ITC,ITC4,3,Lombardia
2021-01-02,PUG,2944,1296,1648,2825,92,23,0,0,4,2944,0,ITF,ITF4,16,Puglia
2021-02-10,SAR,1957,764,1193,1167,301,488,0,0,1,1438,519,ITG,ITG2,20,Sardegna
2021-01-11,PUG,3743,1582,2161,3206,357,175,0,3,2,3743,0,ITF,ITF4,16,Puglia
2021-02-21,PUG,1851,436,1415,525,83,48,0,12,1183,1791,60,ITF,ITF4,16,Puglia
2021-01-29,MOL,421,136,285,227,82,109,0,0,3,6,415,ITF,ITF2,14,Molise
2021-02-18,LAZ,9661,4796,4865,2158,415,471,4951,1665,1,9163,498,ITI,ITI4,12,Lazio
2021-02-03,CAL,2518,1313,1205,2054,361,103,0,0,0,577,1941,ITF,ITF6,18,Calabria
2021-02-11,BAS,767,322,445,200,168,103,291,4,1,684,83,ITF,ITF5,17,Basilicata
2021-01-16,TOS,3271,1046,2225,2493,538,240,0,0,0,3271,0,ITI,ITI1,9,Toscana
2021-01-01,VEN,1525,470,1055,1494,30,1,0,0,0,1525,0,ITH,ITH3,5,Veneto
2021-02-22,EMR,7440,3076,4364,385,273,129,6653,0,0,7177,263,ITH,ITH5,8,Emilia-Romagna
2021-01-16,PUG,2501,1032,1469,1680,305,515,0,0,1,2501,0,ITF,ITF4,16,Puglia
2021-01-27,UMB,838,329,509,837,1,0,0,0,0,13,825,ITI,ITI2,10,Umbria
2021-02-02,PUG,4278,1808,2470,3577,381,317,0,0,3,583,3695,ITF,ITF4,16,Puglia
2021-02-13,LIG,1053,495,558,530,129,140,254,0,0,781,272,ITC,ITC3,7,Liguria
2021-01-08,VDA,299,130,169,240,43,16,0,0,0,299,0,ITC,ITC2,2,Valle d'Aosta / Vallée d'Aoste
2021-02-09,MAR,125,42,83,78,21,26,0,0,0,47,78,ITI,ITI3,11,Marche
2021-01-30,FVG,2271,744,1527,1475,354,442,0,0,0,270,2001,ITH,ITH4,6,Friuli-Venezia Giulia
2021-02-11,PIE,6509,2012,4497,3392,1280,1837,0,0,0,2913,3596,ITC,ITC1,1,Piemonte
2021-01-05,VDA,150,54,96,127,12,11,0,0,0,150,0,ITC,ITC2,2,Valle d'Aosta / Vallée d'Aoste
2021-02-13,PAB,318,79,239,126,184,7,1,0,0,312,6,ITH,ITH1,4,Provincia Autonoma Bolzano / Bozen
2021-02-19,LAZ,9666,4879,4787,2167,387,408,5034,1636,34,9169,497,ITI,ITI4,12,Lazio
2021-02-03,FVG,2645,790,1855,1701,558,386,0,0,0,22,2623,ITH,ITH4,6,Friuli-Venezia Giulia
2021-01-13,CAL,2028,1022,1006,1800,194,34,0,0,0,2028,0,ITF,ITF6,18,Calabria
2021-02-07,CAL,858,427,431,565,212,81,0,0,0,146,712,ITF,ITF6,18,Calabria
2021-02-24,LIG,3178,1345,1833,742,246,95,2094,0,1,2977,201,ITC,ITC3,7,Liguria
2021-01-12,BAS,217,88,129,39,79,99,0,0,0,217,0,ITF,ITF5,17,Basilicata
2021-02-24,PAB,1193,362,831,10,21,0,0,0,1162,1181,12,ITH,ITH1,4,Provincia Autonoma Bolzano / Bozen
2021-02-16,SIC,4406,2296,2110,1462,1287,775,25,856,1,3939,467,ITG,ITG1,19,Sicilia
2021-02-08,VEN,4924,1533,3391,2743,1000,1168,12,0,1,1921,3003,ITH,ITH3,5,Veneto
2021-01-13,ABR,1253,440,813,1103,150,0,0,0,0,1253,0,ITF,ITF1,13,Abruzzo
2021-01-10,VDA,220,71,149,172,29,19,0,0,0,220,0,ITC,ITC2,2,Valle d'Aosta / Vallée d'Aoste
2021-02-23,LIG,3359,1391,1968,642,228,78,2407,2,2,3251,108,ITC,ITC3,7,Liguria
2021-02-01,EMR,10287,3594,6693,7443,1585,1259,0,0,0,366,9921,ITH,ITH5,8,Emilia-Romagna
2021-01-12,MOL,336,114,222,132,75,129,0,0,0,336,0,ITF,ITF2,14,Molise
2021-02-02,PAT,889,237,652,505,49,171,164,0,0,190,699,ITH,ITH2,4,Provincia Autonoma Trento
2021-01-10,FVG,2940,919,2021,1745,950,245,0,0,0,2940,0,ITH,ITH4,6,Friuli-Venezia Giulia
2021-01-06,MAR,2181,792,1389,1738,296,147,0,0,0,2181,0,ITI,ITI3,11,Marche
2021-01-13,FVG,2651,834,1817,1822,599,230,0,0,0,2651,0,ITH,ITH4,6,Friuli-Venezia Giulia
2021-02-04,TOS,4245,1590,2655,3166,624,455,0,0,0,955,3290,ITI,ITI1,9,Toscana
2021-01-19,CAL,1108,488,620,852,180,76,0,0,0,1098,10,ITF,ITF6,18,Calabria
2021-01-23,CAL,400,186,214,325,52,23,0,0,0,358,42,ITF,ITF6,18,Calabria
2020-12-31,VDA,18,4,14,16,2,0,0,0,0,18,0,ITC,ITC2,2,Valle d'Aosta / Vallée d'Aoste
2021-01-10,CAL,929,524,405,830,99,0,0,0,0,929,0,ITF,ITF6,18,Calabria
2021-01-15,PUG,4546,1860,2686,3594,387,558,0,3,4,4546,0,ITF,ITF4,16,Puglia
2021-01-23,BAS,706,299,407,482,222,1,0,0,1,33,673,ITF,ITF5,17,Basilicata
2021-02-17,LIG,2418,1072,1346,790,328,219,1080,0,1,2167,251,ITC,ITC3,7,Liguria
2021-01-31,TOS,2964,1090,1874,2381,135,448,0,0,0,103,2861,ITI,ITI1,9,Toscana
2021-02-23,MAR,3268,1397,1871,219,134,116,2791,8,0,3212,56,ITI,ITI3,11,Marche
2021-01-25,LIG,2572,835,1737,2111,176,283,0,0,2,462,2110,ITC,ITC3,7,Liguria
2021-01-06,VDA,65,33,32,29,18,18,0,0,0,65,0,ITC,ITC2,2,Valle d'Aosta / Vallée d'Aoste
2021-01-09,SIC,7325,3424,3901,5034,1835,456,0,0,0,7325,0,ITG,ITG1,19,Sicilia
2021-01-30,LOM,12199,4517,7682,9784,2248,159,8,0,0,192,12007,ITC,ITC4,3,Lombardia
2021-02-12,PAB,691,208,483,301,279,102,7,2,0,446,245,ITH,ITH1,4,Provincia Autonoma Bolzano / Bozen
2021-02-20,SAR,2036,854,1182,483,157,194,1201,0,1,1702,334,ITG,ITG2,20,Sardegna
2021-01-20,PAT,288,71,217,229,11,48,0,0,0,276,12,ITH,ITH2,4,Provincia Autonoma Trento
2021-02-22,VEN,6916,2991,3925,710,254,301,5416,1,234,6528,388,ITH,ITH3,5,Veneto
2021-01-22,MAR,487,167,320,315,85,87,0,0,0,194,293,ITI,ITI3,11,Marche
2021-02-12,LIG,1649,641,1008,718,202,299,429,0,1,1058,591,ITC,ITC3,7,Liguria
2021-01-27,PAB,84,28,56,54,30,0,0,0,0,1,83,ITH,ITH1,4,Provincia Autonoma Bolzano / Bozen
2021-01-02,PAT,498,142,356,334,25,139,0,0,0,498,0,ITH,ITH2,4,Provincia Autonoma Trento
2021-02-15,SAR,940,338,602,429,232,279,0,0,0,909,31,ITG,ITG2,20,Sardegna
2021-02-05,LOM,24439,7102,17337,13587,6337,4259,256,0,0,2045,22394,ITC,ITC4,3,Lombardia
2021-02-21,TOS,5100,2086,3014,3666,1216,195,1,13,9,4931,169,ITI,ITI1,9,Toscana
2021-02-21,PAT,154,92,62,154,0,0,0,0,0,42,112,ITH,ITH2,4,Provincia Autonoma Trento
2021-02-10,CAL,2451,1067,1384,1469,625,357,0,0,0,827,1624,ITF,ITF6,18,Calabria
2021-02-13,UMB,115,28,87,68,46,0,1,0,0,112,3,ITI,ITI2,10,Umbria
2021-01-11,PAT,724,220,504,516,58,150,0,0,0,724,0,ITH,ITH2,4,Provincia Autonoma Trento
2021-01-30,SIC,7836,3569,4267,5449,1912,475,0,0,0,174,7662,ITG,ITG1,19,Sicilia
2021-01-05,VEN,7327,2183,5144,5410,790,1122,0,1,4,7327,0,ITH,ITH3,5,Veneto
2021-02-14,LAZ,5535,2245,3290,1645,318,127,3445,0,0,5286,249,ITI,ITI4,12,Lazio
2021-02-07,MOL,66,32,34,49,1,16,0,0,0,19,47,ITF,ITF2,14,Molise
2020-12-27,PUG,506,249,257,401,42,63,0,0,0,506,0,ITF,ITF4,16,Puglia
2021-01-14,SIC,5250,2514,2736,3046,1945,259,0,0,0,5250,0,ITG,ITG1,19,Sicilia
2021-02-16,MOL,156,70,86,148,8,0,0,0,0,150,6,ITF,ITF2,14,Molise
2020-12-27,SAR,65,34,31,65,0,0,0,0,0,65,0,ITG,ITG2,20,Sardegna
2021-01-17,PIE,3518,1168,2350,2083,595,840,0,0,0,2870,648,ITC,ITC1,1,Piemonte
2021-01-06,CAL,926,500,426,822,104,0,0,0,0,926,0,ITF,ITF6,18,Calabria
2021-01-26,PIE,6323,1875,4448,4721,874,728,0,0,0,734,5589,ITC,ITC1,1,Piemonte
2021-02-17,MOL,72,32,40,47,19,6,0,0,0,57,15,ITF,ITF2,14,Molise
2021-01-20,VEN,1039,368,671,696,130,213,0,0,0,387,652,ITH,ITH3,5,Veneto
2020-12-27,FVG,262,149,113,259,3,0,0,0,0,262,0,ITH,ITH4,6,Friuli-Venezia Giulia
2021-02-12,UMB,671,224,447,459,208,1,1,0,2,664,7,ITI,ITI2,10,Umbria
2021-01-10,TOS,3001,1104,1897,2432,138,431,0,0,0,3001,0,ITI,ITI1,9,Toscana
2021-01-18,LOM,8939,2913,6026,4081,3279,1459,116,4,0,7957,982,ITC,ITC4,3,Lombardia
2021-01-05,LOM,7672,2513,5159,5711,1786,167,8,0,0,7672,0,ITC,ITC4,3,Lombardia
2021-02-02,FVG,2465,806,1659,1656,393,416,0,0,0,217,2248,ITH,ITH4,6,Friuli-Venezia Giulia
2020-12-27,PAT,103,40,63,76,6,21,0,0,0,103,0,ITH,ITH2,4,Provincia Autonoma Trento
2021-01-19,EMR,2039,502,1537,745,135,1159,0,0,0,2022,17,ITH,ITH5,8,Emilia-Romagna
2021-01-23,CAM,3839,2029,1810,3161,609,69,0,0,0,273,3566,ITF,ITF3,15,Campania
2021-01-18,EMR,3125,879,2246,1679,318,1128,0,0,0,2448,677,ITH,ITH5,8,Emilia-Romagna
2021-01-27,VEN,7141,2064,5077,5203,1057,879,0,0,2,247,6894,ITH,ITH3,5,Veneto
2021-01-16,ABR,927,428,499,710,202,15,0,0,0,927,0,ITF,ITF1,13,Abruzzo
2021-01-24,SIC,4335,2262,2073,3990,342,3,0,0,0,148,4187,ITG,ITG1,19,Sicilia
2021-01-26,UMB,814,390,424,813,1,0,0,0,0,18,796,ITI,ITI2,10,Umbria
2021-02-02,SAR,1482,655,827,988,494,0,0,0,0,241,1241,ITG,ITG2,20,Sardegna
2021-02-22,LOM,11373,4621,6752,3997,1477,909,3997,965,28,11084,289,ITC,ITC4,3,Lombardia
2021-02-22,MAR,3412,1498,1914,325,408,77,2595,5,2,3338,74,ITI,ITI3,11,Marche
2021-01-20,SAR,210,77,133,154,56,0,0,0,0,208,2,ITG,ITG2,20,Sardegna
2021-01-22,UMB,276,105,171,273,1,2,0,0,0,32,244,ITI,ITI2,10,Umbria
2021-01-15,PAT,590,130,460,459,21,110,0,0,0,590,0,ITH,ITH2,4,Provincia Autonoma Trento
2021-01-12,VDA,302,72,230,242,49,11,0,0,0,302,0,ITC,ITC2,2,Valle d'Aosta / Vallée d'Aoste
2021-01-31,UMB,1056,276,780,765,10,281,0,0,0,25,1031,ITI,ITI2,10,Umbria
2021-01-05,SAR,1327,446,881,1283,44,0,0,0,0,1327,0,ITG,ITG2,20,Sardegna
2021-01-03,UMB,267,111,156,267,0,0,0,0,0,267,0,ITI,ITI2,10,Umbria
2021-02-11,MAR,1987,657,1330,1155,620,212,0,0,0,1598,389,ITI,ITI3,11,Marche
2021-02-06,FVG,1152,337,815,755,207,190,0,0,0,21,1131,ITH,ITH4,6,Friuli-Venezia Giulia
2021-01-20,TOS,1313,634,679,431,256,626,0,0,0,1076,237,ITI,ITI1,9,Toscana
2021-01-13,SIC,5204,2462,2742,3033,1730,441,0,0,0,5204,0,ITG,ITG1,19,Sicilia
2021-02-24,MOL,664,277,387,240,379,44,0,0,1,333,331,ITF,ITF2,14,Molise
2021-02-10,PIE,7285,2310,4975,3834,1495,1956,0,0,0,1309,5976,ITC,ITC1,1,Piemonte
2021-02-23,SIC,8939,4681,4258,1265,1233,502,3995,1365,579,8451,488,ITG,ITG1,19,Sicilia
2021-01-16,LOM,15255,5687,9568,8147,5652,1274,179,3,0,15255,0,ITC,ITC4,3,Lombardia
2021-02-14,BAS,130,39,91,55,12,63,0,0,0,130,0,ITF,ITF5,17,Basilicata
2021-02-17,PUG,4250,1738,2512,2443,1208,597,1,0,1,3653,597,ITF,ITF4,16,Puglia
2021-02-17,CAL,1681,672,1009,673,343,285,299,0,81,1471,210,ITF,ITF6,18,Calabria
2020-12-27,VEN,880,395,485,875,4,0,0,0,1,880,0,ITH,ITH3,5,Veneto
2021-01-02,LAZ,6703,2629,4074,6267,78,358,0,0,0,6703,0,ITI,ITI4,12,Lazio
2021-02-22,ABR,2644,1175,1469,477,357,46,1094,419,251,2614,30,ITF,ITF1,13,Abruzzo
2021-01-22,FVG,90,30,60,89,1,0,0,0,0,0,90,ITH,ITH4,6,Friuli-Venezia Giulia
2021-01-10,PAB,2,2,0,1,1,0,0,0,0,2,0,ITH,ITH1,4,Provincia Autonoma Bolzano / Bozen
2021-01-04,EMR,7254,2509,4745,6160,517,577,0,0,0,7254,0,ITH,ITH5,8,Emilia-Romagna
2021-02-02,VEN,6401,1841,4560,2968,1287,1993,152,0,1,391,6010,ITH,ITH3,5,Veneto
2021-01-12,MAR,1226,413,813,912,264,50,0,0,0,1226,0,ITI,ITI3,11,Marche
2021-01-27,SAR,1408,494,914,1303,105,0,0,0,0,79,1329,ITG,ITG2,20,Sardegna
2021-02-19,BAS,1383,639,744,218,371,66,728,0,0,1321,62,ITF,ITF5,17,Basilicata
2021-02-11,ABR,816,262,554,473,189,154,0,0,0,773,43,ITF,ITF1,13,Abruzzo
2021-01-08,BAS,556,219,337,263,231,60,0,0,2,556,0,ITF,ITF5,17,Basilicata
2021-02-20,BAS,785,386,399,70,176,68,471,0,0,668,117,ITF,ITF5,17,Basilicata
2021-01-14,LAZ,5217,1960,3257,3872,450,811,84,0,0,5217,0,ITI,ITI4,12,Lazio
2021-01-09,MOL,450,152,298,221,51,178,0,0,0,450,0,ITF,ITF2,14,Molise
2021-02-17,PAT,1061,405,656,319,73,35,633,0,1,970,91,ITH,ITH2,4,Provincia Autonoma Trento
2021-02-03,EMR,9265,2969,6296,6154,1409,1617,85,0,0,949,8316,ITH,ITH5,8,Emilia-Romagna
2021-02-04,CAM,7943,3429,4514,3965,3685,292,1,0,0,1308,6635,ITF,ITF3,15,Campania
2021-02-04,PIE,10187,3335,6852,6232,2199,1756,0,0,0,581,9606,ITC,ITC1,1,Piemonte
2021-01-31,PIE,4105,1748,2357,3076,654,375,0,0,0,112,3993,ITC,ITC1,1,Piemonte
2021-01-03,EMR,2730,934,1796,2480,80,170,0,0,0,2730,0,ITH,ITH5,8,Emilia-Romagna
2021-01-20,UMB,613,222,391,583,15,14,0,0,1,613,0,ITI,ITI2,10,Umbria
2021-01-16,EMR,5591,1716,3875,3686,793,1108,0,3,1,5591,0,ITH,ITH5,8,Emilia-Romagna
2021-02-11,VDA,231,107,124,53,38,0,127,13,0,222,9,ITC,ITC2,2,Valle d'Aosta / Vallée d'Aoste
2021-01-28,TOS,6275,1880,4395,5421,66,788,0,0,0,349,5926,ITI,ITI1,9,Toscana
2021-01-06,LOM,7044,2486,4558,5264,1742,35,3,0,0,7044,0,ITC,ITC4,3,Lombardia
2021-01-20,PAB,609,248,361,282,77,0,250,0,0,401,208,ITH,ITH1,4,Provincia Autonoma Bolzano / Bozen
2021-02-18,PIE,3775,1218,2557,2236,935,604,0,0,0,3380,395,ITC,ITC1,1,Piemonte
2021-02-02,MAR,1193,397,796,804,296,93,0,0,0,73,1120,ITI,ITI3,11,Marche
2021-01-23,UMB,277,100,177,276,1,0,0,0,0,2,275,ITI,ITI2,10,Umbria
2021-01-11,TOS,5092,1689,3403,4360,210,522,0,0,0,5092,0,ITI,ITI1,9,Toscana
2021-02-25,SIC,4264,2256,2008,634,617,259,2033,593,128,3638,626,ITG,ITG1,19,Sicilia
2021-02-15,CAM,5467,2512,2955,976,1002,94,3393,1,1,5294,173,ITF,ITF3,15,Campania
2020-12-30,PIE,730,322,408,685,45,0,0,0,0,730,0,ITC,ITC1,1,Piemonte
2021-01-04,BAS,607,271,336,533,71,0,0,0,3,607,0,ITF,ITF5,17,Basilicata
2021-01-23,PAB,195,115,80,183,12,0,0,0,0,0,195,ITH,ITH1,4,Provincia Autonoma Bolzano / Bozen
2021-01-31,FVG,2712,836,1876,1692,1002,18,0,0,0,385,2327,ITH,ITH4,6,Friuli-Venezia Giulia
2021-01-06,ABR,1830,664,1166,1546,151,133,0,0,0,1830,0,ITF,ITF1,13,Abruzzo
2020-12-27,VDA,20,9,11,20,0,0,0,0,0,20,0,ITC,ITC2,2,Valle d'Aosta / Vallée d'Aoste
2021-01-04,LAZ,7477,2907,4570,7074,86,316,0,0,1,7477,0,ITI,ITI4,12,Lazio
2021-02-08,MAR,833,258,575,408,163,262,0,0,0,371,462,ITI,ITI3,11,Marche
2021-02-07,CAM,2934,1385,1549,710,1708,226,290,0,0,2156,778,ITF,ITF3,15,Campania
2021-01-28,SAR,2968,1044,1924,2554,403,0,0,11,0,69,2899,ITG,ITG2,20,Sardegna
2021-02-09,CAM,4627,2192,2435,1148,2137,6,1336,0,0,4375,252,ITF,ITF3,15,Campania
2021-01-15,EMR,7700,2392,5308,5288,1093,1318,0,0,1,7700,0,ITH,ITH5,8,Emilia-Romagna
2021-01-15,VDA,218,82,136,116,68,28,6,0,0,218,0,ITC,ITC2,2,Valle d'Aosta / Vallée d'Aoste
2021-02-01,LAZ,5668,2172,3496,4783,319,559,7,0,0,352,5316,ITI,ITI4,12,Lazio
2021-01-07,LAZ,7719,2891,4828,6877,276,566,0,0,0,7719,0,ITI,ITI4,12,Lazio
2021-02-10,FVG,1352,496,856,745,487,119,0,0,1,1266,86,ITH,ITH4,6,Friuli-Venezia Giulia
2021-01-25,PAB,461,176,285,379,80,0,1,0,1,3,458,ITH,ITH1,4,Provincia Autonoma Bolzano / Bozen
2021-01-17,PAB,2269,1024,1245,54,236,19,1960,0,0,2257,12,ITH,ITH1,4,Provincia Autonoma Bolzano / Bozen
2021-02-01,BAS,242,91,151,97,97,48,0,0,0,46,196,ITF,ITF5,17,Basilicata
2021-01-05,MAR,1562,586,976,1436,126,0,0,0,0,1562,0,ITI,ITI3,11,Marche
2021-01-26,FVG,1972,647,1325,1439,152,381,0,0,0,214,1758,ITH,ITH4,6,Friuli-Venezia Giulia
2021-01-10,SAR,2183,750,1433,1632,551,0,0,0,0,2183,0,ITG,ITG2,20,Sardegna
2021-02-09,LIG,1722,640,1082,979,313,409,0,0,21,398,1324,ITC,ITC3,7,Liguria
2021-01-28,VEN,9178,2652,6526,6457,1288,1430,0,0,3,171,9007,ITH,ITH3,5,Veneto
2021-01-27,MAR,2118,780,1338,1752,226,140,0,0,0,122,1996,ITI,ITI3,11,Marche
2021-02-04,UMB,732,226,506,692,20,20,0,0,0,25,707,ITI,ITI2,10,Umbria
2020-12-31,CAM,1490,811,679,1273,216,1,0,0,0,1490,0,ITF,ITF3,15,Campania
2021-01-30,MOL,460,158,302,189,92,179,0,0,0,12,448,ITF,ITF2,14,Molise
2021-02-04,PAB,1839,556,1283,623,598,404,214,0,0,8,1831,ITH,ITH1,4,Provincia Autonoma Bolzano / Bozen
2021-02-21,CAL,607,286,321,36,164,47,330,30,0,530,77,ITF,ITF6,18,Calabria
2021-02-01,SIC,6077,2684,3393,4168,1591,318,0,0,0,304,5773,ITG,ITG1,19,Sicilia
2021-01-29,EMR,10324,3477,6847,8074,1232,1018,0,0,0,289,10035,ITH,ITH5,8,Emilia-Romagna
2021-01-04,SIC,8373,4172,4201,7595,772,6,0,0,0,8373,0,ITG,ITG1,19,Sicilia
2021-02-15,LIG,2039,768,1271,918,237,224,658,1,1,1689,350,ITC,ITC3,7,Liguria
2021-01-28,PAB,867,307,560,584,214,69,0,0,0,10,857,ITH,ITH1,4,Provincia Autonoma Bolzano / Bozen
2021-02-16,CAL,1439,605,834,651,430,240,118,0,0,1160,279,ITF,ITF6,18,Calabria
2021-02-16,PUG,3362,1443,1919,2121,808,412,3,16,2,2717,645,ITF,ITF4,16,Puglia
2021-01-19,BAS,199,84,115,78,77,44,0,0,0,199,0,ITF,ITF5,17,Basilicata
2021-01-05,ABR,1614,604,1010,1604,10,0,0,0,0,1614,0,ITF,ITF1,13,Abruzzo
2021-02-09,PAB,317,126,191,64,22,2,227,0,2,1,316,ITH,ITH1,4,Provincia Autonoma Bolzano / Bozen
2021-01-08,PIE,5528,1761,3767,4078,1029,421,0,0,0,5528,0,ITC,ITC1,1,Piemonte
2020-12-31,PIE,3879,1318,2561,3387,358,134,0,0,0,3879,0,ITC,ITC1,1,Piemonte
2021-02-08,VDA,223,83,140,28,103,3,64,0,25,25,198,ITC,ITC2,2,Valle d'Aosta / Vallée d'Aoste
2021-02-24,CAM,11511,4071,7440,712,2310,85,5095,0,3309,10822,689,ITF,ITF3,15,Campania
2021-02-12,EMR,5292,1671,3621,3383,921,702,286,0,0,3894,1398,ITH,ITH5,8,Emilia-Romagna
2021-02-04,LIG,2749,960,1789,1817,455,468,0,1,8,237,2512,ITC,ITC3,7,Liguria
2021-01-10,PAT,84,19,65,53,19,12,0,0,0,84,0,ITH,ITH2,4,Provincia Autonoma Trento
2021-01-14,MOL,646,239,407,418,113,115,0,0,0,646,0,ITF,ITF2,14,Molise
2021-02-25,MAR,1155,520,635,43,46,46,1020,0,0,1115,40,ITI,ITI3,11,Marche
2021-02-20,LAZ,8781,4077,4704,1940,460,297,4752,1310,22,8364,417,ITI,ITI4,12,Lazio
2021-01-17,LIG,856,298,558,513,81,261,0,0,1,856,0,ITC,ITC3,7,Liguria
2021-01-25,TOS,5122,1895,3227,4158,56,908,0,0,0,247,4875,ITI,ITI1,9,Toscana
2021-01-28,UMB,1240,392,848,891,4,345,0,0,0,19,1221,ITI,ITI2,10,Umbria
2021-01-16,BAS,721,304,417,270,287,161,0,0,3,721,0,ITF,ITF5,17,Basilicata
2020-12-30,LIG,9,3,6,9,0,0,0,0,0,9,0,ITC,ITC3,7,Liguria
2021-01-18,ABR,122,48,74,106,14,2,0,0,0,46,76,ITF,ITF1,13,Abruzzo
2021-01-10,VEN,5019,1661,3358,3838,715,462,2,2,0,5019,0,ITH,ITH3,5,Veneto
2020-12-27,MAR,200,97,103,184,12,4,0,0,0,200,0,ITI,ITI3,11,Marche
2021-01-29,LOM,13416,4108,9308,10439,2405,563,9,0,0,640,12776,ITC,ITC4,3,Lombardia
2021-01-31,PAT,74,15,59,55,13,6,0,0,0,0,74,ITH,ITH2,4,Provincia Autonoma Trento
2021-02-07,PIE,3087,974,2113,1649,662,776,0,0,0,445,2642,ITC,ITC1,1,Piemonte
2021-01-10,UMB,1056,275,781,740,9,307,0,0,0,1056,0,ITI,ITI2,10,Umbria
2021-02-24,LOM,13013,5257,7756,3182,1512,1549,5566,1181,23,12263,750,ITC,ITC4,3,Lombardia
2021-01-23,LIG,799,289,510,630,125,43,0,0,1,145,654,ITC,ITC3,7,Liguria
2021-02-21,CAM,5823,2234,3589,780,653,22,3860,0,508,5598,225,ITF,ITF3,15,Campania
2021-01-17,CAM,1155,551,604,718,286,151,0,0,0,702,453,ITF,ITF3,15,Campania
2021-01-15,ABR,379,149,230,223,121,35,0,0,0,379,0,ITF,ITF1,13,Abruzzo
2021-02-02,VDA,270,70,200,225,43,2,0,0,0,2,268,ITC,ITC2,2,Valle d'Aosta / Vallée d'Aoste
2021-01-02,TOS,3497,1097,2400,2682,15,800,0,0,0,3497,0,ITI,ITI1,9,Toscana
2021-02-10,PAT,829,282,547,306,104,51,368,0,0,489,340,ITH,ITH2,4,Provincia Autonoma Trento
2021-02-08,ABR,1201,398,803,710,227,264,0,0,0,491,710,ITF,ITF1,13,Abruzzo
2021-02-20,LOM,9331,3871,5460,4259,1113,185,2907,863,4,9043,288,ITC,ITC4,3,Lombardia
2021-02-07,LIG,399,150,249,189,27,183,0,0,0,3,396,ITC,ITC3,7,Liguria
2021-01-04,LIG,2369,782,1587,2052,223,91,0,0,3,2369,0,ITC,ITC3,7,Liguria
2021-02-17,EMR,6522,2757,3765,799,1298,404,4021,0,0,5748,774,ITH,ITH5,8,Emilia-Romagna
2021-02-24,ABR,3301,1439,1862,391,340,247,1966,226,131,3125,176,ITF,ITF1,13,Abruzzo
2021-02-11,PAT,1130,364,766,323,63,48,696,0,0,795,335,ITH,ITH2,4,Provincia Autonoma Trento
2021-01-09,LOM,12375,4558,7817,8133,4039,192,10,1,0,12375,0,ITC,ITC4,3,Lombardia
2021-01-19,LAZ,4360,1671,2689,2967,561,424,408,0,0,3907,453,ITI,ITI4,12,Lazio
2021-02-18,UMB,1495,582,913,324,16,170,985,0,0,1029,466,ITI,ITI2,10,Umbria
2021-01-29,ABR,1386,449,937,1290,96,0,0,0,0,74,1312,ITF,ITF1,13,Abruzzo
2021-02-18,SAR,1871,731,1140,1069,361,297,1,33,110,1809,62,ITG,ITG2,20,Sardegna
2021-02-06,SIC,5013,2189,2824,2519,1924,570,0,0,0,1461,3552,ITG,ITG1,19,Sicilia
2021-01-21,CAM,2093,1116,977,1379,639,75,0,0,0,677,1416,ITF,ITF3,15,Campania
2021-02-16,EMR,5695,2417,3278,738,999,424,3534,0,0,5167,528,ITH,ITH5,8,Emilia-Romagna
2021-02-05,TOS,5746,2243,3503,4120,1184,442,0,0,0,1922,3824,ITI,ITI1,9,Toscana
2021-02-17,ABR,2073,949,1124,511,241,394,716,210,1,1791,282,ITF,ITF1,13,Abruzzo
2021-01-12,FVG,2257,712,1545,1525,371,361,0,0,0,2257,0,ITH,ITH4,6,Friuli-Venezia Giulia
2021-01-03,LAZ,5250,1972,3278,5125,60,65,0,0,0,5250,0,ITI,ITI4,12,Lazio
2021-01-25,PIE,6209,1938,4271,4782,865,562,0,0,0,980,5229,ITC,ITC1,1,Piemonte
2021-02-18,EMR,7037,2889,4148,888,539,236,5374,0,0,6456,581,ITH,ITH5,8,Emilia-Romagna
2021-02-03,LAZ,6287,2348,3939,4619,555,1078,35,0,0,900,5387,ITI,ITI4,12,Lazio
2021-01-08,SAR,3257,1184,2073,2929,328,0,0,0,0,3257,0,ITG,ITG2,20,Sardegna
2021-01-17,VDA,131,56,75,49,3,20,59,0,0,131,0,ITC,ITC2,2,Valle d'Aosta / Vallée d'Aoste
2021-01-08,UMB,1173,337,836,926,9,238,0,0,0,1173,0,ITI,ITI2,10,Umbria
2021-01-21,PIE,6706,2257,4449,4681,854,1171,0,0,0,3220,3486,ITC,ITC1,1,Piemonte
2020-12-31,UMB,322,127,195,310,12,0,0,0,0,322,0,ITI,ITI2,10,Umbria
2021-01-01,PAT,206,48,158,109,11,86,0,0,0,206,0,ITH,ITH2,4,Provincia Autonoma Trento
2021-01-03,SIC,4693,2454,2239,4361,332,0,0,0,0,4693,0,ITG,ITG1,19,Sicilia
2021-02-18,PAB,1639,400,1239,23,320,20,3,0,1273,1635,4,ITH,ITH1,4,Provincia Autonoma Bolzano / Bozen
2021-02-10,VDA,239,75,164,51,25,18,126,1,18,132,107,ITC,ITC2,2,Valle d'Aosta / Vallée d'Aoste
2021-02-21,LIG,858,485,373,178,316,97,267,0,0,854,4,ITC,ITC3,7,Liguria
2021-01-16,MOL,420,166,254,270,23,127,0,0,0,420,0,ITF,ITF2,14,Molise
2021-01-25,ABR,1604,633,971,1584,20,0,0,0,0,20,1584,ITF,ITF1,13,Abruzzo
2021-01-07,LOM,11555,3593,7962,8085,2802,594,72,2,0,11555,0,ITC,ITC4,3,Lombardia
2021-02-05,LAZ,6908,2722,4186,5094,631,994,189,0,0,1130,5778,ITI,ITI4,12,Lazio
2021-02-11,TOS,5370,2009,3361,2808,2218,323,0,10,11,5128,242,ITI,ITI1,9,Toscana
2021-01-12,PAT,501,158,343,412,30,59,0,0,0,501,0,ITH,ITH2,4,Provincia Autonoma Trento
2021-02-03,SIC,6099,2855,3244,3355,2120,624,0,0,0,756,5343,ITG,ITG1,19,Sicilia
2021-01-07,CAM,8910,4166,4744,6313,2265,332,0,0,0,8910,0,ITF,ITF3,15,Campania
2021-01-08,PAB,1487,469,1018,759,466,166,96,0,0,1487,0,ITH,ITH1,4,Provincia Autonoma Bolzano / Bozen
2021-02-02,TOS,3734,1471,2263,3020,287,421,0,6,0,188,3546,ITI,ITI1,9,Toscana
2021-02-11,PUG,3664,1389,2275,2548,388,725,0,0,3,2393,1271,ITF,ITF4,16,Puglia
2020-12-31,LIG,948,334,614,713,54,153,28,0,0,948,0,ITC,ITC3,7,Liguria
2021-01-25,PUG,3818,1675,2143,3470,179,168,0,0,1,421,3397,ITF,ITF4,16,Puglia
2020-12-31,PAB,867,497,370,439,428,0,0,0,0,867,0,ITH,ITH1,4,Provincia Autonoma Bolzano / Bozen
2021-02-07,MAR,1870,734,1136,1156,668,46,0,0,0,344,1526,ITI,ITI3,11,Marche
2021-02-19,PAB,1633,392,1241,121,263,73,7,0,1169,1622,11,ITH,ITH1,4,Provincia Autonoma Bolzano / Bozen
2021-02-20,CAL,1358,735,623,438,411,55,433,19,2,1043,315,ITF,ITF6,18,Calabria
2021-02-04,SAR,2270,815,1455,1737,363,169,1,0,0,914,1356,ITG,ITG2,20,Sardegna
2021-01-09,EMR,9872,3425,6447,7685,1307,880,0,0,0,9872,0,ITH,ITH5,8,Emilia-Romagna
2021-02-23,PIE,6987,2776,4211,2106,894,338,3649,0,0,6417,570,ITC,ITC1,1,Piemonte
2021-02-23,UMB,1693,658,1035,1187,95,17,394,0,0,1650,43,ITI,ITI2,10,Umbria
2021-02-01,CAL,2496,1192,1304,2044,409,43,0,0,0,248,2248,ITF,ITF6,18,Calabria
2021-01-26,SIC,9485,4667,4818,8357,874,254,0,0,0,236,9249,ITG,ITG1,19,Sicilia
2021-01-20,MAR,398,99,299,146,62,190,0,0,0,386,12,ITI,ITI3,11,Marche
2021-01-08,EMR,10802,3554,7248,8390,1334,1076,0,2,0,10802,0,ITH,ITH5,8,Emilia-Romagna
2021-01-19,SIC,1271,521,750,521,512,238,0,0,0,1093,178,ITG,ITG1,19,Sicilia
2021-02-18,VEN,5660,2431,3229,940,359,553,3803,0,5,5593,67,ITH,ITH3,5,Veneto
2021-02-24,EMR,9039,3466,5573,616,591,195,7637,0,0,8188,851,ITH,ITH5,8,Emilia-Romagna
2021-01-06,MOL,689,260,429,456,62,171,0,0,0,689,0,ITF,ITF2,14,Molise
2021-01-01,PIE,1038,395,643,922,116,0,0,0,0,1038,0,ITC,ITC1,1,Piemonte
2021-01-10,MAR,1737,699,1038,1462,275,0,0,0,0,1737,0,ITI,ITI3,11,Marche
2021-02-12,BAS,651,284,367,285,269,89,2,6,0,620,31,ITF,ITF5,17,Basilicata
2021-01-17,FVG,1720,524,1196,674,560,486,0,0,0,1720,0,ITH,ITH4,6,Friuli-Venezia Giulia
2021-01-01,PUG,146,60,86,145,1,0,0,0,0,146,0,ITF,ITF4,16,Puglia
2021-01-12,PUG,4199,1762,2437,3625,350,218,1,0,5,4199,0,ITF,ITF4,16,Puglia
2021-02-16,LOM,8986,2936,6050,5589,2161,1202,8,7,19,8542,444,ITC,ITC4,3,Lombardia
2021-02-06,LAZ,5068,2015,3053,3269,630,660,509,0,0,768,4300,ITI,ITI4,12,Lazio
2021-02-20,PAT,370,235,135,326,13,30,1,0,0,87,283,ITH,ITH2,4,Provincia Autonoma Trento
2021-02-07,SIC,2345,995,1350,1609,581,155,0,0,0,672,1673,ITG,ITG1,19,Sicilia
2021-02-25,VEN,3797,1691,2106,312,147,161,3174,3,0,3523,274,ITH,ITH3,5,Veneto
2021-01-13,LIG,2635,963,1672,1841,338,452,0,0,4,2635,0,ITC,ITC3,7,Liguria
2021-01-04,MOL,314,131,183,301,13,0,0,0,0,314,0,ITF,ITF2,14,Molise
2021-01-05,MOL,449,180,269,441,8,0,0,0,0,449,0,ITF,ITF2,14,Molise
2021-02-06,MOL,428,178,250,275,22,130,0,0,1,28,400,ITF,ITF2,14,Molise
2021-02-19,EMR,7289,3000,4289,816,392,256,5823,0,2,6786,503,ITH,ITH5,8,Emilia-Romagna
2021-01-30,LIG,1633,553,1080,1238,137,256,0,0,2,25,1608,ITC,ITC3,7,Liguria
2021-02-01,PAT,1218,334,884,766,83,369,0,0,0,92,1126,ITH,ITH2,4,Provincia Autonoma Trento
2021-02-16,BAS,778,325,453,246,95,65,370,1,1,680,98,ITF,ITF5,17,Basilicata
2021-02-25,UMB,941,354,587,643,70,32,193,0,3,892,49,ITI,ITI2,10,Umbria
2021-02-18,ABR,2291,934,1357,670,380,416,610,215,0,2161,130,ITF,ITF1,13,Abruzzo
2021-02-06,LIG,1869,756,1113,1292,201,375,0,0,1,145,1724,ITC,ITC3,7,Liguria
2021-01-28,MAR,1972,659,1313,1581,290,101,0,0,0,167,1805,ITI,ITI3,11,Marche
2021-02-14,SAR,538,262,276,288,193,57,0,0,0,536,2,ITG,ITG2,20,Sardegna
2021-01-09,ABR,1483,565,918,1430,53,0,0,0,0,1483,0,ITF,ITF1,13,Abruzzo
2021-02-20,PUG,2823,1044,1779,2069,232,160,3,4,355,2568,255,ITF,ITF4,16,Puglia
2021-02-19,ABR,3231,1525,1706,990,433,371,1041,388,8,3131,100,ITF,ITF1,13,Abruzzo
2021-01-08,ABR,1525,507,1018,1487,38,0,0,0,0,1525,0,ITF,ITF1,13,Abruzzo
2021-01-07,PUG,5707,2448,3259,5210,276,217,0,1,3,5707,0,ITF,ITF4,16,Puglia
2021-01-08,VEN,9398,2831,6567,5978,1605,1807,3,1,4,9398,0,ITH,ITH3,5,Veneto
2021-01-25,FVG,1582,567,1015,1369,141,72,0,0,0,194,1388,ITH,ITH4,6,Friuli-Venezia Giulia
2021-02-01,PUG,3956,1656,2300,3437,300,209,0,4,6,376,3580,ITF,ITF4,16,Puglia
2021-01-06,BAS,294,129,165,144,114,36,0,0,0,294,0,ITF,ITF5,17,Basilicata
2021-02-03,MOL,731,249,482,391,159,180,0,0,1,338,393,ITF,ITF2,14,Molise
2021-01-26,PAB,809,291,518,670,139,0,0,0,0,1,808,ITH,ITH1,4,Provincia Autonoma Bolzano / Bozen
2020-12-27,PIE,912,368,544,760,76,76,0,0,0,912,0,ITC,ITC1,1,Piemonte
2021-02-17,BAS,904,386,518,120,159,57,566,1,1,828,76,ITF,ITF5,17,Basilicata
2021-02-14,VEN,124,55,69,93,31,0,0,0,0,111,13,ITH,ITH3,5,Veneto
2021-02-19,SAR,1490,468,1022,674,436,378,1,1,0,1434,56,ITG,ITG2,20,Sardegna
2021-02-04,BAS,1091,440,651,551,259,281,0,0,0,63,1028,ITF,ITF5,17,Basilicata
2021-01-22,PIE,3817,1234,2583,2273,649,895,0,0,0,2475,1342,ITC,ITC1,1,Piemonte
2021-01-07,PAT,1269,310,959,649,64,556,0,0,0,1269,0,ITH,ITH2,4,Provincia Autonoma Trento
2021-02-15,VDA,264,136,128,24,29,24,170,15,2,229,35,ITC,ITC2,2,Valle d'Aosta / Vallée d'Aoste
2021-01-07,ABR,1603,552,1051,1566,37,0,0,0,0,1603,0,ITF,ITF1,13,Abruzzo
2021-01-19,LIG,1176,398,778,628,292,253,0,0,3,1091,85,ITC,ITC3,7,Liguria
2021-01-21,FVG,894,345,549,863,31,0,0,0,0,1,893,ITH,ITH4,6,Friuli-Venezia Giulia
2021-01-03,PAB,40,15,25,32,7,0,1,0,0,40,0,ITH,ITH1,4,Provincia Autonoma Bolzano / Bozen
2021-02-23,CAM,10913,3362,7551,514,2211,219,3685,0,4284,10388,525,ITF,ITF3,15,Campania
2021-01-15,MOL,538,242,296,398,59,81,0,0,0,538,0,ITF,ITF2,14,Molise
2021-02-25,MOL,192,77,115,12,180,0,0,0,0,191,1,ITF,ITF2,14,Molise
2021-02-09,EMR,4139,1241,2898,2214,488,1198,239,0,0,2293,1846,ITH,ITH5,8,Emilia-Romagna
2021-02-25,SAR,1028,494,534,523,287,97,73,48,0,666,362,ITG,ITG2,20,Sardegna
2021-01-06,SAR,1615,549,1066,1510,105,0,0,0,0,1615,0,ITG,ITG2,20,Sardegna
2021-02-19,UMB,743,293,450,281,16,14,432,0,0,526,217,ITI,ITI2,10,Umbria
2021-01-03,LIG,727,226,501,651,75,0,0,0,1,727,0,ITC,ITC3,7,Liguria
2021-01-18,LAZ,5345,2069,3276,3411,756,725,453,0,0,4856,489,ITI,ITI4,12,Lazio
2020-12-29,SAR,57,32,25,56,1,0,0,0,0,57,0,ITG,ITG2,20,Sardegna
2021-02-16,ABR,1972,865,1107,841,513,139,404,75,0,1960,12,ITF,ITF1,13,Abruzzo
2021-02-23,FVG,2607,1249,1358,103,105,206,1939,254,0,2429,178,ITH,ITH4,6,Friuli-Venezia Giulia
2021-01-18,TOS,1119,636,483,430,314,375,0,0,0,1021,98,ITI,ITI1,9,Toscana
2020-12-29,LOM,100,43,57,100,0,0,0,0,0,100,0,ITC,ITC4,3,Lombardia
2021-02-08,PUG,3919,1578,2341,2915,589,389,0,25,1,1532,2387,ITF,ITF4,16,Puglia
2021-02-22,TOS,9796,4245,5551,3481,2280,296,22,1014,2703,9525,271,ITI,ITI1,9,Toscana
2021-01-30,MAR,1906,668,1238,1566,340,0,0,0,0,29,1877,ITI,ITI3,11,Marche
2021-01-11,MAR,1176,411,765,1021,155,0,0,0,0,1176,0,ITI,ITI3,11,Marche
2021-02-14,EMR,1397,377,1020,852,486,39,19,1,0,1277,120,ITH,ITH5,8,Emilia-Romagna
2021-01-20,SIC,808,410,398,422,194,192,0,0,0,573,235,ITG,ITG1,19,Sicilia
2021-01-27,TOS,4835,1572,3263,4019,74,742,0,0,0,207,4628,ITI,ITI1,9,Toscana
2021-01-25,PAT,774,205,569,482,30,262,0,0,0,23,751,ITH,ITH2,4,Provincia Autonoma Trento
2021-02-10,TOS,4259,1279,2980,3533,241,484,0,1,0,3737,522,ITI,ITI1,9,Toscana
2021-02-21,EMR,4393,1693,2700,391,286,188,3527,0,1,3959,434,ITH,ITH5,8,Emilia-Romagna
2021-02-03,LIG,2178,740,1438,1545,261,371,0,0,1,240,1938,ITC,ITC3,7,Liguria
2021-01-16,PAB,2748,1229,1519,450,360,77,1861,0,0,2748,0,ITH,ITH1,4,Provincia Autonoma Bolzano / Bozen
2021-02-18,BAS,1029,380,649,264,78,149,538,0,0,813,216,ITF,ITF5,17,Basilicata
2021-01-07,CAL,2179,1061,1118,1882,297,0,0,0,0,2179,0,ITF,ITF6,18,Calabria
2021-02-19,VEN,7079,3013,4066,1333,878,491,4372,3,2,6886,193,ITH,ITH3,5,Veneto
2021-02-12,CAM,6548,2872,3676,1808,1467,214,3055,0,4,6335,213,ITF,ITF3,15,Campania
2021-01-22,CAM,1523,775,748,970,344,209,0,0,0,673,850,ITF,ITF3,15,Campania
2021-02-22,PUG,8705,4069,4636,1393,708,140,5989,169,306,8379,326,ITF,ITF4,16,Puglia
2021-01-19,MOL,173,63,110,90,59,22,0,0,2,162,11,ITF,ITF2,14,Molise
2021-01-06,VEN,8127,2380,5747,6305,1010,807,1,2,2,8127,0,ITH,ITH3,5,Veneto
2021-02-23,CAL,1549,728,821,437,381,206,522,2,1,1434,115,ITF,ITF6,18,Calabria
2021-02-05,LIG,2438,885,1553,1559,414,462,0,0,3,360,2078,ITC,ITC3,7,Liguria
2021-02-08,PAT,1148,318,830,547,63,237,301,0,0,340,808,ITH,ITH2,4,Provincia Autonoma Trento
2021-01-19,VDA,256,77,179,160,24,15,57,0,0,256,0,ITC,ITC2,2,Valle d'Aosta / Vallée d'Aoste
2021-02-07,PAB,2162,973,1189,99,397,1,1665,0,0,10,2152,ITH,ITH1,4,Provincia Autonoma Bolzano / Bozen
2021-01-08,MAR,1574,588,986,1226,348,0,0,0,0,1574,0,ITI,ITI3,11,Marche
2021-01-29,LAZ,7416,2805,4611,6203,419,704,90,0,0,472,6944,ITI,ITI4,12,Lazio
2021-02-24,FVG,2464,1065,1399,22,53,277,1822,0,290,2446,18,ITH,ITH4,6,Friuli-Venezia Giulia
2020-12-27,EMR,968,372,596,824,118,26,0,0,0,968,0,ITH,ITH5,8,Emilia-Romagna
2021-02-25,LIG,519,208,311,80,39,2,398,0,0,514,5,ITC,ITC3,7,Liguria
2021-01-20,MOL,18,8,10,14,4,0,0,0,0,18,0,ITF,ITF2,14,Molise
2021-02-08,PIE,6878,2350,4528,3776,1553,1549,0,0,0,664,6214,ITC,ITC1,1,Piemonte
2021-02-10,LOM,13658,4342,9316,7999,2641,2919,95,0,4,7288,6370,ITC,ITC4,3,Lombardia
2021-02-05,PAT,796,269,527,466,22,65,243,0,0,279,517,ITH,ITH2,4,Provincia Autonoma Trento
2021-01-14,ABR,530,189,341,364,166,0,0,0,0,530,0,ITF,ITF1,13,Abruzzo
2021-01-26,MAR,2016,746,1270,1736,194,86,0,0,0,92,1924,ITI,ITI3,11,Marche
2021-01-19,SAR,747,270,477,423,163,160,0,0,1,692,55,ITG,ITG2,20,Sardegna
2021-01-16,VEN,4565,1530,3035,3165,750,650,0,0,0,4565,0,ITH,ITH3,5,Veneto
2020-12-27,LIG,132,54,78,85,2,45,0,0,0,132,0,ITC,ITC3,7,Liguria
2021-01-28,VDA,290,123,167,194,88,6,2,0,0,56,234,ITC,ITC2,2,Valle d'Aosta / Vallée d'Aoste
2020-12-31,MAR,383,178,205,370,13,0,0,0,0,383,0,ITI,ITI3,11,Marche
2021-01-17,SIC,1295,584,711,619,516,160,0,0,0,1245,50,ITG,ITG1,19,Sicilia
2021-01-25,MOL,319,130,189,317,0,0,0,0,2,3,316,ITF,ITF2,14,Molise
2021-02-14,MAR,738,301,437,578,160,0,0,0,0,738,0,ITI,ITI3,11,Marche
2021-02-23,LOM,10922,4484,6438,3661,1503,773,3992,990,3,10623,299,ITC,ITC4,3,Lombardia
2021-01-06,TOS,4519,1459,3060,3984,10,525,0,0,0,4519,0,ITI,ITI1,9,Toscana
2021-01-18,CAL,1230,550,680,982,237,11,0,0,0,1040,190,ITF,ITF6,18,Calabria
2020-12-30,SIC,173,101,72,156,17,0,0,0,0,173,0,ITG,ITG1,19,Sicilia
2021-02-11,LAZ,6656,2787,3869,2196,333,500,3627,0,0,6458,198,ITI,ITI4,12,Lazio
2021-02-11,FVG,1915,660,1255,1128,562,222,3,0,0,1723,192,ITH,ITH4,6,Friuli-Venezia Giulia
2021-02-07,UMB,54,17,37,46,8,0,0,0,0,1,53,ITI,ITI2,10,Umbria
2021-02-22,PIE,6640,2639,4001,1681,856,494,3609,0,0,6096,544,ITC,ITC1,1,Piemonte
2021-01-13,LOM,25557,7875,17682,11984,9664,3592,307,10,0,25557,0,ITC,ITC4,3,Lombardia
2020-12-29,SIC,235,146,89,235,0,0,0,0,0,235,0,ITG,ITG1,19,Sicilia
2021-02-21,BAS,206,86,120,14,2,11,178,0,1,206,0,ITF,ITF5,17,Basilicata
2021-01-28,CAL,2232,1107,1125,1920,312,0,0,0,0,84,2148,ITF,ITF6,18,Calabria
2020-12-28,LIG,75,26,49,72,3,0,0,0,0,75,0,ITC,ITC3,7,Liguria
2021-02-25,BAS,271,107,164,53,5,0,213,0,0,228,43,ITF,ITF5,17,Basilicata
2021-02-05,PUG,5611,2263,3348,4556,520,526,0,3,6,1315,4296,ITF,ITF4,16,Puglia
2021-01-29,UMB,1221,343,878,934,16,271,0,0,0,79,1142,ITI,ITI2,10,Umbria
2021-02-12,MOL,329,149,180,223,32,72,0,0,2,207,122,ITF,ITF2,14,Molise
2021-01-05,PAB,820,283,537,718,102,0,0,0,0,820,0,ITH,ITH1,4,Provincia Autonoma Bolzano / Bozen
2021-02-13,VDA,215,195,20,0,54,0,0,161,0,215,0,ITC,ITC2,2,Valle d'Aosta / Vallée d'Aoste
2021-01-17,PAT,251,195,56,251,0,0,0,0,0,251,0,ITH,ITH2,4,Provincia Autonoma Trento
2021-01-21,PAB,915,426,489,719,101,68,27,0,0,138,777,ITH,ITH1,4,Provincia Autonoma Bolzano / Bozen
2020-12-27,PAB,143,65,78,136,6,0,1,0,0,143,0,ITH,ITH1,4,Provincia Autonoma Bolzano / Bozen
2021-02-14,VDA,48,16,32,6,0,42,0,0,0,1,47,ITC,ITC2,2,Valle d'Aosta / Vallée d'Aoste
2021-01-12,TOS,3581,1398,2183,2944,283,354,0,0,0,3581,0,ITI,ITI1,9,Toscana
2021-01-27,VDA,151,71,80,53,27,18,53,0,0,79,72,ITC,ITC2,2,Valle d'Aosta / Vallée d'Aoste
2021-02-06,PUG,4394,1882,2512,3429,485,478,0,0,2,1559,2835,ITF,ITF4,16,Puglia
2021-02-24,VEN,7855,3388,4467,1200,549,244,5599,256,7,7536,319,ITH,ITH3,5,Veneto
2021-02-07,TOS,2806,953,1853,2349,300,157,0,0,0,885,1921,ITI,ITI1,9,Toscana
2021-01-05,EMR,9324,3163,6161,7874,686,764,0,0,0,9324,0,ITH,ITH5,8,Emilia-Romagna
2021-02-04,PAT,970,302,668,542,15,89,324,0,0,419,551,ITH,ITH2,4,Provincia Autonoma Trento
2021-01-01,LAZ,3553,1381,2172,3483,2,68,0,0,0,3553,0,ITI,ITI4,12,Lazio
2021-02-09,SIC,4365,1830,2535,2235,1490,640,0,0,0,3360,1005,ITG,ITG1,19,Sicilia
2021-02-07,SAR,1116,394,722,975,141,0,0,0,0,227,889,ITG,ITG2,20,Sardegna
2021-01-01,TOS,2368,786,1582,1716,2,650,0,0,0,2368,0,ITI,ITI1,9,Toscana
2021-01-05,TOS,5244,1755,3489,4354,11,879,0,0,0,5244,0,ITI,ITI1,9,Toscana
2021-02-03,VDA,349,114,235,157,141,50,1,0,0,14,335,ITC,ITC2,2,Valle d'Aosta / Vallée d'Aoste
2021-01-26,VDA,139,48,91,115,12,12,0,0,0,0,139,ITC,ITC2,2,Valle d'Aosta / Vallée d'Aoste
2021-02-13,CAM,5498,2543,2955,948,807,131,3610,0,2,5280,218,ITF,ITF3,15,Campania
2020-12-31,SAR,32,16,16,28,4,0,0,0,0,32,0,ITG,ITG2,20,Sardegna
2021-01-12,LAZ,5391,1974,3417,4343,464,584,0,0,0,5391,0,ITI,ITI4,12,Lazio
2021-02-01,SAR,1524,605,919,894,553,77,0,0,0,225,1299,ITG,ITG2,20,Sardegna
2021-01-24,LIG,749,232,517,626,63,60,0,0,0,113,636,ITC,ITC3,7,Liguria
2021-02-17,FVG,2292,948,1344,327,194,228,1541,2,0,1814,478,ITH,ITH4,6,Friuli-Venezia Giulia
2021-01-23,LAZ,6883,2682,4201,6063,278,417,125,0,0,255,6628,ITI,ITI4,12,Lazio
2021-02-22,BAS,1425,623,802,126,84,2,1213,0,0,1373,52,ITF,ITF5,17,Basilicata
2021-01-04,SAR,591,217,374,565,26,0,0,0,0,591,0,ITG,ITG2,20,Sardegna
2021-02-12,VDA,245,94,151,51,45,13,131,0,5,215,30,ITC,ITC2,2,Valle d'Aosta / Vallée d'Aoste
2021-01-24,CAM,4128,2123,2005,3140,822,166,0,0,0,383,3745,ITF,ITF3,15,Campania
2021-01-02,EMR,2347,903,1444,2071,79,197,0,0,0,2347,0,ITH,ITH5,8,Emilia-Romagna
2021-01-17,PUG,1295,586,709,819,147,329,0,0,0,1226,69,ITF,ITF4,16,Puglia
2021-01-07,MOL,598,209,389,414,39,145,0,0,0,598,0,ITF,ITF2,14,Molise
2021-01-23,FVG,816,324,492,768,48,0,0,0,0,4,812,ITH,ITH4,6,Friuli-Venezia Giulia
2021-01-20,EMR,1321,269,1052,391,143,787,0,0,0,1320,1,ITH,ITH5,8,Emilia-Romagna
2021-02-04,PUG,5812,2338,3474,4388,810,607,0,0,7,1157,4655,ITF,ITF4,16,Puglia
2021-01-08,TOS,5944,1641,4303,5360,39,545,0,0,0,5944,0,ITI,ITI1,9,Toscana
2021-02-21,PIE,3741,1627,2114,612,189,47,2893,0,0,3640,101,ITC,ITC1,1,Piemonte
2021-01-16,LAZ,5339,2069,3270,3347,460,1062,470,0,0,5339,0,ITI,ITI4,12,Lazio
2021-02-22,SIC,8033,4158,3875,1107,933,554,4065,1053,321,7542,491,ITG,ITG1,19,Sicilia
2021-02-08,TOS,4094,1358,2736,3372,345,377,0,0,0,3635,459,ITI,ITI1,9,Toscana
2021-02-05,SIC,7101,3156,3945,3528,2720,853,0,0,0,2126,4975,ITG,ITG1,19,Sicilia
2021-02-13,MAR,1062,453,609,457,515,90,0,0,0,1010,52,ITI,ITI3,11,Marche
2021-01-30,TOS,4620,1622,2998,3763,219,638,0,0,0,197,4423,ITI,ITI1,9,Toscana
2021-01-10,LOM,10510,3955,6555,6864,3619,8,17,2,0,10510,0,ITC,ITC4,3,Lombardia
2021-01-25,VDA,147,65,82,125,16,6,0,0,0,0,147,ITC,ITC2,2,Valle d'Aosta / Vallée d'Aoste
2021-01-11,MOL,557,194,363,196,250,111,0,0,0,557,0,ITF,ITF2,14,Molise
2021-02-25,ABR,839,367,472,243,123,5,455,12,1,565,274,ITF,ITF1,13,Abruzzo
2021-02-10,ABR,947,312,635,621,210,116,0,0,0,503,444,ITF,ITF1,13,Abruzzo
2021-02-08,BAS,552,190,362,431,72,47,0,0,2,148,404,ITF,ITF5,17,Basilicata
2021-02-16,FVG,2502,1129,1373,260,273,220,1749,0,0,2387,115,ITH,ITH4,6,Friuli-Venezia Giulia
2021-01-18,SAR,904,326,578,714,190,0,0,0,0,780,124,ITG,ITG2,20,Sardegna
2021-01-26,ABR,1542,567,975,1513,29,0,0,0,0,29,1513,ITF,ITF1,13,Abruzzo
2021-01-17,VEN,1932,780,1152,1587,220,120,3,0,2,1583,349,ITH,ITH3,5,Veneto
2021-01-16,MAR,2006,723,1283,1059,662,285,0,0,0,2006,0,ITI,ITI3,11,Marche
2021-01-25,LOM,7012,2365,4647,5504,1318,180,10,0,0,480,6532,ITC,ITC4,3,Lombardia
2021-02-12,LOM,12928,4066,8862,7270,3051,2562,45,0,0,8438,4490,ITC,ITC4,3,Lombardia
2021-01-02,CAM,3674,1963,1711,3167,507,0,0,0,0,3674,0,ITF,ITF3,15,Campania
2021-01-30,PAB,492,243,249,213,178,101,0,0,0,4,488,ITH,ITH1,4,Provincia Autonoma Bolzano / Bozen
2021-02-15,LAZ,7708,3370,4338,2443,661,378,4218,8,0,7411,297,ITI,ITI4,12,Lazio
2021-01-07,EMR,10204,3381,6823,8174,962,1068,0,0,0,10204,0,ITH,ITH5,8,Emilia-Romagna
2021-02-01,MAR,1360,479,881,1053,226,81,0,0,0,98,1262,ITI,ITI3,11,Marche
2021-01-16,PAT,318,147,171,303,1,14,0,0,0,318,0,ITH,ITH2,4,Provincia Autonoma Trento
2021-01-03,CAL,6,3,3,4,2,0,0,0,0,6,0,ITF,ITF6,18,Calabria
2021-02-14,CAL,371,145,226,146,142,83,0,0,0,341,30,ITF,ITF6,18,Calabria
2021-02-14,LIG,224,119,105,29,30,105,60,0,0,224,0,ITC,ITC3,7,Liguria
2021-01-24,UMB,254,104,150,254,0,0,0,0,0,1,253,ITI,ITI2,10,Umbria
2021-01-12,SIC,4542,2234,2308,2863,1484,195,0,0,0,4542,0,ITG,ITG1,19,Sicilia
2021-01-20,CAM,1257,650,607,395,761,101,0,0,0,1257,0,ITF,ITF3,15,Campania
2021-01-27,LOM,8027,2675,5352,6101,1722,202,2,0,0,820,7207,ITC,ITC4,3,Lombardia
2021-02-23,PAB,760,319,441,0,62,0,620,0,78,757,3,ITH,ITH1,4,Provincia Autonoma Bolzano / Bozen
2021-02-22,PAT,668,243,425,94,25,69,480,0,0,585,83,ITH,ITH2,4,Provincia Autonoma Trento
2021-01-30,UMB,1577,483,1094,841,18,717,1,0,0,44,1533,ITI,ITI2,10,Umbria
2021-01-21,LAZ,5223,2099,3124,4758,108,232,125,0,0,196,5027,ITI,ITI4,12,Lazio
2021-02-13,LOM,6232,2385,3847,3840,1745,631,16,0,0,4919,1313,ITC,ITC4,3,Lombardia
2021-01-31,CAM,8067,3711,4356,5107,2893,67,0,0,0,23,8044,ITF,ITF3,15,Campania
2021-01-21,SAR,126,60,66,60,66,0,0,0,0,94,32,ITG,ITG2,20,Sardegna
2021-01-09,FVG,2517,841,1676,1519,405,593,0,0,0,2517,0,ITH,ITH4,6,Friuli-Venezia Giulia
2021-02-06,LOM,14604,5358,9246,9247,3496,1791,70,0,0,881,13723,ITC,ITC4,3,Lombardia
2021-02-18,PAT,1146,417,729,292,45,35,770,0,4,1083,63,ITH,ITH2,4,Provincia Autonoma Trento
2021-01-21,UMB,610,202,408,428,13,169,0,0,0,341,269,ITI,ITI2,10,Umbria
2021-02-03,SAR,1118,418,700,918,181,19,0,0,0,426,692,ITG,ITG2,20,Sardegna
2021-01-30,SAR,3862,1392,2470,2987,874,0,1,0,0,362,3500,ITG,ITG2,20,Sardegna
2021-02-23,EMR,8168,3203,4965,407,317,108,7335,0,1,7787,381,ITH,ITH5,8,Emilia-Romagna
2021-01-29,TOS,6136,1698,4438,5375,139,622,0,0,0,302,5834,ITI,ITI1,9,Toscana
2021-01-05,SIC,10527,5159,5368,9074,1246,207,0,0,0,10527,0,ITG,ITG1,19,Sicilia
2021-01-10,ABR,1139,409,730,1091,48,0,0,0,0,1139,0,ITF,ITF1,13,Abruzzo
2021-02-15,FVG,2442,908,1534,696,401,314,1031,0,0,2192,250,ITH,ITH4,6,Friuli-Venezia Giulia
2021-01-28,EMR,10219,3333,6886,8065,1031,1123,0,0,0,351,9868,ITH,ITH5,8,Emilia-Romagna
2021-01-27,CAM,7732,3817,3915,5833,1629,270,0,0,0,161,7571,ITF,ITF3,15,Campania
2021-02-20,ABR,4654,1798,2856,303,561,150,1347,406,1887,4578,76,ITF,ITF1,13,Abruzzo
2021-02-11,MOL,293,133,160,225,19,45,0,3,1,257,36,ITF,ITF2,14,Molise
2020-12-31,SIC,877,469,408,827,50,0,0,0,0,877,0,ITG,ITG1,19,Sicilia
2021-01-15,LAZ,6223,2465,3758,4476,604,988,155,0,0,6223,0,ITI,ITI4,12,Lazio
2021-01-29,MAR,1991,730,1261,1479,438,74,0,0,0,168,1823,ITI,ITI3,11,Marche
2021-02-12,VEN,4282,1420,2862,2697,900,677,6,2,0,3706,576,ITH,ITH3,5,Veneto
2021-01-08,SIC,8328,3864,4464,6591,1524,213,0,0,0,8328,0,ITG,ITG1,19,Sicilia
2021-02-02,LAZ,5772,2133,3639,4712,486,571,3,0,0,501,5271,ITI,ITI4,12,Lazio
2021-01-08,CAL,2109,1014,1095,1898,211,0,0,0,0,2109,0,ITF,ITF6,18,Calabria
2021-01-26,LIG,2394,775,1619,1881,257,251,0,0,5,153,2241,ITC,ITC3,7,Liguria
2021-02-01,VDA,403,127,276,268,65,70,0,0,0,87,316,ITC,ITC2,2,Valle d'Aosta / Vallée d'Aoste
2021-01-12,PIE,9989,3387,6602,6821,1996,1172,0,0,0,9989,0,ITC,ITC1,1,Piemonte
2021-01-25,VEN,6466,2074,4392,5059,500,904,1,0,2,170,6296,ITH,ITH3,5,Veneto
2021-01-24,PAB,12,10,2,1,11,0,0,0,0,0,12,ITH,ITH1,4,Provincia Autonoma Bolzano / Bozen
2021-02-18,PUG,4150,1739,2411,2514,952,679,3,0,2,3547,603,ITF,ITF4,16,Puglia
2021-01-07,VDA,275,111,164,224,46,5,0,0,0,275,0,ITC,ITC2,2,Valle d'Aosta / Vallée d'Aoste
2021-02-04,MOL,757,295,462,501,114,141,0,0,1,76,681,ITF,ITF2,14,Molise
2021-02-01,CAM,3985,1813,2172,2504,1329,152,0,0,0,110,3875,ITF,ITF3,15,Campania
2021-01-10,PIE,5207,2273,2934,3904,784,519,0,0,0,5207,0,ITC,ITC1,1,Piemonte
2021-02-09,FVG,1839,550,1289,1046,507,286,0,0,0,1552,287,ITH,ITH4,6,Friuli-Venezia Giulia
2021-02-02,BAS,365,141,224,134,129,102,0,0,0,175,190,ITF,ITF5,17,Basilicata
2021-01-11,VEN,7236,2100,5136,3499,1533,1956,247,0,1,7236,0,ITH,ITH3,5,Veneto
2020-12-27,UMB,85,45,40,67,2,16,0,0,0,85,0,ITI,ITI2,10,Umbria
2020-12-27,LAZ,139,66,73,139,0,0,0,0,0,139,0,ITI,ITI4,12,Lazio
2021-01-15,VEN,5871,1820,4051,2991,1300,1565,9,3,3,5871,0,ITH,ITH3,5,Veneto
2021-01-06,SIC,6471,3402,3069,5717,752,2,0,0,0,6471,0,ITG,ITG1,19,Sicilia
2021-01-27,LIG,1613,576,1037,1264,173,175,0,0,1,168,1445,ITC,ITC3,7,Liguria
2021-02-21,LAZ,6768,3089,3679,1241,362,51,4491,607,16,6487,281,ITI,ITI4,12,Lazio
2021-02-17,PAB,4,1,3,1,2,0,1,0,0,2,2,ITH,ITH1,4,Provincia Autonoma Bolzano / Bozen
2021-01-03,SAR,90,36,54,89,1,0,0,0,0,90,0,ITG,ITG2,20,Sardegna
2021-01-26,CAL,1805,861,944,1571,164,70,0,0,0,285,1520,ITF,ITF6,18,Calabria
2021-01-20,FVG,750,323,427,719,31,0,0,0,0,12,738,ITH,ITH4,6,Friuli-Venezia Giulia
2021-01-23,EMR,2443,868,1575,1899,114,430,0,0,0,441,2002,ITH,ITH5,8,Emilia-Romagna
2021-01-28,CAM,8831,4122,4709,6215,2269,347,0,0,0,135,8696,ITF,ITF3,15,Campania
2021-01-12,LIG,2239,823,1416,1613,246,378,0,0,2,2239,0,ITC,ITC3,7,Liguria
2021-01-03,BAS,900,344,556,789,108,0,0,0,3,900,0,ITF,ITF5,17,Basilicata
2021-01-29,SIC,9359,4320,5039,7150,1904,305,0,0,0,432,8927,ITG,ITG1,19,Sicilia
2021-02-19,PAT,849,340,509,167,60,70,552,0,0,791,58,ITH,ITH2,4,Provincia Autonoma Trento
2021-01-22,SIC,1235,625,610,1035,82,118,0,0,0,242,993,ITG,ITG1,19,Sicilia
2021-01-30,BAS,701,225,476,299,276,126,0,0,0,127,574,ITF,ITF5,17,Basilicata
2021-02-12,LAZ,6449,2635,3814,1991,423,261,3774,0,0,6372,77,ITI,ITI4,12,Lazio
2021-01-05,CAL,1350,618,732,1256,94,0,0,0,0,1350,0,ITF,ITF6,18,Calabria
2021-01-19,CAM,1095,474,621,534,390,171,0,0,0,1092,3,ITF,ITF3,15,Campania
2021-01-13,PIE,10041,3214,6827,6458,2255,1328,0,0,0,10041,0,ITC,ITC1,1,Piemonte
2021-01-19,PAT,403,77,326,363,4,36,0,0,0,403,0,ITH,ITH2,4,Provincia Autonoma Trento
2021-02-05,ABR,1534,520,1014,1187,241,106,0,0,0,787,747,ITF,ITF1,13,Abruzzo
2021-01-17,UMB,54,17,37,47,7,0,0,0,0,54,0,ITI,ITI2,10,Umbria
2021-01-18,MOL,114,48,66,97,17,0,0,0,0,114,0,ITF,ITF2,14,Molise
2021-02-02,LOM,19469,6462,13007,13164,4581,1646,78,0,0,478,18991,ITC,ITC4,3,Lombardia
2021-02-08,LIG,1803,697,1106,1183,371,242,0,0,7,299,1504,ITC,ITC3,7,Liguria
2021-02-11,VEN,3774,1149,2625,2468,632,663,9,1,1,3147,627,ITH,ITH3,5,Veneto
2021-01-25,LAZ,7761,3041,4720,7006,270,363,122,0,0,421,7340,ITI,ITI4,12,Lazio
2021-01-20,LOM,5528,1357,4171,1991,2186,1261,90,0,0,5413,115,ITC,ITC4,3,Lombardia
2021-01-05,FVG,1679,550,1129,1349,133,197,0,0,0,1679,0,ITH,ITH4,6,Friuli-Venezia Giulia
2021-02-19,TOS,8248,2927,5321,2963,1232,202,152,579,3120,7753,495,ITI,ITI1,9,Toscana
2021-02-19,PUG,4630,1939,2691,3000,1230,385,2,6,7,4237,393,ITF,ITF4,16,Puglia
2021-01-16,CAL,2394,1120,1274,1664,489,241,0,0,0,2394,0,ITF,ITF6,18,Calabria
2021-01-16,FVG,1231,360,871,771,212,248,0,0,0,1231,0,ITH,ITH4,6,Friuli-Venezia Giulia
2021-02-03,BAS,666,300,366,305,189,172,0,0,0,32,634,ITF,ITF5,17,Basilicata
2021-02-02,CAM,5722,2804,2918,3640,1728,354,0,0,0,443,5279,ITF,ITF3,15,Campania
2021-01-21,MAR,896,253,643,460,100,336,0,0,0,585,311,ITI,ITI3,11,Marche
2021-01-02,LOM,199,72,127,177,22,0,0,0,0,199,0,ITC,ITC4,3,Lombardia
2021-01-02,CAL,165,94,71,165,0,0,0,0,0,165,0,ITF,ITF6,18,Calabria
2021-01-28,PAT,530,147,383,385,38,107,0,0,0,48,482,ITH,ITH2,4,Provincia Autonoma Trento
2021-02-17,LAZ,8805,4368,4437,2282,432,499,4247,1344,1,8277,528,ITI,ITI4,12,Lazio
2021-01-16,VDA,236,80,156,127,36,22,51,0,0,236,0,ITC,ITC2,2,Valle d'Aosta / Vallée d'Aoste
2021-02-10,MOL,150,78,72,91,6,53,0,0,0,130,20,ITF,ITF2,14,Molise
2021-01-24,CAL,44,18,26,15,3,26,0,0,0,39,5,ITF,ITF6,18,Calabria
2021-01-14,EMR,8085,2572,5513,5390,1087,1606,0,2,0,8085,0,ITH,ITH5,8,Emilia-Romagna
2021-02-03,PAT,844,312,532,342,36,73,393,0,0,414,430,ITH,ITH2,4,Provincia Autonoma Trento
2021-01-30,ABR,1509,566,943,1348,114,47,0,0,0,69,1440,ITF,ITF1,13,Abruzzo
2021-01-14,VEN,7053,1924,5129,3228,1335,2473,17,0,0,7053,0,ITH,ITH3,5,Veneto
2021-02-15,MOL,144,70,74,117,12,15,0,0,0,141,3,ITF,ITF2,14,Molise
2021-01-03,PUG,2004,942,1062,1814,44,145,0,0,1,2004,0,ITF,ITF4,16,Puglia
2021-02-04,VDA,293,85,208,167,91,34,1,0,0,7,286,ITC,ITC2,2,Valle d'Aosta / Vallée d'Aoste
2021-01-12,VEN,5230,1516,3714,2250,1058,1752,168,0,2,5230,0,ITH,ITH3,5,Veneto
2021-01-04,CAM,5826,2963,2863,4850,976,0,0,0,0,5826,0,ITF,ITF3,15,Campania
2021-02-14,PUG,754,337,417,659,32,62,0,0,1,632,122,ITF,ITF4,16,Puglia
2021-01-12,PAB,1527,398,1129,299,680,475,73,0,0,1527,0,ITH,ITH1,4,Provincia Autonoma Bolzano / Bozen
2021-01-23,VEN,4063,1255,2808,3403,206,450,1,0,3,34,4029,ITH,ITH3,5,Veneto
2021-01-24,SAR,90,34,56,89,1,0,0,0,0,5,85,ITG,ITG2,20,Sardegna
2021-01-30,PIE,5977,2134,3843,4367,1115,495,0,0,0,218,5759,ITC,ITC1,1,Piemonte
2021-01-11,LOM,15976,5309,10667,10161,5163,552,100,0,0,15976,0,ITC,ITC4,3,Lombardia
2021-02-04,FVG,2730,807,1923,1722,543,465,0,0,0,36,2694,ITH,ITH4,6,Friuli-Venezia Giulia
2021-01-10,BAS,77,24,53,9,68,0,0,0,0,77,0,ITF,ITF5,17,Basilicata
2021-02-05,BAS,980,440,540,516,274,190,0,0,0,62,918,ITF,ITF5,17,Basilicata
2021-02-25,PUG,1767,856,911,384,181,79,606,275,242,1425,342,ITF,ITF4,16,Puglia
2020-12-28,CAL,6,2,4,6,0,0,0,0,0,6,0,ITF,ITF6,18,Calabria
2021-02-13,SAR,1451,561,890,732,462,252,0,0,5,1449,2,ITG,ITG2,20,Sardegna
2021-01-15,CAM,4981,2381,2600,2740,2050,191,0,0,0,4981,0,ITF,ITF3,15,Campania
2021-01-01,SIC,815,437,378,740,75,0,0,0,0,815,0,ITG,ITG1,19,Sicilia
2021-02-06,PIE,7979,2663,5316,5097,1627,1255,0,0,0,400,7579,ITC,ITC1,1,Piemonte
2021-01-03,PAT,483,158,325,409,12,62,0,0,0,483,0,ITH,ITH2,4,Provincia Autonoma Trento
2021-02-03,CAM,8899,4000,4899,4734,3450,714,1,0,0,877,8022,ITF,ITF3,15,Campania
2021-02-06,SAR,1969,697,1272,1543,286,139,0,0,1,568,1401,ITG,ITG2,20,Sardegna
2021-02-20,MOL,1017,440,577,20,939,8,50,0,0,997,20,ITF,ITF2,14,Molise
2021-02-14,PAT,246,186,60,240,6,0,0,0,0,11,235,ITH,ITH2,4,Provincia Autonoma Trento
2021-02-22,UMB,1858,777,1081,732,120,1,1005,0,0,1769,89,ITI,ITI2,10,Umbria
2021-01-04,PAT,852,223,629,481,49,322,0,0,0,852,0,ITH,ITH2,4,Provincia Autonoma Trento
2021-01-02,ABR,548,218,330,540,8,0,0,0,0,548,0,ITF,ITF1,13,Abruzzo
2021-02-11,EMR,4241,1412,2829,2468,738,719,314,0,2,3402,839,ITH,ITH5,8,Emilia-Romagna
2021-01-15,LOM,24374,7177,17197,10206,9913,3844,405,6,0,24374,0,ITC,ITC4,3,Lombardia
2021-02-01,LIG,2324,844,1480,1800,209,314,0,0,1,75,2249,ITC,ITC3,7,Liguria
2020-12-27,TOS,620,267,353,460,147,13,0,0,0,620,0,ITI,ITI1,9,Toscana
2021-01-13,BAS,915,386,529,588,178,148,0,0,1,915,0,ITF,ITF5,17,Basilicata
2021-02-06,ABR,1611,742,869,1168,371,72,0,0,0,602,1009,ITF,ITF1,13,Abruzzo
2021-01-06,FVG,709,264,445,514,195,0,0,0,0,709,0,ITH,ITH4,6,Friuli-Venezia Giulia
2021-01-31,VDA,290,90,200,231,41,18,0,0,0,58,232,ITC,ITC2,2,Valle d'Aosta / Vallée d'Aoste
2021-01-03,CAM,3837,2009,1828,3191,646,0,0,0,0,3837,0,ITF,ITF3,15,Campania
2021-02-07,PUG,1323,596,727,945,217,161,0,0,0,244,1079,ITF,ITF4,16,Puglia
2021-02-15,PAB,72,42,30,17,10,40,5,0,0,26,46,ITH,ITH1,4,Provincia Autonoma Bolzano / Bozen
2020-12-27,SIC,89,54,35,62,2,25,0,0,0,89,0,ITG,ITG1,19,Sicilia
2021-01-28,FVG,2235,792,1443,1754,287,194,0,0,0,354,1881,ITH,ITH4,6,Friuli-Venezia Giulia
2021-01-29,PAB,1488,508,980,856,331,295,2,0,4,23,1465,ITH,ITH1,4,Provincia Autonoma Bolzano / Bozen
2021-02-06,BAS,900,366,534,544,187,168,0,0,1,144,756,ITF,ITF5,17,Basilicata
2021-01-21,SIC,1328,647,681,1001,190,137,0,0,0,499,829,ITG,ITG1,19,Sicilia
2021-02-23,LAZ,10818,4650,6168,1894,595,309,5096,1014,1910,10196,622,ITI,ITI4,12,Lazio
2021-02-14,TOS,8993,2567,6426,3031,5615,81,0,261,5,8883,110,ITI,ITI1,9,Toscana
2021-01-05,PUG,5096,2244,2852,4738,250,98,5,0,5,5096,0,ITF,ITF4,16,Puglia
2021-01-20,CAL,1395,622,773,864,352,179,0,0,0,1394,1,ITF,ITF6,18,Calabria
2021-02-11,LOM,16283,4823,11460,8979,3591,3683,30,0,0,9188,7095,ITC,ITC4,3,Lombardia
2021-01-24,PIE,3150,957,2193,2632,372,146,0,0,0,434,2716,ITC,ITC1,1,Piemonte
2021-01-29,LIG,2803,978,1825,2148,297,356,0,0,2,42,2761,ITC,ITC3,7,Liguria
2021-02-08,SAR,1470,533,937,998,345,126,1,0,0,855,615,ITG,ITG2,20,Sardegna
2021-01-11,FVG,1882,609,1273,1500,336,46,0,0,0,1882,0,ITH,ITH4,6,Friuli-Venezia Giulia
2021-01-21,MOL,6,2,4,0,6,0,0,0,0,6,0,ITF,ITF2,14,Molise
2021-02-22,CAL,1996,1013,983,727,543,166,552,3,5,1441,555,ITF,ITF6,18,Calabria
2021-02-13,MOL,132,80,52,129,3,0,0,0,0,132,0,ITF,ITF2,14,Molise
2021-01-04,VDA,142,59,83,126,16,0,0,0,0,142,0,ITC,ITC2,2,Valle d'Aosta / Vallée d'Aoste
2021-01-27,MOL,674,251,423,436,28,209,0,0,1,8,666,ITF,ITF2,14,Molise
2021-02-16,LAZ,8037,3860,4177,2055,577,260,4194,950,1,7780,257,ITI,ITI4,12,Lazio
2021-02-13,BAS,665,249,416,280,197,115,71,2,0,605,60,ITF,ITF5,17,Basilicata
2021-02-15,VEN,4242,1772,2470,411,184,337,3296,13,1,4003,239,ITH,ITH3,5,Veneto
2021-01-22,LIG,1627,546,1081,967,163,497,0,0,0,1154,473,ITC,ITC3,7,Liguria
2021-02-10,EMR,3923,1350,2573,2305,589,775,254,0,0,2726,1197,ITH,ITH5,8,Emilia-Romagna
2020-12-30,PAT,6,2,4,4,1,1,0,0,0,6,0,ITH,ITH2,4,Provincia Autonoma Trento
2021-02-09,TOS,4472,1461,3011,3580,388,504,0,0,0,3864,608,ITI,ITI1,9,Toscana
2021-01-08,LAZ,7707,2887,4820,6517,392,798,0,0,0,7707,0,ITI,ITI4,12,Lazio
2021-01-26,PUG,5359,2397,2962,4846,281,232,0,0,0,574,4785,ITF,ITF4,16,Puglia
2021-02-20,SIC,4593,2441,2152,564,851,316,2244,512,106,4467,126,ITG,ITG1,19,Sicilia
2021-02-11,PAB,1016,398,618,208,362,104,342,0,0,235,781,ITH,ITH1,4,Provincia Autonoma Bolzano / Bozen
2021-01-27,EMR,8315,2933,5382,6860,800,654,0,1,0,463,7852,ITH,ITH5,8,Emilia-Romagna
2021-01-02,PIE,3539,1134,2405,3072,414,53,0,0,0,3539,0,ITC,ITC1,1,Piemonte
2020-12-30,TOS,327,104,223,34,10,283,0,0,0,327,0,ITI,ITI1,9,Toscana
2021-02-09,LAZ,8391,3483,4908,3258,581,548,4004,0,0,4570,3821,ITI,ITI4,12,Lazio
2021-01-06,LAZ,5096,1951,3145,4619,155,320,0,1,1,5096,0,ITI,ITI4,12,Lazio
2021-01-01,SAR,30,16,14,30,0,0,0,0,0,30,0,ITG,ITG2,20,Sardegna
2021-01-15,FVG,2028,606,1422,1283,370,375,0,0,0,2028,0,ITH,ITH4,6,Friuli-Venezia Giulia
2021-01-12,UMB,784,247,537,665,14,105,0,0,0,784,0,ITI,ITI2,10,Umbria
2021-02-02,ABR,1797,677,1120,1242,413,142,0,0,0,241,1556,ITF,ITF1,13,Abruzzo
2021-01-14,LOM,26160,7643,18517,11468,9519,4706,459,8,0,26160,0,ITC,ITC4,3,Lombardia
2021-02-10,PAB,1622,600,1022,484,556,1,581,0,0,26,1596,ITH,ITH1,4,Provincia Autonoma Bolzano / Bozen
2021-01-01,PAB,1,1,0,1,0,0,0,0,0,1,0,ITH,ITH1,4,Provincia Autonoma Bolzano / Bozen
2021-02-22,SAR,1619,942,677,595,403,179,2,440,0,1390,229,ITG,ITG2,20,Sardegna
2021-02-20,VEN,6112,1870,4242,1569,305,28,970,5,3235,6107,5,ITH,ITH3,5,Veneto
2021-02-20,EMR,5295,2097,3198,405,243,155,4492,0,0,5031,264,ITH,ITH5,8,Emilia-Romagna
2021-02-18,VDA,348,153,195,61,40,45,180,14,8,260,88,ITC,ITC2,2,Valle d'Aosta / Vallée d'Aoste
2021-02-19,VDA,292,102,190,17,30,35,145,0,65,268,24,ITC,ITC2,2,Valle d'Aosta / Vallée d'Aoste
2021-02-17,MAR,1787,663,1124,965,521,300,1,0,0,1668,119,ITI,ITI3,11,Marche
2021-01-26,TOS,5392,1791,3601,4357,84,951,0,0,0,219,5173,ITI,ITI1,9,Toscana
2020-12-31,LAZ,5218,2095,3123,4927,12,279,0,0,0,5218,0,ITI,ITI4,12,Lazio
2021-01-10,PUG,2345,1059,1286,2035,109,201,0,0,0,2345,0,ITF,ITF4,16,Puglia
2021-02-10,VEN,4678,1561,3117,3064,870,743,0,0,1,3643,1035,ITH,ITH3,5,Veneto
2021-01-15,CAL,2793,1258,1535,1690,691,412,0,0,0,2793,0,ITF,ITF6,18,Calabria
2021-02-15,EMR,2890,845,2045,1980,464,157,289,0,0,2765,125,ITH,ITH5,8,Emilia-Romagna
2021-01-01,UMB,269,102,167,268,1,0,0,0,0,269,0,ITI,ITI2,10,Umbria
2021-01-23,LOM,1114,357,757,500,578,36,0,0,0,916,198,ITC,ITC4,3,Lombardia
2021-02-11,UMB,841,349,492,734,99,5,0,0,3,836,5,ITI,ITI2,10,Umbria
2021-01-24,BAS,834,299,535,603,230,1,0,0,0,58,776,ITF,ITF5,17,Basilicata
2021-01-26,PAT,497,138,359,397,16,84,0,0,0,25,472,ITH,ITH2,4,Provincia Autonoma Trento
2021-01-11,ABR,1551,557,994,1337,166,48,0,0,0,1551,0,ITF,ITF1,13,Abruzzo
2021-01-13,CAM,8019,3666,4353,4351,3082,586,0,0,0,8019,0,ITF,ITF3,15,Campania
2020-12-31,TOS,805,202,603,97,10,698,0,0,0,805,0,ITI,ITI1,9,Toscana
2020-12-30,PUG,1,0,1,1,0,0,0,0,0,1,0,ITF,ITF4,16,Puglia
