data_somministrazione,area,totale,sesso_maschile,sesso_femminile,categoria_operatori_sanitari_sociosanitari,categoria_personale_non_sanitario,categoria_ospiti_rsa,categoria_over80,categoria_forze_armate,categoria_personale_scolastico,prima_dose,seconda_dose,codice_NUTS1,codice_NUTS2,codice_regione_ISTAT,nome_area
2021-01-21,PUG,2129,903,1226,1429,174,526,0,0,0,1270,859,ITF,ITF4,16,Puglia
2021-01-11,LAZ,5525,2103,3422,4553,403,569,0,0,0,5525,0,ITI,ITI4,12,Lazio
2021-01-06,EMR,8258,2939,5319,6846,761,650,0,1,0,8258,0,ITH,ITH5,8,Emilia-Romagna
2021-02-09,SAR,2286,837,1449,1308,479,497,1,0,1,1290,996,ITG,ITG2,20,Sardegna
2021-02-15,TOS,8763,3370,5393,4531,2026,215,56,795,1140,7944,819,ITI,ITI1,9,Toscana
2021-03-05,CAL,6145,3540,2605,695,1589,710,1854,1292,5,5570,575,ITF,ITF6,18,Calabria
2021-01-31,EMR,7692,2758,4934,6172,1259,261,0,0,0,242,7450,ITH,ITH5,8,Emilia-Romagna
2021-01-22,PUG,1408,578,830,876,157,373,1,0,1,991,417,ITF,ITF4,16,Puglia
2021-01-28,LIG,2788,948,1840,2189,284,309,0,1,5,38,2750,ITC,ITC3,7,Liguria
2021-03-04,TOS,16726,6299,10427,2814,1638,195,7688,696,3695,13656,3070,ITI,ITI1,9,Toscana
2021-02-16,CAM,5432,2409,3023,910,1182,169,3171,0,0,4661,771,ITF,ITF3,15,Campania
2021-02-16,PIE,3812,1603,2209,1818,1443,550,0,0,1,3054,758,ITC,ITC1,1,Piemonte
2021-02-10,PUG,3602,1425,2177,2490,247,864,0,0,1,2121,1481,ITF,ITF4,16,Puglia
2021-02-02,SIC,5537,2621,2916,3152,1956,429,0,0,0,633,4904,ITG,ITG1,19,Sicilia
2021-01-25,CAM,5744,2926,2818,4743,945,56,0,0,0,164,5580,ITF,ITF3,15,Campania
2021-02-17,LOM,11588,3649,7939,7429,2221,1857,35,37,9,10235,1353,ITC,ITC4,3,Lombardia
2021-02-25,EMR,9147,3470,5677,789,520,140,7613,0,85,8196,951,ITH,ITH5,8,Emilia-Romagna
2021-02-28,VEN,4050,1308,2742,1701,1347,15,984,0,3,3214,836,ITH,ITH3,5,Veneto
2021-02-14,PIE,1473,498,975,793,381,285,0,0,14,875,598,ITC,ITC1,1,Piemonte
2021-03-07,LAZ,12525,4870,7655,1034,1112,123,6581,684,2991,9260,3265,ITI,ITI4,12,Lazio
2021-02-27,CAM,13936,4469,9467,597,3062,78,3144,0,7055,12294,1642,ITF,ITF3,15,Campania
2021-01-26,VEN,6903,2081,4822,5309,628,962,0,1,3,155,6748,ITH,ITH3,5,Veneto
2021-02-18,CAM,9074,3810,5264,1710,1340,70,5518,0,436,8366,708,ITF,ITF3,15,Campania
2021-02-28,CAL,2167,983,1184,113,152,190,1706,6,0,2016,151,ITF,ITF6,18,Calabria
2021-02-04,VEN,7307,2012,5295,3448,1467,2378,12,0,2,556,6751,ITH,ITH3,5,Veneto
2021-01-09,PUG,4868,2246,2622,4314,303,246,4,0,1,4868,0,ITF,ITF4,16,Puglia
2020-12-27,LOM,702,407,295,551,137,13,1,0,0,702,0,ITC,ITC4,3,Lombardia
2021-02-05,MAR,2134,650,1484,1309,418,407,0,0,0,440,1694,ITI,ITI3,11,Marche
2021-02-17,CAM,7380,3205,4175,993,1082,38,4905,0,362,6320,1060,ITF,ITF3,15,Campania
2021-02-21,SAR,1584,709,875,66,32,59,1421,6,0,1554,30,ITG,ITG2,20,Sardegna
2021-03-01,ABR,3484,1389,2095,696,293,174,1911,128,282,2722,762,ITF,ITF1,13,Abruzzo
2021-01-13,LAZ,5559,2063,3496,4145,402,1009,3,0,0,5559,0,ITI,ITI4,12,Lazio
2021-01-09,PIE,6183,2185,3998,4488,1127,568,0,0,0,6183,0,ITC,ITC1,1,Piemonte
2021-02-02,EMR,9430,3031,6399,6229,1490,1630,80,0,1,496,8934,ITH,ITH5,8,Emilia-Romagna
2021-02-24,PIE,10715,4293,6422,1697,1130,388,5350,0,2150,10205,510,ITC,ITC1,1,Piemonte
2021-02-12,FVG,1197,426,771,673,394,128,2,0,0,1147,50,ITH,ITH4,6,Friuli-Venezia Giulia
2021-01-09,CAM,10566,5024,5542,6759,3538,269,0,0,0,10566,0,ITF,ITF3,15,Campania
2021-01-17,TOS,2535,871,1664,2002,293,240,0,0,0,2022,513,ITI,ITI1,9,Toscana
2021-01-31,SAR,2121,750,1371,1544,576,0,1,0,0,48,2073,ITG,ITG2,20,Sardegna
2020-12-27,ABR,37,19,18,34,1,2,0,0,0,37,0,ITF,ITF1,13,Abruzzo
2021-01-21,CAL,958,444,514,735,108,115,0,0,0,929,29,ITF,ITF6,18,Calabria
2021-02-15,PUG,3184,1238,1946,2228,520,433,0,0,3,2594,590,ITF,ITF4,16,Puglia
2021-01-07,PIE,5385,1739,3646,4158,886,341,0,0,0,5385,0,ITC,ITC1,1,Piemonte
2021-02-09,VEN,5106,1840,3266,3084,872,1130,20,0,0,3399,1707,ITH,ITH3,5,Veneto
2021-01-11,PAB,1501,476,1025,532,645,174,150,0,0,1501,0,ITH,ITH1,4,Provincia Autonoma Bolzano / Bozen
2021-03-03,BAS,1549,733,816,191,412,99,397,203,247,993,556,ITF,ITF5,17,Basilicata
2021-01-11,SIC,5903,2590,3313,3923,1598,382,0,0,0,5903,0,ITG,ITG1,19,Sicilia
2021-01-02,LIG,688,245,443,592,96,0,0,0,0,688,0,ITC,ITC3,7,Liguria
2021-03-03,ABR,2772,1173,1599,1016,312,20,1048,215,161,1956,816,ITF,ITF1,13,Abruzzo
2021-01-02,PAB,91,48,43,69,22,0,0,0,0,91,0,ITH,ITH1,4,Provincia Autonoma Bolzano / Bozen
2021-01-13,MAR,2105,746,1359,1408,621,76,0,0,0,2105,0,ITI,ITI3,11,Marche
2021-02-04,LOM,26897,7872,19025,15264,5983,5458,192,0,0,1868,25029,ITC,ITC4,3,Lombardia
2021-02-20,LOM,9383,3879,5504,4275,1117,217,2907,863,4,9090,293,ITC,ITC4,3,Lombardia
2021-02-07,LIG,406,152,254,190,29,187,0,0,0,2,404,ITC,ITC3,7,Liguria
2021-02-24,ABR,3302,1439,1863,391,340,247,1967,226,131,3126,176,ITF,ITF1,13,Abruzzo
2021-02-17,EMR,6528,2760,3768,802,1283,404,4039,0,0,5753,775,ITH,ITH5,8,Emilia-Romagna
2021-01-29,ABR,1386,449,937,1290,96,0,0,0,0,74,1312,ITF,ITF1,13,Abruzzo
2021-02-18,SAR,1875,732,1143,1072,362,297,1,33,110,1811,64,ITG,ITG2,20,Sardegna
2021-01-21,CAM,2093,1116,977,1379,639,75,0,0,0,677,1416,ITF,ITF3,15,Campania
2021-02-16,EMR,5701,2420,3281,738,904,424,3635,0,0,5173,528,ITH,ITH5,8,Emilia-Romagna
2021-01-03,LAZ,5250,1972,3278,5125,60,65,0,0,0,5250,0,ITI,ITI4,12,Lazio
2021-01-12,FVG,2257,712,1545,1525,371,361,0,0,0,2257,0,ITH,ITH4,6,Friuli-Venezia Giulia
2021-02-18,EMR,7040,2890,4150,890,534,236,5380,0,0,6458,582,ITH,ITH5,8,Emilia-Romagna
2021-02-03,LAZ,6288,2348,3940,4620,555,1078,35,0,0,901,5387,ITI,ITI4,12,Lazio
2021-03-05,PIE,14101,5452,8649,2526,1869,641,6816,0,2249,10304,3797,ITC,ITC1,1,Piemonte
2021-01-08,SAR,3257,1184,2073,2929,328,0,0,0,0,3257,0,ITG,ITG2,20,Sardegna
2021-01-21,PIE,6876,2314,4562,4705,855,1316,0,0,0,3381,3495,ITC,ITC1,1,Piemonte
2021-01-03,SIC,4693,2454,2239,4361,332,0,0,0,0,4693,0,ITG,ITG1,19,Sicilia
2021-02-27,UMB,1658,354,1304,14,11,13,0,60,1560,1642,16,ITI,ITI2,10,Umbria
2021-01-12,PAT,501,158,343,413,29,59,0,0,0,501,0,ITH,ITH2,4,Provincia Autonoma Trento
2021-02-03,SIC,6100,2856,3244,3356,2120,624,0,0,0,756,5344,ITG,ITG1,19,Sicilia
2020-12-31,LIG,972,347,625,735,55,154,28,0,0,972,0,ITC,ITC3,7,Liguria
2021-03-03,UMB,4070,1621,2449,720,285,33,1210,289,1533,3359,711,ITI,ITI2,10,Umbria
2021-02-23,PIE,8644,3409,5235,2118,1225,376,3858,0,1067,8047,597,ITC,ITC1,1,Piemonte
2021-01-26,SIC,9515,4679,4836,8379,882,254,0,0,0,265,9250,ITG,ITG1,19,Sicilia
2021-01-20,MAR,398,99,299,146,62,190,0,0,0,386,12,ITI,ITI3,11,Marche
2021-03-06,MOL,1728,807,921,156,1415,0,5,152,0,1569,159,ITF,ITF2,14,Molise
2021-02-12,BAS,774,333,441,288,272,90,118,6,0,743,31,ITF,ITF5,17,Basilicata
2021-01-10,MAR,1737,699,1038,1462,275,0,0,0,0,1737,0,ITI,ITI3,11,Marche
2021-01-01,PUG,146,60,86,145,1,0,0,0,0,146,0,ITF,ITF4,16,Puglia
2021-01-12,PUG,4202,1765,2437,3628,350,218,1,0,5,4202,0,ITF,ITF4,16,Puglia
2021-02-27,VEN,8839,2609,6230,2140,605,36,1964,12,4082,8044,795,ITH,ITH3,5,Veneto
2021-02-06,LAZ,5069,2015,3054,3270,630,660,509,0,0,769,4300,ITI,ITI4,12,Lazio
2021-02-16,LOM,9179,2994,6185,5682,2211,1252,8,7,19,8730,449,ITC,ITC4,3,Lombardia
2021-02-25,PAB,1149,409,740,1,17,0,726,0,405,1148,1,ITH,ITH1,4,Provincia Autonoma Bolzano / Bozen
2021-03-03,PAB,811,240,571,12,7,6,0,51,735,798,13,ITH,ITH1,4,Provincia Autonoma Bolzano / Bozen
2021-01-01,PAT,206,48,158,109,11,86,0,0,0,206,0,ITH,ITH2,4,Provincia Autonoma Trento
2021-01-04,LIG,2461,808,1653,2104,233,121,0,0,3,2461,0,ITC,ITC3,7,Liguria
2021-03-04,PUG,13589,5386,8203,1494,1168,226,4268,1178,5255,12318,1271,ITF,ITF4,16,Puglia
2021-02-26,PIE,11524,4503,7021,810,1219,487,6223,0,2785,10783,741,ITC,ITC1,1,Piemonte
2021-01-09,LOM,12376,4558,7818,8134,4039,192,10,1,0,12376,0,ITC,ITC4,3,Lombardia
2021-02-11,PAT,1130,364,766,331,17,48,734,0,0,796,334,ITH,ITH2,4,Provincia Autonoma Trento
2021-02-18,UMB,1495,582,913,324,16,170,985,0,0,1029,466,ITI,ITI2,10,Umbria
2021-01-19,LAZ,4360,1671,2689,2967,561,424,408,0,0,3907,453,ITI,ITI4,12,Lazio
2021-02-05,TOS,5748,2244,3504,4121,1184,442,1,0,0,1924,3824,ITI,ITI1,9,Toscana
2021-02-06,SIC,5066,2225,2841,2535,1939,592,0,0,0,1488,3578,ITG,ITG1,19,Sicilia
2021-02-17,ABR,2076,951,1125,512,241,394,718,210,1,1793,283,ITF,ITF1,13,Abruzzo
2021-01-25,PIE,6209,1938,4271,4782,865,562,0,0,0,982,5227,ITC,ITC1,1,Piemonte
2021-01-17,VDA,131,56,75,49,3,20,59,0,0,131,0,ITC,ITC2,2,Valle d'Aosta / Vall√©e d'Aoste
2021-03-05,CAM,16436,6323,10113,1641,5433,64,4983,4,4311,9784,6652,ITF,ITF3,15,Campania
2021-01-08,UMB,1173,337,836,926,9,238,0,0,0,1173,0,ITI,ITI2,10,Umbria
2021-02-26,CAM,13265,4205,9060,623,2381,169,3219,1,6872,11930,1335,ITF,ITF3,15,Campania
2021-02-27,EMR,10924,3978,6946,1719,495,114,7670,0,926,9194,1730,ITH,ITH5,8,Emilia-Romagna
2021-01-07,LOM,11556,3594,7962,8086,2802,594,72,2,0,11556,0,ITC,ITC4,3,Lombardia
2021-03-06,SAR,2532,1045,1487,1086,920,404,7,79,36,852,1680,ITG,ITG2,20,Sardegna
2021-02-24,PUG,9631,4504,5127,1863,708,116,6026,364,554,9044,587,ITF,ITF4,16,Puglia
2021-02-17,SAR,1403,575,828,688,376,312,0,27,0,1328,75,ITG,ITG2,20,Sardegna
2021-03-06,EMR,17879,5262,12617,2438,824,40,5325,514,8738,15450,2429,ITH,ITH5,8,Emilia-Romagna
2021-01-06,UMB,843,323,520,840,3,0,0,0,0,843,0,ITI,ITI2,10,Umbria
2021-01-29,CAM,10052,4812,5240,6405,3388,259,0,0,0,47,10005,ITF,ITF3,15,Campania
2021-01-29,PUG,6188,2658,3530,5464,433,288,0,0,3,436,5752,ITF,ITF4,16,Puglia
2021-03-05,ABR,5260,1936,3324,561,457,107,2581,202,1352,4563,697,ITF,ITF1,13,Abruzzo
2021-01-05,LIG,2840,886,1954,2269,303,261,0,0,7,2840,0,ITC,ITC3,7,Liguria
2021-03-02,TOS,10379,3677,6702,3167,1024,125,1799,752,3512,6944,3435,ITI,ITI1,9,Toscana
2021-02-03,MAR,2125,742,1383,1344,615,166,0,0,0,119,2006,ITI,ITI3,11,Marche
2021-01-22,EMR,1827,477,1350,940,165,722,0,0,0,1088,739,ITH,ITH5,8,Emilia-Romagna
2021-02-09,MOL,359,170,189,161,88,110,0,0,0,197,162,ITF,ITF2,14,Molise
2021-02-13,PAT,536,333,203,373,5,0,158,0,0,171,365,ITH,ITH2,4,Provincia Autonoma Trento
2021-03-03,SAR,3692,2013,1679,1050,710,491,700,740,1,2597,1095,ITG,ITG2,20,Sardegna
2021-02-26,ABR,3919,1671,2248,1025,565,160,1650,257,262,2950,969,ITF,ITF1,13,Abruzzo
2021-02-16,SAR,698,288,410,373,211,114,0,0,0,669,29,ITG,ITG2,20,Sardegna
2021-02-12,PUG,4089,1625,2464,2930,450,690,4,10,5,2999,1090,ITF,ITF4,16,Puglia
2021-01-22,LOM,2889,814,2075,1081,1658,142,6,0,2,2837,52,ITC,ITC4,3,Lombardia
2021-01-15,MAR,1771,500,1271,985,420,366,0,0,0,1771,0,ITI,ITI3,11,Marche
2021-02-27,PIE,12160,4647,7513,711,964,232,7295,0,2958,11813,347,ITC,ITC1,1,Piemonte
2021-02-16,PAB,528,205,323,10,7,0,511,0,0,528,0,ITH,ITH1,4,Provincia Autonoma Bolzano / Bozen
2021-01-12,ABR,1804,666,1138,1470,334,0,0,0,0,1804,0,ITF,ITF1,13,Abruzzo
2021-03-01,VEN,9201,3578,5623,1978,1107,850,2627,153,2486,7377,1824,ITH,ITH3,5,Veneto
2021-01-04,MAR,1500,563,937,1290,199,11,0,0,0,1500,0,ITI,ITI3,11,Marche
2021-02-12,ABR,968,319,649,438,220,310,0,0,0,779,189,ITF,ITF1,13,Abruzzo
2021-01-24,TOS,3348,1072,2276,2601,37,709,1,0,0,200,3148,ITI,ITI1,9,Toscana
2021-02-08,LOM,9686,2831,6855,5148,2196,2289,53,0,0,2062,7624,ITC,ITC4,3,Lombardia
2021-01-09,SAR,4026,1417,2609,3181,845,0,0,0,0,4026,0,ITG,ITG2,20,Sardegna
2021-01-15,LIG,2199,736,1463,1295,392,510,0,0,2,2199,0,ITC,ITC3,7,Liguria
2021-01-29,SAR,2951,1067,1884,2580,368,3,0,0,0,48,2903,ITG,ITG2,20,Sardegna
2020-12-27,CAM,720,422,298,703,17,0,0,0,0,720,0,ITF,ITF3,15,Campania
2021-02-20,FVG,2063,932,1131,11,19,148,1579,0,306,1919,144,ITH,ITH4,6,Friuli-Venezia Giulia
2021-01-28,SIC,9327,4399,4928,7463,1569,295,0,0,0,414,8913,ITG,ITG1,19,Sicilia
2021-01-29,PIE,5937,1885,4052,4196,1069,672,0,0,0,454,5483,ITC,ITC1,1,Piemonte
2021-02-08,CAL,1847,733,1114,1214,512,121,0,0,0,661,1186,ITF,ITF6,18,Calabria
2021-02-17,PIE,4536,1941,2595,2185,1852,497,1,0,1,3547,989,ITC,ITC1,1,Piemonte
2021-03-06,ABR,4172,1353,2819,432,368,52,1748,15,1557,3602,570,ITF,ITF1,13,Abruzzo
2021-01-24,LAZ,5467,2109,3358,4945,262,134,126,0,0,385,5082,ITI,ITI4,12,Lazio
2021-01-27,PUG,4338,1851,2487,3815,229,292,0,0,2,543,3795,ITF,ITF4,16,Puglia
2020-12-27,CAL,275,150,125,274,1,0,0,0,0,275,0,ITF,ITF6,18,Calabria
2021-02-08,FVG,2354,693,1661,1399,521,434,0,0,0,91,2263,ITH,ITH4,6,Friuli-Venezia Giulia
2021-03-01,PAB,736,161,575,0,56,0,0,0,680,736,0,ITH,ITH1,4,Provincia Autonoma Bolzano / Bozen
2021-01-30,VDA,436,202,234,232,192,12,0,0,0,13,423,ITC,ITC2,2,Valle d'Aosta / Vall√©e d'Aoste
2021-01-03,MAR,896,348,548,759,137,0,0,0,0,896,0,ITI,ITI3,11,Marche
2021-01-14,VDA,237,69,168,151,84,0,2,0,0,237,0,ITC,ITC2,2,Valle d'Aosta / Vall√©e d'Aoste
2021-01-22,SAR,83,47,36,45,38,0,0,0,0,55,28,ITG,ITG2,20,Sardegna
2021-01-08,MOL,429,141,288,244,65,120,0,0,0,429,0,ITF,ITF2,14,Molise
2021-01-31,MOL,268,70,198,85,18,164,0,0,1,6,262,ITF,ITF2,14,Molise
2021-01-21,BAS,30,10,20,0,30,0,0,0,0,30,0,ITF,ITF5,17,Basilicata
2021-01-10,MOL,270,72,198,82,19,169,0,0,0,270,0,ITF,ITF2,14,Molise
2021-02-21,MOL,573,227,346,1,4,0,568,0,0,571,2,ITF,ITF2,14,Molise
2021-02-15,BAS,609,227,382,185,137,40,245,2,0,568,41,ITF,ITF5,17,Basilicata
2021-02-22,LAZ,11374,4963,6411,1776,309,472,5205,1390,2222,10873,501,ITI,ITI4,12,Lazio
2021-03-04,ABR,5936,2358,3578,1170,535,93,2992,328,818,5015,921,ITF,ITF1,13,Abruzzo
2021-03-03,CAL,4863,2650,2213,631,1157,917,1367,787,4,3800,1063,ITF,ITF6,18,Calabria
2021-01-14,PAB,1808,539,1269,477,760,285,286,0,0,1808,0,ITH,ITH1,4,Provincia Autonoma Bolzano / Bozen
2021-02-09,PIE,7334,2305,5029,4149,1365,1820,0,0,0,722,6612,ITC,ITC1,1,Piemonte
2021-01-19,PUG,1222,452,770,527,117,578,0,0,0,1212,10,ITF,ITF4,16,Puglia
2021-02-07,VEN,2313,861,1452,1924,337,50,2,0,0,714,1599,ITH,ITH3,5,Veneto
2021-01-23,PAT,570,330,240,480,2,88,0,0,0,384,186,ITH,ITH2,4,Provincia Autonoma Trento
2021-02-24,LAZ,11942,5171,6771,1795,936,337,5147,1327,2400,10953,989,ITI,ITI4,12,Lazio
2020-12-30,VEN,699,245,454,598,62,39,0,0,0,699,0,ITH,ITH3,5,Veneto
2021-02-26,PAT,1207,432,775,245,28,19,809,1,105,883,324,ITH,ITH2,4,Provincia Autonoma Trento
2021-02-28,SIC,7173,3069,4104,869,1311,93,3287,254,1359,6544,629,ITG,ITG1,19,Sicilia
2021-01-17,SAR,860,277,583,747,113,0,0,0,0,859,1,ITG,ITG2,20,Sardegna
2021-02-11,SIC,5331,2103,3228,2458,1984,889,0,0,0,4867,464,ITG,ITG1,19,Sicilia
2020-12-30,LAZ,1629,629,1000,1602,0,27,0,0,0,1629,0,ITI,ITI4,12,Lazio
2021-02-04,CAL,3391,1623,1768,2560,609,222,0,0,0,644,2747,ITF,ITF6,18,Calabria
2021-01-27,PIE,4193,1452,2741,2981,655,557,0,0,0,999,3194,ITC,ITC1,1,Piemonte
2021-02-18,TOS,8773,3276,5497,2914,1511,196,214,796,3142,7916,857,ITI,ITI1,9,Toscana
2021-03-02,PUG,14791,5488,9303,1357,1281,106,4144,1064,6839,13539,1252,ITF,ITF4,16,Puglia
2021-02-24,UMB,1496,557,939,1081,43,71,292,9,0,1480,16,ITI,ITI2,10,Umbria
2021-01-14,LIG,2854,994,1860,1758,542,553,0,0,1,2854,0,ITC,ITC3,7,Liguria
2021-01-18,MAR,673,230,443,370,171,132,0,0,0,547,126,ITI,ITI3,11,Marche
2021-02-06,CAL,2908,1337,1571,2094,567,247,0,0,0,442,2466,ITF,ITF6,18,Calabria
2021-01-24,ABR,50,22,28,49,1,0,0,0,0,6,44,ITF,ITF1,13,Abruzzo
2021-02-02,PAB,1730,499,1231,617,499,605,9,0,0,7,1723,ITH,ITH1,4,Provincia Autonoma Bolzano / Bozen
2021-01-04,VEN,6726,2029,4697,5238,570,913,1,0,4,6726,0,ITH,ITH3,5,Veneto
2021-03-01,FVG,2840,998,1842,82,97,164,1544,4,949,2799,41,ITH,ITH4,6,Friuli-Venezia Giulia
2021-01-16,SAR,1492,525,967,1282,209,0,0,0,1,1492,0,ITG,ITG2,20,Sardegna
2021-02-08,PAB,1,1,0,0,1,0,0,0,0,1,0,ITH,ITH1,4,Provincia Autonoma Bolzano / Bozen
2021-02-27,MOL,1366,568,798,26,40,14,1285,0,1,1347,19,ITF,ITF2,14,Molise
2021-01-04,PUG,4503,2012,2491,4371,120,11,0,0,1,4503,0,ITF,ITF4,16,Puglia
2021-02-19,MAR,1971,716,1255,1273,492,203,1,0,2,1836,135,ITI,ITI3,11,Marche
2021-01-06,PIE,3114,1110,2004,2368,433,313,0,0,0,3114,0,ITC,ITC1,1,Piemonte
2021-01-29,FVG,2413,813,1600,1855,321,237,0,0,0,264,2149,ITH,ITH4,6,Friuli-Venezia Giulia
2021-02-16,LIG,2333,931,1402,926,412,282,711,0,2,1944,389,ITC,ITC3,7,Liguria
2021-02-18,MAR,2103,746,1357,1150,549,402,1,0,1,1816,287,ITI,ITI3,11,Marche
2021-01-21,TOS,1589,686,903,579,220,790,0,0,0,867,722,ITI,ITI1,9,Toscana
2021-01-31,ABR,1502,488,1014,1154,245,103,0,0,0,287,1215,ITF,ITF1,13,Abruzzo
2021-03-02,PAT,1273,429,844,129,47,53,900,0,144,883,390,ITH,ITH2,4,Provincia Autonoma Trento
2021-02-08,UMB,637,203,434,368,112,153,0,4,0,88,549,ITI,ITI2,10,Umbria
2021-01-17,LAZ,4555,1841,2714,3231,336,177,811,0,0,4343,212,ITI,ITI4,12,Lazio
2021-01-15,PAB,3026,1119,1907,532,898,336,1260,0,0,3026,0,ITH,ITH1,4,Provincia Autonoma Bolzano / Bozen
2021-02-05,CAL,3795,1709,2086,2327,914,554,0,0,0,488,3307,ITF,ITF6,18,Calabria
2021-01-31,LOM,9727,3754,5973,7464,2169,87,7,0,0,33,9694,ITC,ITC4,3,Lombardia
2021-02-04,SIC,6877,3159,3718,4417,1920,540,0,0,0,1460,5417,ITG,ITG1,19,Sicilia
2021-01-16,SIC,2776,1195,1581,1329,1149,298,0,0,0,2776,0,ITG,ITG1,19,Sicilia
2021-01-28,PUG,5463,2270,3193,4758,376,327,0,0,2,474,4989,ITF,ITF4,16,Puglia
2021-02-10,MAR,1439,452,987,881,343,215,0,0,0,1080,359,ITI,ITI3,11,Marche
2021-01-18,VEN,2769,782,1987,1221,541,999,8,0,0,2570,199,ITH,ITH3,5,Veneto
2021-01-14,CAM,7073,2977,4096,3707,3016,350,0,0,0,7073,0,ITF,ITF3,15,Campania
2021-01-27,ABR,1364,515,849,1301,63,0,0,0,0,39,1325,ITF,ITF1,13,Abruzzo
2021-03-03,LAZ,16936,7168,9768,2033,1374,374,7969,1249,3937,12646,4290,ITI,ITI4,12,Lazio
2021-01-29,PAB,1488,508,980,856,331,295,2,0,4,23,1465,ITH,ITH1,4,Provincia Autonoma Bolzano / Bozen
2021-01-28,FVG,2235,792,1443,1754,287,194,0,0,0,354,1881,ITH,ITH4,6,Friuli-Venezia Giulia
2021-02-06,BAS,902,367,535,546,187,168,0,0,1,146,756,ITF,ITF5,17,Basilicata
2021-01-20,CAL,1395,622,773,864,352,179,0,0,0,1394,1,ITF,ITF6,18,Calabria
2021-02-08,SAR,1470,533,937,998,345,126,1,0,0,856,614,ITG,ITG2,20,Sardegna
2021-02-11,LOM,16596,4897,11699,9070,3618,3875,33,0,0,9367,7229,ITC,ITC4,3,Lombardia
2021-03-06,MAR,3256,1378,1878,670,447,4,1439,262,434,2453,803,ITI,ITI3,11,Marche
2021-03-01,LAZ,16563,7087,9476,1542,1735,382,7919,1406,3579,12722,3841,ITI,ITI4,12,Lazio
2021-02-16,LAZ,8040,3861,4179,2057,577,261,4194,950,1,7783,257,ITI,ITI4,12,Lazio
2021-02-13,BAS,790,309,481,279,209,115,185,2,0,729,61,ITF,ITF5,17,Basilicata
2021-02-26,MOL,563,260,303,42,57,3,406,0,55,490,73,ITF,ITF2,14,Molise
2021-02-11,PAB,1047,409,638,208,392,104,343,0,0,238,809,ITH,ITH1,4,Provincia Autonoma Bolzano / Bozen
2021-01-06,LAZ,5096,1951,3145,4619,155,320,0,1,1,5096,0,ITI,ITI4,12,Lazio
2021-02-27,LIG,1852,908,944,136,544,5,1167,0,0,1723,129,ITC,ITC3,7,Liguria
2021-02-10,PAB,1630,602,1028,489,559,1,581,0,0,26,1604,ITH,ITH1,4,Provincia Autonoma Bolzano / Bozen
2021-02-20,EMR,5306,2100,3206,405,242,155,4504,0,0,5042,264,ITH,ITH5,8,Emilia-Romagna
2021-03-02,ABR,3963,1676,2287,934,439,53,1856,276,405,3279,684,ITF,ITF1,13,Abruzzo
2021-02-22,SAR,1619,942,677,595,403,179,2,440,0,1390,229,ITG,ITG2,20,Sardegna
2021-02-19,VDA,292,102,190,17,30,35,145,0,65,268,24,ITC,ITC2,2,Valle d'Aosta / Vall√©e d'Aoste
2021-03-04,SAR,3874,1886,1988,950,857,464,1089,475,39,2725,1149,ITG,ITG2,20,Sardegna
2021-01-10,PUG,2346,1060,1286,2035,109,202,0,0,0,2346,0,ITF,ITF4,16,Puglia
2021-02-15,EMR,2890,846,2044,1982,462,157,289,0,0,2764,126,ITH,ITH5,8,Emilia-Romagna
2021-03-04,PIE,13188,5132,8056,2145,1819,580,6593,0,2051,10279,2909,ITC,ITC1,1,Piemonte
2021-02-10,VEN,4700,1566,3134,3081,875,743,0,0,1,3649,1051,ITH,ITH3,5,Veneto
2021-02-11,UMB,842,349,493,735,99,5,0,0,3,837,5,ITI,ITI2,10,Umbria
2021-01-24,BAS,834,299,535,603,230,1,0,0,0,58,776,ITF,ITF5,17,Basilicata
2021-01-13,CAM,8019,3665,4354,4350,3082,587,0,0,0,8019,0,ITF,ITF3,15,Campania
2021-01-11,ABR,1551,557,994,1337,166,48,0,0,0,1551,0,ITF,ITF1,13,Abruzzo
2021-01-27,MOL,674,251,423,436,28,209,0,0,1,8,666,ITF,ITF2,14,Molise
2020-12-30,TOS,327,104,223,34,10,283,0,0,0,327,0,ITI,ITI1,9,Toscana
2021-02-18,VDA,348,153,195,61,40,45,180,14,8,260,88,ITC,ITC2,2,Valle d'Aosta / Vall√©e d'Aoste
2021-01-01,SAR,30,16,14,30,0,0,0,0,0,30,0,ITG,ITG2,20,Sardegna
2020-12-30,PUG,1,0,1,1,0,0,0,0,0,1,0,ITF,ITF4,16,Puglia
2020-12-30,PAT,6,2,4,4,1,1,0,0,0,6,0,ITH,ITH2,4,Provincia Autonoma Trento
2021-01-03,CAM,3837,2009,1828,3191,646,0,0,0,0,3837,0,ITF,ITF3,15,Campania
2021-02-07,PUG,1333,599,734,951,220,162,0,0,0,246,1087,ITF,ITF4,16,Puglia
2021-02-15,PAB,72,42,30,17,10,40,5,0,0,26,46,ITH,ITH1,4,Provincia Autonoma Bolzano / Bozen
2021-02-14,TOS,8994,2568,6426,3033,5614,81,0,261,5,8884,110,ITI,ITI1,9,Toscana
2021-02-23,LAZ,10861,4668,6193,1896,598,309,5133,1015,1910,10237,624,ITI,ITI4,12,Lazio
2021-01-21,SIC,1328,647,681,1001,190,137,0,0,0,499,829,ITG,ITG1,19,Sicilia
2021-01-05,PUG,5096,2244,2852,4739,250,98,5,0,4,5096,0,ITF,ITF4,16,Puglia
2021-01-11,FVG,1882,609,1273,1500,336,46,0,0,0,1882,0,ITH,ITH4,6,Friuli-Venezia Giulia
2021-01-24,PIE,3150,957,2193,2632,372,146,0,0,0,434,2716,ITC,ITC1,1,Piemonte
2021-01-29,LIG,2947,1023,1924,2232,301,412,0,0,2,62,2885,ITC,ITC3,7,Liguria
2021-02-22,CAL,1996,1013,983,727,543,166,552,3,5,1441,555,ITF,ITF6,18,Calabria
2021-02-13,MOL,132,80,52,129,3,0,0,0,0,132,0,ITF,ITF2,14,Molise
2021-02-15,VEN,4262,1780,2482,415,184,340,3309,13,1,4021,241,ITH,ITH3,5,Veneto
2021-02-10,EMR,3933,1353,2580,2330,573,775,255,0,0,2733,1200,ITH,ITH5,8,Emilia-Romagna
2021-01-22,LIG,1786,593,1193,1038,183,565,0,0,0,1308,478,ITC,ITC3,7,Liguria
2021-02-25,VDA,201,101,100,6,157,11,0,25,2,194,7,ITC,ITC2,2,Valle d'Aosta / Vall√©e d'Aoste
2021-02-09,TOS,4483,1468,3015,3581,388,513,1,0,0,3872,611,ITI,ITI1,9,Toscana
2021-02-03,LOM,25041,7769,17272,15126,5867,3909,139,0,0,1013,24028,ITC,ITC4,3,Lombardia
2021-02-26,EMR,7528,2852,4676,1007,625,217,5386,0,293,6493,1035,ITH,ITH5,8,Emilia-Romagna
2021-03-04,CAL,5381,3104,2277,646,1413,731,1540,1049,2,4585,796,ITF,ITF6,18,Calabria
2021-03-05,PAB,646,184,462,324,315,0,6,1,0,223,423,ITH,ITH1,4,Provincia Autonoma Bolzano / Bozen
2021-01-21,VEN,2290,719,1571,1985,162,141,0,0,2,21,2269,ITH,ITH3,5,Veneto
2021-01-08,PAT,1442,312,1130,764,152,526,0,0,0,1442,0,ITH,ITH2,4,Provincia Autonoma Trento
2021-02-22,FVG,2484,1192,1292,430,325,115,1363,246,5,2066,418,ITH,ITH4,6,Friuli-Venezia Giulia
2021-03-05,SAR,4684,2285,2399,1627,1325,567,564,591,10,2574,2110,ITG,ITG2,20,Sardegna
2021-02-20,MAR,4123,1706,2417,118,411,261,3330,3,0,4012,111,ITI,ITI3,11,Marche
2021-01-31,CAL,1107,554,553,764,285,58,0,0,0,155,952,ITF,ITF6,18,Calabria
2021-01-05,BAS,946,409,537,736,210,0,0,0,0,946,0,ITF,ITF5,17,Basilicata
2021-01-04,ABR,1401,575,826,1396,5,0,0,0,0,1401,0,ITF,ITF1,13,Abruzzo
2021-01-27,BAS,410,174,236,151,233,26,0,0,0,113,297,ITF,ITF5,17,Basilicata
2021-02-20,CAM,8562,3079,5483,1014,857,145,4581,0,1965,8259,303,ITF,ITF3,15,Campania
2021-01-03,LOM,852,316,536,710,137,4,1,0,0,852,0,ITC,ITC4,3,Lombardia
2021-02-24,TOS,10152,4337,5815,80,1567,263,4069,1225,2948,9956,196,ITI,ITI1,9,Toscana
2021-01-13,EMR,9062,2938,6124,6005,1312,1744,0,0,1,9062,0,ITH,ITH5,8,Emilia-Romagna
2021-02-28,FVG,2668,988,1680,234,163,0,405,378,1488,2273,395,ITH,ITH4,6,Friuli-Venezia Giulia
2021-02-07,LAZ,4668,1865,2803,3251,385,218,813,0,1,382,4286,ITI,ITI4,12,Lazio
2021-02-09,PAT,913,287,626,446,13,73,381,0,0,441,472,ITH,ITH2,4,Provincia Autonoma Trento
2021-02-15,SIC,3944,1859,2085,1695,1343,563,10,307,26,3380,564,ITG,ITG1,19,Sicilia
2021-01-03,VEN,5157,1563,3594,4596,311,249,0,0,1,5157,0,ITH,ITH3,5,Veneto
2021-02-10,CAM,6905,3421,3484,1945,2714,88,2158,0,0,6740,165,ITF,ITF3,15,Campania
2021-01-04,LOM,5977,2058,3919,4599,1197,166,15,0,0,5977,0,ITC,ITC4,3,Lombardia
2020-12-31,PUG,1634,782,852,1549,38,44,0,0,3,1634,0,ITF,ITF4,16,Puglia
2021-01-20,PIE,6539,2068,4471,3571,1154,1814,0,0,0,5813,726,ITC,ITC1,1,Piemonte
2021-02-03,VEN,5933,1658,4275,2852,1336,1742,1,0,2,483,5450,ITH,ITH3,5,Veneto
2021-02-12,CAL,1711,669,1042,815,760,136,0,0,0,943,768,ITF,ITF6,18,Calabria
2021-02-19,SIC,5133,2736,2397,1482,1349,599,74,1390,239,4565,568,ITG,ITG1,19,Sicilia
2021-01-11,SAR,1182,505,677,656,526,0,0,0,0,1182,0,ITG,ITG2,20,Sardegna
2021-01-18,PUG,1844,770,1074,1182,216,446,0,0,0,1495,349,ITF,ITF4,16,Puglia
2021-02-06,EMR,7515,2375,5140,5358,946,1172,39,0,0,2109,5406,ITH,ITH5,8,Emilia-Romagna
2021-02-17,TOS,8172,3168,5004,3465,1173,249,215,584,2486,7421,751,ITI,ITI1,9,Toscana
2021-01-28,LOM,12152,3682,8470,8958,2322,839,33,0,0,775,11377,ITC,ITC4,3,Lombardia
2021-01-06,PUG,3772,1610,2162,3175,321,276,0,0,0,3772,0,ITF,ITF4,16,Puglia
2021-02-25,FVG,2989,1543,1446,21,128,189,1551,361,739,2964,25,ITH,ITH4,6,Friuli-Venezia Giulia
2021-01-25,SAR,588,212,376,553,35,0,0,0,0,22,566,ITG,ITG2,20,Sardegna
2021-01-09,UMB,1719,492,1227,888,10,821,0,0,0,1719,0,ITI,ITI2,10,Umbria
2021-02-08,LAZ,9334,3868,5466,3788,874,918,3754,0,0,4487,4847,ITI,ITI4,12,Lazio
2021-02-18,SIC,5484,3164,2320,1635,1236,813,9,1695,96,5053,431,ITG,ITG1,19,Sicilia
2021-01-02,BAS,948,379,569,851,94,0,0,0,3,948,0,ITF,ITF5,17,Basilicata
2021-02-24,MAR,3439,1506,1933,226,234,165,2810,3,1,3360,79,ITI,ITI3,11,Marche
2021-01-05,PIE,5377,1602,3775,4364,728,285,0,0,0,5377,0,ITC,ITC1,1,Piemonte
2021-01-09,LAZ,6288,2556,3732,5110,558,620,0,0,0,6288,0,ITI,ITI4,12,Lazio
2021-02-05,MOL,593,269,324,460,70,63,0,0,0,55,538,ITF,ITF2,14,Molise
2021-03-01,PAT,1235,453,782,73,26,10,1028,3,95,937,298,ITH,ITH2,4,Provincia Autonoma Trento
2021-02-20,VDA,249,209,40,6,51,7,2,174,9,240,9,ITC,ITC2,2,Valle d'Aosta / Vall√©e d'Aoste
2021-03-06,PAT,534,216,318,324,16,0,194,0,0,382,152,ITH,ITH2,4,Provincia Autonoma Trento
2021-01-15,UMB,692,212,480,588,44,60,0,0,0,692,0,ITI,ITI2,10,Umbria
2021-01-20,BAS,84,22,62,0,84,0,0,0,0,84,0,ITF,ITF5,17,Basilicata
2020-12-30,MAR,17,5,12,14,3,0,0,0,0,17,0,ITI,ITI3,11,Marche
2021-01-30,VEN,8728,2666,6062,6201,1292,1218,4,12,1,686,8042,ITH,ITH3,5,Veneto
2021-02-01,UMB,1260,333,927,876,32,352,0,0,0,47,1213,ITI,ITI2,10,Umbria
2021-02-01,PIE,8640,3053,5587,6163,1403,1074,0,0,0,578,8062,ITC,ITC1,1,Piemonte
2021-01-04,PAB,469,191,278,397,72,0,0,0,0,469,0,ITH,ITH1,4,Provincia Autonoma Bolzano / Bozen
2021-02-28,LOM,7751,3204,4547,1061,2253,76,4248,82,31,7536,215,ITC,ITC4,3,Lombardia
2021-01-30,CAL,2173,1147,1026,1974,199,0,0,0,0,358,1815,ITF,ITF6,18,Calabria
2021-02-23,MOL,527,202,325,136,42,8,340,0,1,362,165,ITF,ITF2,14,Molise
2021-01-27,LAZ,5768,2170,3598,4797,385,457,129,0,0,651,5117,ITI,ITI4,12,Lazio
2021-02-28,MAR,2835,1250,1585,19,18,0,2794,2,2,2829,6,ITI,ITI3,11,Marche
2021-01-04,TOS,5063,1893,3170,4099,32,932,0,0,0,5063,0,ITI,ITI1,9,Toscana
2021-02-19,PIE,5355,2011,3344,1981,1605,663,30,0,1076,4837,518,ITC,ITC1,1,Piemonte
2021-01-25,UMB,647,322,325,645,2,0,0,0,0,5,642,ITI,ITI2,10,Umbria
2021-03-03,TOS,17459,6134,11325,3318,1154,100,8723,718,3446,13896,3563,ITI,ITI1,9,Toscana
2021-01-17,EMR,2889,887,2002,1913,425,547,0,0,4,2643,246,ITH,ITH5,8,Emilia-Romagna
2021-01-24,PUG,1639,738,901,1271,226,141,1,0,0,123,1516,ITF,ITF4,16,Puglia
2021-02-17,SIC,5426,3290,2136,1527,1126,880,8,1883,2,4754,672,ITG,ITG1,19,Sicilia
2021-01-07,LIG,3111,1056,2055,2261,417,428,0,1,4,3111,0,ITC,ITC3,7,Liguria
2021-02-15,LOM,8558,3006,5552,5630,1953,968,4,1,2,8138,420,ITC,ITC4,3,Lombardia
2021-01-14,PAT,696,201,495,477,11,208,0,0,0,696,0,ITH,ITH2,4,Provincia Autonoma Trento
2021-01-12,CAM,5214,2563,2651,3439,1435,340,0,0,0,5214,0,ITF,ITF3,15,Campania
2020-12-31,EMR,2205,776,1429,1675,203,327,0,0,0,2205,0,ITH,ITH5,8,Emilia-Romagna
2021-01-12,CAL,2058,1017,1041,1706,323,29,0,0,0,2058,0,ITF,ITF6,18,Calabria
2021-01-08,LIG,2873,976,1897,2034,403,431,0,1,4,2873,0,ITC,ITC3,7,Liguria
2021-01-17,ABR,187,59,128,136,51,0,0,0,0,180,7,ITF,ITF1,13,Abruzzo
2021-02-05,PIE,9449,3077,6372,5764,2041,1644,0,0,0,657,8792,ITC,ITC1,1,Piemonte
2021-02-10,LAZ,7772,3112,4660,2646,580,633,3913,0,0,4837,2935,ITI,ITI4,12,Lazio
2021-02-19,CAM,9554,3557,5997,1647,1128,161,4453,0,2165,8904,650,ITF,ITF3,15,Campania
2021-01-30,PAT,383,130,253,345,7,31,0,0,0,151,232,ITH,ITH2,4,Provincia Autonoma Trento
2021-03-05,PAT,1550,579,971,77,99,10,882,151,331,994,556,ITH,ITH2,4,Provincia Autonoma Trento
2021-01-31,LAZ,4279,1783,2496,3572,339,244,124,0,0,296,3983,ITI,ITI4,12,Lazio
2021-02-20,TOS,4640,1790,2850,3349,1038,203,17,15,18,4127,513,ITI,ITI1,9,Toscana
2021-02-28,ABR,1705,510,1195,23,34,0,79,149,1420,1703,2,ITF,ITF1,13,Abruzzo
2021-01-11,UMB,1271,336,935,878,20,373,0,0,0,1271,0,ITI,ITI2,10,Umbria
2021-02-18,LOM,13721,4826,8895,5951,1945,1552,3403,857,13,12723,998,ITC,ITC4,3,Lombardia
2021-01-07,PAB,892,317,575,613,227,0,52,0,0,892,0,ITH,ITH1,4,Provincia Autonoma Bolzano / Bozen
2021-01-13,MOL,474,160,314,256,73,144,0,0,1,474,0,ITF,ITF2,14,Molise
2021-01-02,VEN,5740,1765,3975,4796,398,544,2,0,0,5740,0,ITH,ITH3,5,Veneto
2021-01-26,BAS,794,350,444,481,278,35,0,0,0,102,692,ITF,ITF5,17,Basilicata
2021-01-24,FVG,305,119,186,277,27,1,0,0,0,1,304,ITH,ITH4,6,Friuli-Venezia Giulia
2021-02-20,PAB,1502,471,1031,196,83,24,469,1,729,1484,18,ITH,ITH1,4,Provincia Autonoma Bolzano / Bozen
2021-01-02,UMB,301,110,191,301,0,0,0,0,0,301,0,ITI,ITI2,10,Umbria
2020-12-31,LOM,713,300,413,656,57,0,0,0,0,713,0,ITC,ITC4,3,Lombardia
2021-03-07,MOL,911,413,498,1,910,0,0,0,0,909,2,ITF,ITF2,14,Molise
2021-03-05,PUG,14706,5928,8778,2087,1120,272,4794,931,5502,12737,1969,ITF,ITF4,16,Puglia
2021-01-08,LOM,12590,3893,8697,8634,3704,218,32,2,0,12590,0,ITC,ITC4,3,Lombardia
2021-01-30,PUG,5523,2511,3012,4747,348,419,3,0,6,412,5111,ITF,ITF4,16,Puglia
2021-02-21,LOM,5003,1850,3153,1736,1010,32,2182,40,3,4983,20,ITC,ITC4,3,Lombardia
2021-01-19,TOS,1104,531,573,392,221,491,0,0,0,1104,0,ITI,ITI1,9,Toscana
2021-02-13,LAZ,6272,2435,3837,2123,213,280,3656,0,0,6184,88,ITI,ITI4,12,Lazio
2021-01-31,BAS,77,24,53,75,2,0,0,0,0,0,77,ITF,ITF5,17,Basilicata
2021-02-20,PIE,3691,1219,2472,1035,1050,218,30,0,1358,3516,175,ITC,ITC1,1,Piemonte
2021-02-20,UMB,282,100,182,83,8,39,152,0,0,258,24,ITI,ITI2,10,Umbria
2021-01-01,CAM,919,506,413,831,88,0,0,0,0,919,0,ITF,ITF3,15,Campania
2021-02-27,SAR,1914,643,1271,1062,379,303,170,0,0,1359,555,ITG,ITG2,20,Sardegna
2021-01-16,MOL,420,166,254,270,23,127,0,0,0,420,0,ITF,ITF2,14,Molise
2021-01-25,ABR,1604,633,971,1584,20,0,0,0,0,20,1584,ITF,ITF1,13,Abruzzo
2021-02-05,LAZ,6910,2722,4188,5095,631,995,189,0,0,1131,5779,ITI,ITI4,12,Lazio
2021-02-11,TOS,5370,2009,3361,2808,2218,323,0,10,11,5128,242,ITI,ITI1,9,Toscana
2021-01-08,PAB,1487,469,1018,759,466,166,96,0,0,1487,0,ITH,ITH1,4,Provincia Autonoma Bolzano / Bozen
2021-01-07,CAM,8910,4166,4744,6313,2265,332,0,0,0,8910,0,ITF,ITF3,15,Campania
2021-02-02,TOS,3741,1475,2266,3020,287,422,6,6,0,194,3547,ITI,ITI1,9,Toscana
2021-02-11,PUG,3602,1371,2231,2542,388,669,0,0,3,2331,1271,ITF,ITF4,16,Puglia
2021-01-25,PUG,3820,1676,2144,3470,179,168,2,0,1,423,3397,ITF,ITF4,16,Puglia
2021-02-19,PAB,1633,392,1241,121,249,73,7,0,1183,1622,11,ITH,ITH1,4,Provincia Autonoma Bolzano / Bozen
2021-02-07,MAR,1870,734,1136,1156,668,46,0,0,0,344,1526,ITI,ITI3,11,Marche
2021-03-03,PIE,11026,4077,6949,1035,784,258,6262,0,2687,10173,853,ITC,ITC1,1,Piemonte
2021-02-04,SAR,2271,816,1455,1737,363,170,1,0,0,916,1355,ITG,ITG2,20,Sardegna
2021-02-20,CAL,1358,735,623,438,411,55,433,19,2,1043,315,ITF,ITF6,18,Calabria
2021-01-09,EMR,9873,3424,6449,7824,1169,880,0,0,0,9873,0,ITH,ITH5,8,Emilia-Romagna
2021-02-23,UMB,1693,658,1035,1187,95,17,394,0,0,1650,43,ITI,ITI2,10,Umbria
2021-02-27,ABR,2808,1337,1471,253,185,123,732,642,873,2542,266,ITF,ITF1,13,Abruzzo
2021-02-01,CAL,2496,1192,1304,2044,409,43,0,0,0,248,2248,ITF,ITF6,18,Calabria
2021-02-18,VEN,5661,2432,3229,941,359,553,3803,0,5,5594,67,ITH,ITH3,5,Veneto
2021-01-08,EMR,10808,3555,7253,8454,1274,1080,0,0,0,10808,0,ITH,ITH5,8,Emilia-Romagna
2021-01-19,SIC,1271,521,750,521,512,238,0,0,0,1093,178,ITG,ITG1,19,Sicilia
2021-02-24,EMR,9262,3540,5722,624,596,216,7763,0,63,8408,854,ITH,ITH5,8,Emilia-Romagna
2021-01-06,MOL,689,260,429,456,62,171,0,0,0,689,0,ITF,ITF2,14,Molise
2021-01-01,PIE,1038,395,643,922,116,0,0,0,0,1038,0,ITC,ITC1,1,Piemonte
2021-01-17,FVG,1720,524,1196,674,560,486,0,0,0,1720,0,ITH,ITH4,6,Friuli-Venezia Giulia
2021-03-03,MOL,672,316,356,63,389,48,0,45,127,590,82,ITF,ITF2,14,Molise
2020-12-31,UMB,322,127,195,310,12,0,0,0,0,322,0,ITI,ITI2,10,Umbria
2021-02-18,PAB,1639,400,1239,23,314,20,3,0,1279,1635,4,ITH,ITH1,4,Provincia Autonoma Bolzano / Bozen
2021-02-21,LIG,861,487,374,180,317,97,267,0,0,857,4,ITC,ITC3,7,Liguria
2020-12-31,PAB,867,497,370,440,427,0,0,0,0,867,0,ITH,ITH1,4,Provincia Autonoma Bolzano / Bozen
2021-02-10,VDA,239,75,164,51,25,18,126,1,18,132,107,ITC,ITC2,2,Valle d'Aosta / Vall√©e d'Aoste
2021-03-04,LIG,4357,1971,2386,840,301,200,2730,282,4,3649,708,ITC,ITC3,7,Liguria
2021-01-16,MAR,2006,723,1283,1059,662,285,0,0,0,2006,0,ITI,ITI3,11,Marche
2021-02-12,LOM,13132,4111,9021,7384,3084,2619,45,0,0,8577,4555,ITC,ITC4,3,Lombardia
2021-01-25,LOM,7014,2367,4647,5506,1318,180,10,0,0,480,6534,ITC,ITC4,3,Lombardia
2021-01-02,CAM,3674,1963,1711,3167,507,0,0,0,0,3674,0,ITF,ITF3,15,Campania
2021-01-30,PAB,496,244,252,216,179,101,0,0,0,4,492,ITH,ITH1,4,Provincia Autonoma Bolzano / Bozen
2021-01-07,EMR,10206,3381,6825,8179,959,1068,0,0,0,10206,0,ITH,ITH5,8,Emilia-Romagna
2021-01-16,PAT,318,147,171,303,1,14,0,0,0,318,0,ITH,ITH2,4,Provincia Autonoma Trento
2021-02-14,LIG,224,118,106,28,30,106,60,0,0,224,0,ITC,ITC3,7,Liguria
2021-02-14,CAL,371,145,226,146,142,83,0,0,0,341,30,ITF,ITF6,18,Calabria
2021-01-20,CAM,1257,650,607,395,761,101,0,0,0,1257,0,ITF,ITF3,15,Campania
2021-01-27,LOM,8028,2675,5353,6102,1722,202,2,0,0,820,7208,ITC,ITC4,3,Lombardia
2021-02-22,PAT,732,254,478,118,16,69,486,0,43,649,83,ITH,ITH2,4,Provincia Autonoma Trento
2021-01-30,UMB,1577,483,1094,841,18,717,1,0,0,44,1533,ITI,ITI2,10,Umbria
2021-02-06,LOM,14698,5376,9322,9302,3505,1820,71,0,0,881,13817,ITC,ITC4,3,Lombardia
2021-01-09,FVG,2518,841,1677,1519,406,593,0,0,0,2518,0,ITH,ITH4,6,Friuli-Venezia Giulia
2021-02-23,EMR,8186,3210,4976,407,317,111,7350,0,1,7802,384,ITH,ITH5,8,Emilia-Romagna
2021-01-29,TOS,6136,1698,4438,5375,139,622,0,0,0,302,5834,ITI,ITI1,9,Toscana
2021-01-10,ABR,1139,409,730,1091,48,0,0,0,0,1139,0,ITF,ITF1,13,Abruzzo
2021-01-27,CAM,7735,3819,3916,5836,1629,270,0,0,0,161,7574,ITF,ITF3,15,Campania
2021-03-07,PIE,9430,3722,5708,1085,884,82,5868,0,1511,8606,824,ITC,ITC1,1,Piemonte
2021-01-17,LOM,8086,3275,4811,5106,2771,159,45,5,0,7888,198,ITC,ITC4,3,Lombardia
2021-03-04,PAB,1320,675,645,301,359,27,39,389,205,1092,228,ITH,ITH1,4,Provincia Autonoma Bolzano / Bozen
2021-01-11,CAM,4071,1871,2200,2385,1434,252,0,0,0,4071,0,ITF,ITF3,15,Campania
2021-02-08,EMR,5176,1517,3659,2826,693,1478,178,0,1,2281,2895,ITH,ITH5,8,Emilia-Romagna
2021-02-05,FVG,2613,784,1829,1613,510,490,0,0,0,90,2523,ITH,ITH4,6,Friuli-Venezia Giulia
2021-01-14,PIE,9761,3150,6611,6175,2102,1484,0,0,0,9761,0,ITC,ITC1,1,Piemonte
2021-03-04,VEN,12410,4605,7805,3021,1715,1144,3407,306,2817,9130,3280,ITH,ITH3,5,Veneto
2021-03-01,MAR,3725,1487,2238,387,177,82,2788,5,286,3478,247,ITI,ITI3,11,Marche
2021-02-15,CAL,1137,538,599,499,412,159,66,0,1,989,148,ITF,ITF6,18,Calabria
2021-01-23,PIE,4219,1321,2898,3190,523,506,0,0,0,878,3341,ITC,ITC1,1,Piemonte
2021-02-08,SIC,4086,1759,2327,2346,1343,397,0,0,0,2128,1958,ITG,ITG1,19,Sicilia
2021-03-02,BAS,793,381,412,110,78,5,185,201,214,658,135,ITF,ITF5,17,Basilicata
2021-02-04,MAR,2338,807,1531,1405,658,275,0,0,0,112,2226,ITI,ITI3,11,Marche
2021-01-20,PUG,1468,524,944,706,165,597,0,0,0,1460,8,ITF,ITF4,16,Puglia
2021-01-14,BAS,969,413,556,423,223,323,0,0,0,969,0,ITF,ITF5,17,Basilicata
2021-01-18,BAS,463,157,306,364,54,45,0,0,0,364,99,ITF,ITF5,17,Basilicata
2021-01-07,SIC,9173,4239,4934,7694,1269,210,0,0,0,9173,0,ITG,ITG1,19,Sicilia
2021-01-24,LOM,1184,453,731,798,361,24,1,0,0,522,662,ITC,ITC4,3,Lombardia
2021-02-10,SAR,1958,765,1193,1168,301,488,0,0,1,1440,518,ITG,ITG2,20,Sardegna
2021-01-02,PUG,2945,1297,1648,2826,92,23,0,0,4,2945,0,ITF,ITF4,16,Puglia
2021-03-04,LOM,26394,10944,15450,6679,6253,1942,9338,1806,376,17939,8455,ITC,ITC4,3,Lombardia
2021-01-11,PUG,3749,1587,2162,3212,357,175,0,3,2,3749,0,ITF,ITF4,16,Puglia
2021-02-21,PUG,2146,465,1681,536,90,47,29,12,1432,2085,61,ITF,ITF4,16,Puglia
2021-02-18,LAZ,9666,4797,4869,2160,415,473,4952,1665,1,9168,498,ITI,ITI4,12,Lazio
2021-02-03,CAL,2763,1428,1335,2170,490,103,0,0,0,583,2180,ITF,ITF6,18,Calabria
2021-02-11,BAS,948,398,550,200,171,107,466,4,0,865,83,ITF,ITF5,17,Basilicata
2021-01-16,TOS,3271,1046,2225,2493,538,240,0,0,0,3271,0,ITI,ITI1,9,Toscana
2021-01-01,VEN,1525,470,1055,1494,30,1,0,0,0,1525,0,ITH,ITH3,5,Veneto
2021-02-28,TOS,1648,667,981,1110,202,78,0,249,9,921,727,ITI,ITI1,9,Toscana
2021-01-16,PUG,2501,1032,1469,1680,305,515,0,0,1,2501,0,ITF,ITF4,16,Puglia
2021-02-22,EMR,7452,3078,4374,385,231,129,6707,0,0,7189,263,ITH,ITH5,8,Emilia-Romagna
2021-02-02,PUG,4274,1814,2460,3590,383,298,0,0,3,545,3729,ITF,ITF4,16,Puglia
2021-02-13,LIG,1073,504,569,542,132,145,254,0,0,798,275,ITC,ITC3,7,Liguria
2021-02-09,MAR,125,42,83,78,21,26,0,0,0,47,78,ITI,ITI3,11,Marche
2021-01-30,FVG,2271,744,1527,1475,354,442,0,0,0,270,2001,ITH,ITH4,6,Friuli-Venezia Giulia
2021-02-11,PIE,6738,2085,4653,3418,1307,2010,0,0,3,2980,3758,ITC,ITC1,1,Piemonte
2021-02-19,LAZ,9668,4881,4787,2167,389,408,5034,1636,34,9171,497,ITI,ITI4,12,Lazio
2021-02-03,FVG,2646,790,1856,1701,558,386,1,0,0,23,2623,ITH,ITH4,6,Friuli-Venezia Giulia
2021-01-13,CAL,2028,1022,1006,1800,194,34,0,0,0,2028,0,ITF,ITF6,18,Calabria
2021-02-22,PAB,517,141,376,336,167,0,4,0,10,510,7,ITH,ITH1,4,Provincia Autonoma Bolzano / Bozen
2021-03-07,BAS,274,112,162,14,9,0,231,5,15,273,1,ITF,ITF5,17,Basilicata
2021-01-29,MOL,421,136,285,227,82,109,0,0,3,6,415,ITF,ITF2,14,Molise
2021-01-27,UMB,838,329,509,837,1,0,0,0,0,13,825,ITI,ITI2,10,Umbria
2021-02-13,PAB,318,79,239,126,184,7,1,0,0,312,6,ITH,ITH1,4,Provincia Autonoma Bolzano / Bozen
2021-03-01,VDA,181,66,115,19,15,29,116,2,0,147,34,ITC,ITC2,2,Valle d'Aosta / Vall√©e d'Aoste
2021-01-08,VDA,299,130,169,240,43,16,0,0,0,299,0,ITC,ITC2,2,Valle d'Aosta / Vall√©e d'Aoste
2021-01-03,FVG,312,122,190,285,26,1,0,0,0,312,0,ITH,ITH4,6,Friuli-Venezia Giulia
2021-01-05,VDA,150,54,96,127,12,11,0,0,0,150,0,ITC,ITC2,2,Valle d'Aosta / Vall√©e d'Aoste
2021-02-07,CAL,859,428,431,566,212,81,0,0,0,147,712,ITF,ITF6,18,Calabria
2021-02-24,LIG,3705,1535,2170,777,266,150,2511,0,1,3449,256,ITC,ITC3,7,Liguria
2021-02-08,VEN,4964,1537,3427,2775,1007,1169,12,0,1,1930,3034,ITH,ITH3,5,Veneto
2021-01-22,ABR,118,57,61,2,4,112,0,0,0,118,0,ITF,ITF1,13,Abruzzo
2021-02-16,VEN,6672,2885,3787,726,383,513,5049,1,0,6496,176,ITH,ITH3,5,Veneto
2021-02-24,CAL,1843,940,903,658,366,115,653,47,4,1368,475,ITF,ITF6,18,Calabria
2021-02-22,VDA,316,94,222,62,41,37,103,6,67,213,103,ITC,ITC2,2,Valle d'Aosta / Vall√©e d'Aoste
2021-01-28,LAZ,7954,2998,4956,6810,496,514,134,0,0,459,7495,ITI,ITI4,12,Lazio
2021-01-22,VEN,1080,332,748,946,77,57,0,0,0,26,1054,ITH,ITH3,5,Veneto
2021-01-29,CAL,2048,984,1064,1752,247,49,0,0,0,234,1814,ITF,ITF6,18,Calabria
2021-02-17,VEN,6005,2765,3240,406,278,363,4953,5,0,5911,94,ITH,ITH3,5,Veneto
2021-02-12,PAT,986,333,653,334,61,55,536,0,0,565,421,ITH,ITH2,4,Provincia Autonoma Trento
2021-01-22,CAL,656,274,382,298,248,110,0,0,0,654,2,ITF,ITF6,18,Calabria
2021-03-05,BAS,1511,712,799,300,221,74,352,254,310,995,516,ITF,ITF5,17,Basilicata
2021-03-06,UMB,3138,788,2350,422,244,25,5,120,2322,3011,127,ITI,ITI2,10,Umbria
2021-03-04,VDA,291,139,152,55,58,2,160,14,2,42,249,ITC,ITC2,2,Valle d'Aosta / Vall√©e d'Aoste
2021-01-27,FVG,1269,425,844,849,356,64,0,0,0,447,822,ITH,ITH4,6,Friuli-Venezia Giulia
2021-03-06,VEN,10355,4201,6154,2890,2718,1417,1973,42,1315,7220,3135,ITH,ITH3,5,Veneto
2021-02-05,VDA,294,102,192,159,82,0,53,0,0,101,193,ITC,ITC2,2,Valle d'Aosta / Vall√©e d'Aoste
2021-01-30,LAZ,6649,2730,3919,5298,574,651,126,0,0,448,6201,ITI,ITI4,12,Lazio
2021-01-18,FVG,1960,607,1353,1358,492,110,0,0,0,1866,94,ITH,ITH4,6,Friuli-Venezia Giulia
2021-01-13,VDA,337,110,227,166,143,28,0,0,0,337,0,ITC,ITC2,2,Valle d'Aosta / Vall√©e d'Aoste
2021-02-16,UMB,1307,655,652,33,12,0,1262,0,0,1298,9,ITI,ITI2,10,Umbria
2021-02-13,ABR,841,380,461,545,224,72,0,0,0,437,404,ITF,ITF1,13,Abruzzo
2021-01-20,LIG,1431,519,912,674,329,426,0,0,2,1419,12,ITC,ITC3,7,Liguria
2021-01-29,VEN,8995,2780,6215,6035,1522,1434,3,1,0,367,8628,ITH,ITH3,5,Veneto
2021-03-01,SAR,2160,1054,1106,1135,444,142,104,334,1,1501,659,ITG,ITG2,20,Sardegna
2021-01-27,CAL,1457,734,723,1226,208,23,0,0,0,396,1061,ITF,ITF6,18,Calabria
2021-03-01,PIE,10841,4238,6603,1117,1038,279,6180,0,2227,10027,814,ITC,ITC1,1,Piemonte
2021-01-27,PAT,734,257,477,395,34,304,1,0,0,73,661,ITH,ITH2,4,Provincia Autonoma Trento
2021-01-25,BAS,1020,427,593,673,346,1,0,0,0,74,946,ITF,ITF5,17,Basilicata
2021-01-29,PAT,1349,331,1018,722,86,541,0,0,0,54,1295,ITH,ITH2,4,Provincia Autonoma Trento
2021-02-02,LIG,2613,976,1637,1920,227,464,0,0,2,196,2417,ITC,ITC3,7,Liguria
2021-01-23,TOS,3949,1354,2595,2936,172,841,0,0,0,640,3309,ITI,ITI1,9,Toscana
2021-01-19,MAR,225,81,144,120,20,85,0,0,0,141,84,ITI,ITI3,11,Marche
2021-01-07,BAS,640,319,321,353,258,29,0,0,0,640,0,ITF,ITF5,17,Basilicata
2021-02-18,MOL,319,74,245,296,23,0,0,0,0,306,13,ITF,ITF2,14,Molise
2021-01-06,LIG,1640,605,1035,1210,250,113,64,0,3,1640,0,ITC,ITC3,7,Liguria
2021-01-02,SIC,4872,2533,2339,4311,561,0,0,0,0,4872,0,ITG,ITG1,19,Sicilia
2021-02-13,PUG,3705,1448,2257,2868,517,291,4,18,7,3013,692,ITF,ITF4,16,Puglia
2021-03-03,VEN,11744,4432,7312,3240,1546,1043,3379,303,2233,8303,3441,ITH,ITH3,5,Veneto
2021-01-26,MOL,450,184,266,444,5,0,0,0,1,8,442,ITF,ITF2,14,Molise
2021-02-17,UMB,1618,748,870,363,14,0,1240,0,1,1267,351,ITI,ITI2,10,Umbria
2021-02-14,SIC,1057,402,655,433,388,236,0,0,0,917,140,ITG,ITG1,19,Sicilia
2021-02-23,BAS,1818,734,1084,159,46,35,1578,0,0,1680,138,ITF,ITF5,17,Basilicata
2021-01-24,MAR,890,341,549,772,118,0,0,0,0,17,873,ITI,ITI3,11,Marche
2021-02-26,BAS,2127,893,1234,89,104,1,1933,0,0,2044,83,ITF,ITF5,17,Basilicata
2021-02-28,MOL,828,331,497,38,763,27,0,0,0,786,42,ITF,ITF2,14,Molise
2021-01-10,LIG,644,259,385,366,102,176,0,0,0,644,0,ITC,ITC3,7,Liguria
2021-02-01,FVG,2093,687,1406,1587,371,135,0,0,0,14,2079,ITH,ITH4,6,Friuli-Venezia Giulia
2021-01-06,PAB,59,18,41,59,0,0,0,0,0,59,0,ITH,ITH1,4,Provincia Autonoma Bolzano / Bozen
2021-01-14,TOS,3254,1179,2075,2459,475,320,0,0,0,3254,0,ITI,ITI1,9,Toscana
2021-02-13,FVG,562,175,387,334,228,0,0,0,0,556,6,ITH,ITH4,6,Friuli-Venezia Giulia
2021-03-07,UMB,781,165,616,16,82,21,0,0,662,781,0,ITI,ITI2,10,Umbria
2021-02-10,UMB,715,349,366,606,106,3,0,0,0,700,15,ITI,ITI2,10,Umbria
2021-01-05,VEN,7327,2183,5144,5410,790,1122,0,1,4,7327,0,ITH,ITH3,5,Veneto
2021-01-30,SIC,7837,3569,4268,5450,1912,475,0,0,0,175,7662,ITG,ITG1,19,Sicilia
2021-03-03,FVG,3552,1561,1991,748,553,100,1319,416,416,2277,1275,ITH,ITH4,6,Friuli-Venezia Giulia
2021-02-14,LAZ,5535,2245,3290,1645,318,127,3445,0,0,5286,249,ITI,ITI4,12,Lazio
2020-12-27,PUG,506,249,257,401,42,63,0,0,0,506,0,ITF,ITF4,16,Puglia
2021-01-14,SIC,5250,2514,2736,3046,1945,259,0,0,0,5250,0,ITG,ITG1,19,Sicilia
2021-03-02,CAM,12739,4550,8189,1263,4352,147,1937,2,5038,8400,4339,ITF,ITF3,15,Campania
2021-01-17,PIE,3518,1168,2350,2083,595,840,0,0,0,2870,648,ITC,ITC1,1,Piemonte
2021-01-06,CAL,926,500,426,822,104,0,0,0,0,926,0,ITF,ITF6,18,Calabria
2021-01-26,PIE,6326,1878,4448,4723,875,728,0,0,0,734,5592,ITC,ITC1,1,Piemonte
2021-03-06,FVG,2627,906,1721,180,196,1,1551,1,698,2301,326,ITH,ITH4,6,Friuli-Venezia Giulia
2020-12-27,FVG,262,149,113,259,3,0,0,0,0,262,0,ITH,ITH4,6,Friuli-Venezia Giulia
2021-01-20,VEN,1039,368,671,696,130,213,0,0,0,387,652,ITH,ITH3,5,Veneto
2021-03-06,LOM,17951,7649,10302,4657,4827,390,6130,944,1003,13482,4469,ITC,ITC4,3,Lombardia
2021-01-10,TOS,3001,1104,1897,2432,138,431,0,0,0,3001,0,ITI,ITI1,9,Toscana
2021-01-18,LOM,8964,2920,6044,4090,3284,1470,116,4,0,7982,982,ITC,ITC4,3,Lombardia
2021-01-05,LOM,7672,2513,5159,5711,1786,167,8,0,0,7672,0,ITC,ITC4,3,Lombardia
2021-02-02,FVG,2465,806,1659,1656,393,416,0,0,0,217,2248,ITH,ITH4,6,Friuli-Venezia Giulia
2020-12-27,PAT,103,40,63,76,6,21,0,0,0,103,0,ITH,ITH2,4,Provincia Autonoma Trento
2021-01-19,EMR,2039,502,1537,745,135,1159,0,0,0,2022,17,ITH,ITH5,8,Emilia-Romagna
2021-01-18,EMR,3125,879,2246,1681,316,1128,0,0,0,2448,677,ITH,ITH5,8,Emilia-Romagna
2021-01-23,CAM,3839,2029,1810,3161,609,69,0,0,0,273,3566,ITF,ITF3,15,Campania
2021-01-27,VEN,7141,2064,5077,5203,1057,879,0,0,2,247,6894,ITH,ITH3,5,Veneto
2021-01-16,ABR,927,428,499,710,202,15,0,0,0,927,0,ITF,ITF1,13,Abruzzo
2021-01-24,SIC,4335,2262,2073,3990,342,3,0,0,0,148,4187,ITG,ITG1,19,Sicilia
2021-01-26,UMB,814,390,424,813,1,0,0,0,0,18,796,ITI,ITI2,10,Umbria
2021-03-01,CAL,2684,1529,1155,399,422,257,971,632,3,2234,450,ITF,ITF6,18,Calabria
2021-02-22,LOM,11490,4667,6823,4053,1499,920,4025,965,28,11184,306,ITC,ITC4,3,Lombardia
2021-02-02,SAR,1482,655,827,988,494,0,0,0,0,241,1241,ITG,ITG2,20,Sardegna
2021-02-22,MAR,3412,1498,1914,325,408,77,2595,5,2,3338,74,ITI,ITI3,11,Marche
2021-01-22,UMB,276,105,171,273,1,2,0,0,0,32,244,ITI,ITI2,10,Umbria
2021-01-20,SAR,210,77,133,154,56,0,0,0,0,208,2,ITG,ITG2,20,Sardegna
2021-01-15,PAT,590,130,460,459,21,110,0,0,0,590,0,ITH,ITH2,4,Provincia Autonoma Trento
2021-01-31,UMB,1056,276,780,765,10,281,0,0,0,25,1031,ITI,ITI2,10,Umbria
2021-01-05,SAR,1327,446,881,1283,44,0,0,0,0,1327,0,ITG,ITG2,20,Sardegna
2021-01-03,UMB,267,111,156,267,0,0,0,0,0,267,0,ITI,ITI2,10,Umbria
2021-02-11,MAR,1988,658,1330,1155,621,212,0,0,0,1599,389,ITI,ITI3,11,Marche
2021-02-07,MOL,66,32,34,49,1,16,0,0,0,19,47,ITF,ITF2,14,Molise
2021-02-17,MOL,72,32,40,47,19,6,0,0,0,57,15,ITF,ITF2,14,Molise
2021-02-12,UMB,671,224,447,459,208,1,1,0,2,665,6,ITI,ITI2,10,Umbria
2021-01-12,VDA,302,72,230,242,49,11,0,0,0,302,0,ITC,ITC2,2,Valle d'Aosta / Vall√©e d'Aoste
2021-03-02,PAB,681,193,488,1,1,0,0,7,672,681,0,ITH,ITH1,4,Provincia Autonoma Bolzano / Bozen
2021-02-16,MOL,156,70,86,148,8,0,0,0,0,150,6,ITF,ITF2,14,Molise
2020-12-27,SAR,65,34,31,65,0,0,0,0,0,65,0,ITG,ITG2,20,Sardegna
2021-02-06,FVG,1153,337,816,755,207,191,0,0,0,22,1131,ITH,ITH4,6,Friuli-Venezia Giulia
2021-01-20,TOS,1314,635,679,432,256,626,0,0,0,1077,237,ITI,ITI1,9,Toscana
2021-02-24,MOL,666,278,388,242,105,44,274,0,1,333,333,ITF,ITF2,14,Molise
2021-03-04,BAS,1754,839,915,217,241,64,725,263,244,962,792,ITF,ITF5,17,Basilicata
2021-01-13,SIC,5204,2462,2742,3033,1730,441,0,0,0,5204,0,ITG,ITG1,19,Sicilia
2021-02-10,PIE,7441,2344,5097,3846,1497,2098,0,0,0,1315,6126,ITC,ITC1,1,Piemonte
2021-03-05,SIC,15606,6746,8860,3188,2486,712,3994,1413,3813,11282,4324,ITG,ITG1,19,Sicilia
2021-03-04,SIC,14923,6448,8475,2811,2798,698,3927,1123,3566,10721,4202,ITG,ITG1,19,Sicilia
2021-02-06,TOS,4527,1550,2977,3725,575,227,0,0,0,1294,3233,ITI,ITI1,9,Toscana
2021-01-29,BAS,612,228,384,277,265,70,0,0,0,63,549,ITF,ITF5,17,Basilicata
2021-02-26,SAR,2789,1103,1686,1220,1068,218,204,74,5,2482,307,ITG,ITG2,20,Sardegna
2021-02-07,BAS,373,159,214,259,74,40,0,0,0,49,324,ITF,ITF5,17,Basilicata
2021-01-20,LAZ,4388,1656,2732,3277,399,426,286,0,0,2848,1540,ITI,ITI4,12,Lazio
2021-03-04,FVG,3368,1555,1813,354,249,84,1807,478,396,2739,629,ITH,ITH4,6,Friuli-Venezia Giulia
2021-03-02,LAZ,16491,7132,9359,1794,1421,229,8015,1278,3754,12562,3929,ITI,ITI4,12,Lazio
2021-02-06,PAB,2298,1025,1273,446,375,6,1470,0,1,18,2280,ITH,ITH1,4,Provincia Autonoma Bolzano / Bozen
2021-03-03,PUG,15522,6259,9263,1873,1084,153,5668,791,5953,13873,1649,ITF,ITF4,16,Puglia
2021-01-13,SAR,573,178,395,494,79,0,0,0,0,573,0,ITG,ITG2,20,Sardegna
2021-02-15,ABR,1796,831,965,625,487,221,217,246,0,1754,42,ITF,ITF1,13,Abruzzo
2021-03-05,EMR,16023,5244,10779,2826,1283,186,5746,528,5454,12944,3079,ITH,ITH5,8,Emilia-Romagna
2021-01-18,CAM,957,399,558,576,194,187,0,0,0,713,244,ITF,ITF3,15,Campania
2021-01-02,MAR,453,139,314,444,9,0,0,0,0,453,0,ITI,ITI3,11,Marche
2021-02-23,SAR,1516,1008,508,601,519,89,6,301,0,1281,235,ITG,ITG2,20,Sardegna
2021-02-19,LOM,13764,5281,8483,5371,1835,1083,4530,927,18,13127,637,ITC,ITC4,3,Lombardia
2021-02-26,TOS,9811,3639,6172,1557,1703,259,1768,961,3563,8605,1206,ITI,ITI1,9,Toscana
2021-01-10,LAZ,4039,1700,2339,3424,363,252,0,0,0,4039,0,ITI,ITI4,12,Lazio
2021-02-22,CAM,10534,3255,7279,511,2275,76,3856,0,3816,10272,262,ITF,ITF3,15,Campania
2021-01-30,EMR,10037,3508,6529,7562,1706,769,0,0,0,143,9894,ITH,ITH5,8,Emilia-Romagna
2021-01-13,PUG,4529,1724,2805,3963,334,230,0,0,2,4529,0,ITF,ITF4,16,Puglia
2021-02-03,PAB,1445,457,988,615,441,321,68,0,0,5,1440,ITH,ITH1,4,Provincia Autonoma Bolzano / Bozen
2021-02-23,PUG,9030,4281,4749,1734,468,139,5279,399,1011,8607,423,ITF,ITF4,16,Puglia
2021-02-15,MAR,973,413,560,544,428,1,0,0,0,960,13,ITI,ITI3,11,Marche
2021-01-07,FVG,2091,718,1373,1759,222,110,0,0,0,2091,0,ITH,ITH4,6,Friuli-Venezia Giulia
2021-01-19,PIE,6412,2099,4313,3576,1300,1536,0,0,0,6399,13,ITC,ITC1,1,Piemonte
2021-02-11,LIG,1848,708,1140,1131,256,455,0,0,6,1000,848,ITC,ITC3,7,Liguria
2021-01-11,EMR,9323,3266,6057,6573,1483,1267,0,0,0,9323,0,ITH,ITH5,8,Emilia-Romagna
2021-01-16,CAM,3369,1675,1694,1355,1641,373,0,0,0,3369,0,ITF,ITF3,15,Campania
2021-01-08,FVG,2322,747,1575,1680,246,396,0,0,0,2322,0,ITH,ITH4,6,Friuli-Venezia Giulia
2021-01-06,CAM,7652,3749,3903,5781,1571,300,0,0,0,7652,0,ITF,ITF3,15,Campania
2021-01-12,LOM,19686,6561,13125,10938,7210,1377,158,3,0,19686,0,ITC,ITC4,3,Lombardia
2021-02-03,TOS,4221,1452,2769,3475,240,505,1,0,0,241,3980,ITI,ITI1,9,Toscana
2021-01-22,TOS,2861,1063,1798,2022,81,758,0,0,0,525,2336,ITI,ITI1,9,Toscana
2021-01-25,EMR,6413,2128,4285,5231,504,678,0,0,0,220,6193,ITH,ITH5,8,Emilia-Romagna
2021-02-26,PAB,1048,400,648,51,136,1,846,0,14,1018,30,ITH,ITH1,4,Provincia Autonoma Bolzano / Bozen
2021-02-05,VEN,8358,2531,5827,4257,1928,2158,7,5,3,1421,6937,ITH,ITH3,5,Veneto
2021-02-12,TOS,7603,2683,4920,3741,3272,188,0,402,0,7390,213,ITI,ITI1,9,Toscana
2021-02-08,CAM,5112,2448,2664,1388,2120,226,1378,0,0,4310,802,ITF,ITF3,15,Campania
2021-03-07,PUG,3984,1564,2420,807,169,1,1460,261,1286,3455,529,ITF,ITF4,16,Puglia
2021-03-06,PAB,2775,1591,1184,386,807,7,945,255,375,2720,55,ITH,ITH1,4,Provincia Autonoma Bolzano / Bozen
2021-01-07,SAR,3111,1077,2034,2720,380,0,0,11,0,3111,0,ITG,ITG2,20,Sardegna
2021-02-25,CAL,2815,1513,1302,736,636,234,862,343,4,2236,579,ITF,ITF6,18,Calabria
2021-01-16,PIE,7756,2631,5125,4796,1590,1370,0,0,0,7756,0,ITC,ITC1,1,Piemonte
2021-02-13,PIE,4145,1333,2812,2306,721,1112,1,0,5,2921,1224,ITC,ITC1,1,Piemonte
2021-01-18,PIE,6144,2042,4102,3233,1402,1509,0,0,0,5896,248,ITC,ITC1,1,Piemonte
2021-01-03,TOS,3336,1052,2284,2565,9,762,0,0,0,3336,0,ITI,ITI1,9,Toscana
2020-12-28,SAR,65,25,40,65,0,0,0,0,0,65,0,ITG,ITG2,20,Sardegna
2021-02-24,BAS,1782,737,1045,85,28,2,1666,1,0,1713,69,ITF,ITF5,17,Basilicata
2021-02-05,UMB,780,234,546,645,51,84,0,0,0,18,762,ITI,ITI2,10,Umbria
2021-01-22,PAB,241,138,103,129,23,85,3,0,1,124,117,ITH,ITH1,4,Provincia Autonoma Bolzano / Bozen
2020-12-29,LIG,120,32,88,88,11,21,0,0,0,120,0,ITC,ITC3,7,Liguria
2021-01-14,FVG,2587,788,1799,1607,550,430,0,0,0,2587,0,ITH,ITH4,6,Friuli-Venezia Giulia
2021-01-23,ABR,263,114,149,223,14,26,0,0,0,57,206,ITF,ITF1,13,Abruzzo
2021-01-31,SIC,4111,1958,2153,2600,1216,295,0,0,0,113,3998,ITG,ITG1,19,Sicilia
2021-02-11,CAM,6275,2703,3572,1861,1922,129,2363,0,0,6209,66,ITF,ITF3,15,Campania
2021-02-13,TOS,7783,2360,5423,3665,3768,163,0,186,1,7556,227,ITI,ITI1,9,Toscana
2021-02-01,PAB,1385,404,981,706,382,296,0,0,1,11,1374,ITH,ITH1,4,Provincia Autonoma Bolzano / Bozen
2021-01-02,SAR,60,21,39,60,0,0,0,0,0,60,0,ITG,ITG2,20,Sardegna
2021-02-19,LIG,3018,1248,1770,924,590,96,1407,0,1,2843,175,ITC,ITC3,7,Liguria
2021-02-09,ABR,908,311,597,612,165,131,0,0,0,499,409,ITF,ITF1,13,Abruzzo
2021-02-27,FVG,3414,1175,2239,202,171,0,1520,25,1496,3414,0,ITH,ITH4,6,Friuli-Venezia Giulia
2021-02-02,MOL,486,155,331,295,63,128,0,0,0,163,323,ITF,ITF2,14,Molise
2021-02-01,TOS,5465,1942,3523,4441,407,617,0,0,0,521,4944,ITI,ITI1,9,Toscana
2021-03-04,PAT,2290,771,1519,155,111,23,1637,20,344,1443,847,ITH,ITH2,4,Provincia Autonoma Trento
2021-02-16,MAR,1291,475,816,736,463,92,0,0,0,1261,30,ITI,ITI3,11,Marche
2021-02-04,ABR,1681,616,1065,1168,456,57,0,0,0,609,1072,ITF,ITF1,13,Abruzzo
2021-02-25,LAZ,12572,5492,7080,1753,1209,488,5088,1423,2611,11526,1046,ITI,ITI4,12,Lazio
2021-02-10,SIC,4429,1818,2611,1975,1714,740,0,0,0,4004,425,ITG,ITG1,19,Sicilia
2021-02-09,LOM,11931,3270,8661,5617,2313,3926,75,0,0,3977,7954,ITC,ITC4,3,Lombardia
2021-02-25,TOS,10337,4120,6217,1074,1696,215,3146,1007,3199,9346,991,ITI,ITI1,9,Toscana
2021-02-07,EMR,4786,1534,3252,3685,644,444,10,0,3,1727,3059,ITH,ITH5,8,Emilia-Romagna
2021-01-23,MAR,557,190,367,440,54,63,0,0,0,123,434,ITI,ITI3,11,Marche
2021-01-26,LAZ,7602,2907,4695,6590,256,631,125,0,0,372,7230,ITI,ITI4,12,Lazio
2021-01-14,PUG,4055,1582,2473,3158,396,499,0,0,2,4055,0,ITF,ITF4,16,Puglia
2021-02-18,LIG,2712,1105,1607,903,444,349,1013,0,3,2384,328,ITC,ITC3,7,Liguria
2021-02-10,BAS,547,237,310,176,153,127,90,0,1,495,52,ITF,ITF5,17,Basilicata
2021-01-29,VDA,316,138,178,259,41,16,0,0,0,2,314,ITC,ITC2,2,Valle d'Aosta / Vall√©e d'Aoste
2021-01-21,PAT,349,93,256,318,15,16,0,0,0,227,122,ITH,ITH2,4,Provincia Autonoma Trento
2021-01-02,FVG,1217,471,746,1150,67,0,0,0,0,1217,0,ITH,ITH4,6,Friuli-Venezia Giulia
2020-12-30,LOM,113,42,71,105,8,0,0,0,0,113,0,ITC,ITC4,3,Lombardia
2021-02-24,VDA,183,82,101,30,15,13,65,53,7,164,19,ITC,ITC2,2,Valle d'Aosta / Vall√©e d'Aoste
2021-01-24,PAT,545,274,271,533,12,0,0,0,0,222,323,ITH,ITH2,4,Provincia Autonoma Trento
2021-02-18,PIE,4562,1906,2656,2236,1720,604,0,0,2,4165,397,ITC,ITC1,1,Piemonte
2021-02-02,MAR,1193,397,796,804,296,93,0,0,0,73,1120,ITI,ITI3,11,Marche
2021-01-23,UMB,277,100,177,276,1,0,0,0,0,2,275,ITI,ITI2,10,Umbria
2021-01-11,TOS,5092,1689,3403,4360,210,522,0,0,0,5092,0,ITI,ITI1,9,Toscana
2021-02-25,SIC,10141,5270,4871,1768,1700,507,3976,1525,665,8967,1174,ITG,ITG1,19,Sicilia
2021-02-15,CAM,5467,2513,2954,975,1002,94,3394,1,1,5294,173,ITF,ITF3,15,Campania
2020-12-30,PIE,730,322,408,685,45,0,0,0,0,730,0,ITC,ITC1,1,Piemonte
2021-01-04,BAS,608,272,336,534,72,0,0,0,2,608,0,ITF,ITF5,17,Basilicata
2021-01-31,FVG,2713,836,1877,1692,1003,18,0,0,0,385,2328,ITH,ITH4,6,Friuli-Venezia Giulia
2021-01-06,ABR,1830,664,1166,1546,151,133,0,0,0,1830,0,ITF,ITF1,13,Abruzzo
2021-01-04,LAZ,7477,2907,4570,7074,86,316,0,0,1,7477,0,ITI,ITI4,12,Lazio
2021-02-08,MAR,833,258,575,408,163,262,0,0,0,371,462,ITI,ITI3,11,Marche
2021-02-09,CAM,4628,2192,2436,1148,2136,6,1338,0,0,4376,252,ITF,ITF3,15,Campania
2021-02-07,CAM,2935,1385,1550,711,1708,226,290,0,0,2157,778,ITF,ITF3,15,Campania
2021-02-27,PAB,2454,758,1696,202,128,8,881,3,1232,2445,9,ITH,ITH1,4,Provincia Autonoma Bolzano / Bozen
2021-01-28,SAR,2968,1044,1924,2554,403,0,0,11,0,69,2899,ITG,ITG2,20,Sardegna
2021-01-15,EMR,7700,2392,5308,5297,1084,1318,0,0,1,7700,0,ITH,ITH5,8,Emilia-Romagna
2021-01-15,VDA,218,82,136,116,68,28,6,0,0,218,0,ITC,ITC2,2,Valle d'Aosta / Vall√©e d'Aoste
2021-02-01,LAZ,5669,2173,3496,4784,319,559,7,0,0,353,5316,ITI,ITI4,12,Lazio
2021-01-07,LAZ,7720,2892,4828,6878,276,566,0,0,0,7720,0,ITI,ITI4,12,Lazio
2021-01-25,PAB,462,177,285,380,80,0,1,0,1,3,459,ITH,ITH1,4,Provincia Autonoma Bolzano / Bozen
2021-02-16,SIC,4408,2297,2111,1462,1287,776,25,857,1,3941,467,ITG,ITG1,19,Sicilia
2021-01-13,ABR,1253,440,813,1103,150,0,0,0,0,1253,0,ITF,ITF1,13,Abruzzo
2021-02-27,MAR,3368,1439,1929,186,172,161,2842,6,1,3159,209,ITI,ITI3,11,Marche
2021-01-10,VDA,220,71,149,172,29,19,0,0,0,220,0,ITC,ITC2,2,Valle d'Aosta / Vall√©e d'Aoste
2021-02-23,LIG,3766,1546,2220,674,256,113,2719,2,2,3658,108,ITC,ITC3,7,Liguria
2021-02-01,EMR,10289,3595,6694,7446,1584,1259,0,0,0,366,9923,ITH,ITH5,8,Emilia-Romagna
2021-02-02,PAT,889,237,652,505,49,171,164,0,0,190,699,ITH,ITH2,4,Provincia Autonoma Trento
2021-01-10,FVG,2941,919,2022,1745,951,245,0,0,0,2941,0,ITH,ITH4,6,Friuli-Venezia Giulia
2021-01-06,MAR,2181,792,1389,1738,296,147,0,0,0,2181,0,ITI,ITI3,11,Marche
2021-01-13,FVG,2651,834,1817,1822,599,230,0,0,0,2651,0,ITH,ITH4,6,Friuli-Venezia Giulia
2021-03-05,MOL,1219,649,570,322,673,0,0,151,73,1015,204,ITF,ITF2,14,Molise
2021-02-04,TOS,4250,1593,2657,3166,624,455,5,0,0,960,3290,ITI,ITI1,9,Toscana
2021-01-19,CAL,1108,488,620,852,180,76,0,0,0,1098,10,ITF,ITF6,18,Calabria
2021-01-23,CAL,400,186,214,325,52,23,0,0,0,358,42,ITF,ITF6,18,Calabria
2021-01-10,CAL,929,524,405,830,99,0,0,0,0,929,0,ITF,ITF6,18,Calabria
2021-03-07,ABR,1685,415,1270,24,201,0,211,0,1249,1685,0,ITF,ITF1,13,Abruzzo
2021-02-17,LIG,2575,1133,1442,845,356,262,1111,0,1,2213,362,ITC,ITC3,7,Liguria
2021-01-23,BAS,707,299,408,484,222,1,0,0,0,33,674,ITF,ITF5,17,Basilicata
2021-01-15,PUG,4545,1859,2686,3593,388,557,0,3,4,4545,0,ITF,ITF4,16,Puglia
2021-01-31,TOS,2964,1090,1874,2381,135,448,0,0,0,103,2861,ITI,ITI1,9,Toscana
2021-03-06,LIG,3172,1792,1380,373,786,117,1426,470,0,2469,703,ITC,ITC3,7,Liguria
2021-01-25,LIG,2677,874,1803,2170,189,316,0,0,2,467,2210,ITC,ITC3,7,Liguria
2021-02-23,MAR,3271,1399,1872,219,137,116,2791,8,0,3215,56,ITI,ITI3,11,Marche
2021-01-09,SIC,7325,3424,3901,5034,1835,456,0,0,0,7325,0,ITG,ITG1,19,Sicilia
2021-01-30,LOM,12308,4565,7743,9877,2263,159,8,1,0,192,12116,ITC,ITC4,3,Lombardia
2021-02-12,PAB,703,212,491,306,286,102,7,2,0,458,245,ITH,ITH1,4,Provincia Autonoma Bolzano / Bozen
2021-03-05,MAR,6019,2734,3285,1126,796,143,2373,781,800,4552,1467,ITI,ITI3,11,Marche
2021-02-20,SAR,2036,854,1182,483,157,194,1201,0,1,1702,334,ITG,ITG2,20,Sardegna
2021-01-20,PAT,288,71,217,229,11,48,0,0,0,276,12,ITH,ITH2,4,Provincia Autonoma Trento
2021-02-22,VEN,6950,3012,3938,710,255,334,5416,1,234,6562,388,ITH,ITH3,5,Veneto
2021-01-27,PAB,84,28,56,54,30,0,0,0,0,1,83,ITH,ITH1,4,Provincia Autonoma Bolzano / Bozen
2021-03-03,MAR,6645,3002,3643,818,816,254,3132,842,783,5764,881,ITI,ITI3,11,Marche
2021-02-12,LIG,1864,668,1196,822,220,391,430,0,1,965,899,ITC,ITC3,7,Liguria
2021-02-05,LOM,24549,7138,17411,13651,6360,4282,256,0,0,2059,22490,ITC,ITC4,3,Lombardia
2021-02-15,SAR,940,338,602,429,232,279,0,0,0,909,31,ITG,ITG2,20,Sardegna
2021-01-02,PAT,498,142,356,334,25,139,0,0,0,498,0,ITH,ITH2,4,Provincia Autonoma Trento
2021-02-26,LIG,3631,1468,2163,752,200,169,2508,0,2,3302,329,ITC,ITC3,7,Liguria
2021-03-04,UMB,3854,1666,2188,849,234,4,935,366,1466,3028,826,ITI,ITI2,10,Umbria
2021-02-21,TOS,5101,2087,3014,3667,1216,195,1,13,9,4932,169,ITI,ITI1,9,Toscana
2021-02-10,CAL,2463,1074,1389,1469,637,357,0,0,0,839,1624,ITF,ITF6,18,Calabria
2021-03-02,PIE,9889,3874,6015,892,930,214,5523,0,2330,9075,814,ITC,ITC1,1,Piemonte
2021-02-13,UMB,115,28,87,68,46,0,1,0,0,112,3,ITI,ITI2,10,Umbria
2021-01-11,PAT,724,220,504,516,58,150,0,0,0,724,0,ITH,ITH2,4,Provincia Autonoma Trento
2021-02-24,PAB,1205,365,840,10,3,0,0,0,1192,1193,12,ITH,ITH1,4,Provincia Autonoma Bolzano / Bozen
2021-01-12,MOL,336,114,222,132,75,129,0,0,0,336,0,ITF,ITF2,14,Molise
2021-03-03,VDA,254,117,137,9,111,1,128,1,4,186,68,ITC,ITC2,2,Valle d'Aosta / Vall√©e d'Aoste
2021-01-06,VDA,65,33,32,29,18,18,0,0,0,65,0,ITC,ITC2,2,Valle d'Aosta / Vall√©e d'Aoste
2021-02-21,PAT,155,92,63,154,1,0,0,0,0,43,112,ITH,ITH2,4,Provincia Autonoma Trento
2020-12-31,VDA,18,4,14,16,2,0,0,0,0,18,0,ITC,ITC2,2,Valle d'Aosta / Vall√©e d'Aoste
2021-01-22,MAR,487,167,320,315,85,87,0,0,0,194,293,ITI,ITI3,11,Marche
2021-01-12,BAS,217,88,129,39,79,99,0,0,0,217,0,ITF,ITF5,17,Basilicata
2021-01-20,FVG,750,323,427,719,31,0,0,0,0,12,738,ITH,ITH4,6,Friuli-Venezia Giulia
2021-02-06,CAM,5340,2665,2675,1990,2877,458,15,0,0,2102,3238,ITF,ITF3,15,Campania
2021-01-24,EMR,2443,883,1560,2079,114,250,0,0,0,301,2142,ITH,ITH5,8,Emilia-Romagna
2021-01-09,MAR,1709,605,1104,1406,303,0,0,0,0,1709,0,ITI,ITI3,11,Marche
2021-01-03,ABR,471,185,286,464,7,0,0,0,0,471,0,ITF,ITF1,13,Abruzzo
2021-02-16,TOS,9266,3338,5928,5081,982,178,10,691,2324,8555,711,ITI,ITI1,9,Toscana
2021-02-22,MOL,265,129,136,56,139,62,8,0,0,250,15,ITF,ITF2,14,Molise
2021-02-13,VEN,3193,1455,1738,1549,621,1020,3,0,0,3178,15,ITH,ITH3,5,Veneto
2021-01-10,CAM,8166,3737,4429,5179,2890,97,0,0,0,8166,0,ITF,ITF3,15,Campania
2021-02-12,MAR,1583,618,965,815,680,88,0,0,0,1431,152,ITI,ITI3,11,Marche
2021-02-03,ABR,2061,717,1344,1541,402,118,0,0,0,419,1642,ITF,ITF1,13,Abruzzo
2021-02-12,SIC,4742,1850,2892,2297,1802,643,0,0,0,4411,331,ITG,ITG1,19,Sicilia
2021-02-07,LOM,7081,2763,4318,5028,1773,263,17,0,0,339,6742,ITC,ITC4,3,Lombardia
2021-01-27,SIC,7530,3835,3695,6328,1050,152,0,0,0,189,7341,ITG,ITG1,19,Sicilia
2020-12-31,FVG,1053,384,669,1011,42,0,0,0,0,1053,0,ITH,ITH4,6,Friuli-Venezia Giulia
2021-02-17,VDA,327,144,183,25,19,30,237,16,0,227,100,ITC,ITC2,2,Valle d'Aosta / Vall√©e d'Aoste
2021-02-27,LAZ,11343,4239,7104,1358,884,514,4764,1120,2703,10390,953,ITI,ITI4,12,Lazio
2021-03-06,VDA,22,4,18,13,0,5,4,0,0,22,0,ITC,ITC2,2,Valle d'Aosta / Vall√©e d'Aoste
2021-01-05,PAT,707,231,476,494,52,161,0,0,0,707,0,ITH,ITH2,4,Provincia Autonoma Trento
2021-03-04,EMR,15507,5096,10411,2584,1083,240,6118,511,4971,12533,2974,ITH,ITH5,8,Emilia-Romagna
2021-02-02,CAL,2289,1112,1177,1863,351,75,0,0,0,177,2112,ITF,ITF6,18,Calabria
2021-01-24,VEN,4116,1219,2897,3750,142,222,1,0,1,28,4088,ITH,ITH3,5,Veneto
2021-03-02,CAL,4131,2390,1741,705,735,427,1390,872,2,3422,709,ITF,ITF6,18,Calabria
2021-03-01,TOS,4274,1598,2676,3188,599,126,2,334,25,639,3635,ITI,ITI1,9,Toscana
2021-01-12,SAR,865,408,457,504,361,0,0,0,0,865,0,ITG,ITG2,20,Sardegna
2021-01-09,TOS,4483,1596,2887,3779,144,560,0,0,0,4483,0,ITI,ITI1,9,Toscana
2021-01-31,PUG,1806,826,980,1500,104,198,2,0,2,74,1732,ITF,ITF4,16,Puglia
2021-01-28,ABR,1433,495,938,1370,62,1,0,0,0,12,1421,ITF,ITF1,13,Abruzzo
2021-02-01,MOL,562,201,361,301,149,111,0,0,1,14,548,ITF,ITF2,14,Molise
2021-01-04,FVG,1510,559,951,1392,118,0,0,0,0,1510,0,ITH,ITH4,6,Friuli-Venezia Giulia
2021-01-15,BAS,812,349,463,455,183,174,0,0,0,812,0,ITF,ITF5,17,Basilicata
2021-01-18,UMB,588,215,373,315,149,124,0,0,0,504,84,ITI,ITI2,10,Umbria
2021-01-04,CAL,996,492,504,969,27,0,0,0,0,996,0,ITF,ITF6,18,Calabria
2021-01-14,SAR,1105,426,679,885,220,0,0,0,0,1105,0,ITG,ITG2,20,Sardegna
2021-01-23,SAR,60,22,38,60,0,0,0,0,0,0,60,ITG,ITG2,20,Sardegna
2021-01-13,UMB,450,139,311,379,29,42,0,0,0,450,0,ITI,ITI2,10,Umbria
2021-02-08,MOL,334,141,193,206,43,85,0,0,0,216,118,ITF,ITF2,14,Molise
2021-02-09,VDA,251,84,167,78,30,14,75,1,53,68,183,ITC,ITC2,2,Valle d'Aosta / Vall√©e d'Aoste
2021-02-26,VDA,206,57,149,67,34,4,96,4,1,122,84,ITC,ITC2,2,Valle d'Aosta / Vall√©e d'Aoste
2021-01-15,PIE,8961,2951,6010,5493,1924,1544,0,0,0,8961,0,ITC,ITC1,1,Piemonte
2021-02-24,SIC,9597,4868,4729,1422,1252,499,4027,1474,923,9003,594,ITG,ITG1,19,Sicilia
2021-01-21,LIG,1076,373,703,562,181,332,1,0,0,656,420,ITC,ITC3,7,Liguria
2021-02-05,CAM,7259,3463,3796,3446,3496,308,9,0,0,2132,5127,ITF,ITF3,15,Campania
2021-01-25,MAR,1595,558,1037,1425,114,56,0,0,0,97,1498,ITI,ITI3,11,Marche
2021-02-06,VEN,4086,1350,2736,3017,699,367,3,0,0,707,3379,ITH,ITH3,5,Veneto
2021-01-26,LOM,8318,2701,5617,6559,1543,203,13,0,0,328,7990,ITC,ITC4,3,Lombardia
2021-01-07,MAR,1802,633,1169,1480,322,0,0,0,0,1802,0,ITI,ITI3,11,Marche
2021-03-07,SAR,1373,621,752,282,226,32,833,0,0,901,472,ITG,ITG2,20,Sardegna
2021-01-05,CAM,7238,3639,3599,5811,1321,106,0,0,0,7238,0,ITF,ITF3,15,Campania
2021-03-05,LAZ,18253,7699,10554,2614,1731,237,8379,1323,3969,13595,4658,ITI,ITI4,12,Lazio
2021-01-19,ABR,111,55,56,27,34,50,0,0,0,91,20,ITF,ITF1,13,Abruzzo
2021-02-25,PIE,11608,4888,6720,1433,1824,405,6059,0,1887,11032,576,ITC,ITC1,1,Piemonte
2021-01-14,CAL,2557,1214,1343,1962,592,3,0,0,0,2557,0,ITF,ITF6,18,Calabria
2021-02-20,ABR,4781,1842,2939,310,569,192,1417,406,1887,4705,76,ITF,ITF1,13,Abruzzo
2021-01-15,LAZ,6223,2465,3758,4476,604,988,155,0,0,6223,0,ITI,ITI4,12,Lazio
2021-02-11,MOL,293,133,160,225,19,45,0,3,1,257,36,ITF,ITF2,14,Molise
2021-02-12,VEN,4259,1416,2843,2679,897,675,6,2,0,3686,573,ITH,ITH3,5,Veneto
2021-01-26,LIG,2435,787,1648,1921,258,251,0,0,5,101,2334,ITC,ITC3,7,Liguria
2021-01-08,CAL,2109,1014,1095,1898,211,0,0,0,0,2109,0,ITF,ITF6,18,Calabria
2021-01-12,PIE,9989,3387,6602,6821,1996,1172,0,0,0,9989,0,ITC,ITC1,1,Piemonte
2021-01-25,VEN,6466,2074,4392,5059,500,904,1,0,2,170,6296,ITH,ITH3,5,Veneto
2021-03-01,MOL,641,268,373,200,184,108,0,2,147,427,214,ITF,ITF2,14,Molise
2021-02-18,PUG,4321,1825,2496,2697,947,668,5,2,2,3736,585,ITF,ITF4,16,Puglia
2021-01-07,VDA,275,111,164,224,46,5,0,0,0,275,0,ITC,ITC2,2,Valle d'Aosta / Vall√©e d'Aoste
2021-02-04,MOL,758,295,463,502,114,141,0,0,1,77,681,ITF,ITF2,14,Molise
2021-02-09,FVG,1847,555,1292,1052,509,286,0,0,0,1559,288,ITH,ITH4,6,Friuli-Venezia Giulia
2021-01-10,PIE,5207,2273,2934,3904,784,519,0,0,0,5207,0,ITC,ITC1,1,Piemonte
2021-01-06,SIC,6471,3402,3069,5717,752,2,0,0,0,6471,0,ITG,ITG1,19,Sicilia
2021-01-27,LIG,1709,589,1120,1304,177,227,0,0,1,143,1566,ITC,ITC3,7,Liguria
2021-02-21,LAZ,6770,3090,3680,1243,362,51,4491,607,16,6489,281,ITI,ITI4,12,Lazio
2021-03-01,SIC,12860,6090,6770,1556,1808,392,4302,1744,3058,11201,1659,ITG,ITG1,19,Sicilia
2021-01-26,CAL,1805,861,944,1571,164,70,0,0,0,285,1520,ITF,ITF6,18,Calabria
2021-01-21,SAR,126,60,66,60,66,0,0,0,0,94,32,ITG,ITG2,20,Sardegna
2021-02-18,PAT,1200,424,776,300,30,35,777,3,55,1137,63,ITH,ITH2,4,Provincia Autonoma Trento
2021-02-01,VDA,403,127,276,268,65,70,0,0,0,87,316,ITC,ITC2,2,Valle d'Aosta / Vall√©e d'Aoste
2021-01-24,UMB,254,104,150,254,0,0,0,0,0,1,253,ITI,ITI2,10,Umbria
2021-01-24,PAB,12,10,2,1,11,0,0,0,0,0,12,ITH,ITH1,4,Provincia Autonoma Bolzano / Bozen
2021-01-03,CAL,6,3,3,4,2,0,0,0,0,6,0,ITF,ITF6,18,Calabria
2021-02-17,PAB,4,1,3,1,2,0,1,0,0,2,2,ITH,ITH1,4,Provincia Autonoma Bolzano / Bozen
2021-03-05,VEN,12602,4717,7885,3284,2082,931,3088,271,2946,9072,3530,ITH,ITH3,5,Veneto
2021-02-15,LAZ,7724,3377,4347,2445,675,378,4218,8,0,7427,297,ITI,ITI4,12,Lazio
2021-02-01,MAR,1360,479,881,1053,226,81,0,0,0,98,1262,ITI,ITI3,11,Marche
2021-01-12,SIC,4542,2234,2308,2863,1484,195,0,0,0,4542,0,ITG,ITG1,19,Sicilia
2021-03-02,MOL,666,383,283,98,253,51,0,113,151,508,158,ITF,ITF2,14,Molise
2021-01-21,LAZ,5246,2108,3138,4779,110,232,125,0,0,196,5050,ITI,ITI4,12,Lazio
2021-02-13,LOM,6267,2390,3877,3855,1748,648,16,0,0,4926,1341,ITC,ITC4,3,Lombardia
2021-01-31,CAM,8067,3711,4356,5107,2893,67,0,0,0,23,8044,ITF,ITF3,15,Campania
2021-02-03,SAR,1118,418,700,918,181,19,0,0,0,426,692,ITG,ITG2,20,Sardegna
2021-01-21,UMB,610,202,408,428,13,169,0,0,0,341,269,ITI,ITI2,10,Umbria
2021-01-30,SAR,3862,1392,2470,2987,874,0,1,0,0,362,3500,ITG,ITG2,20,Sardegna
2021-01-05,SIC,10527,5159,5368,9074,1246,207,0,0,0,10527,0,ITG,ITG1,19,Sicilia
2021-01-28,EMR,10220,3333,6887,8068,1030,1122,0,0,0,350,9870,ITH,ITH5,8,Emilia-Romagna
2021-01-29,MAR,1991,730,1261,1479,438,74,0,0,0,168,1823,ITI,ITI3,11,Marche
2020-12-31,SIC,877,469,408,827,50,0,0,0,0,877,0,ITG,ITG1,19,Sicilia
2021-01-08,SIC,8328,3864,4464,6591,1524,213,0,0,0,8328,0,ITG,ITG1,19,Sicilia
2021-02-02,LAZ,5772,2133,3639,4712,486,571,3,0,0,501,5271,ITI,ITI4,12,Lazio
2021-03-03,EMR,15409,5107,10302,2504,1038,140,6774,340,4613,12968,2441,ITH,ITH5,8,Emilia-Romagna
2021-02-01,CAM,3985,1813,2172,2504,1329,152,0,0,0,110,3875,ITF,ITF3,15,Campania
2021-02-02,BAS,366,142,224,134,129,102,1,0,0,176,190,ITF,ITF5,17,Basilicata
2021-01-11,VEN,7236,2100,5136,3499,1533,1956,247,0,1,7236,0,ITH,ITH3,5,Veneto
2020-12-27,UMB,85,45,40,67,2,16,0,0,0,85,0,ITI,ITI2,10,Umbria
2021-01-15,VEN,5870,1820,4050,2990,1300,1565,9,3,3,5870,0,ITH,ITH3,5,Veneto
2021-02-23,PAB,762,320,442,0,58,0,620,0,84,757,5,ITH,ITH1,4,Provincia Autonoma Bolzano / Bozen
2021-02-15,FVG,2442,908,1534,696,401,314,1031,0,0,2192,250,ITH,ITH4,6,Friuli-Venezia Giulia
2020-12-27,LAZ,272,131,141,272,0,0,0,0,0,272,0,ITI,ITI4,12,Lazio
2021-01-16,LOM,15261,5688,9573,8149,5653,1277,179,3,0,15261,0,ITC,ITC4,3,Lombardia
2021-02-23,SIC,8944,4686,4258,1265,1236,502,3995,1367,579,8456,488,ITG,ITG1,19,Sicilia
2021-02-14,BAS,149,48,101,55,13,63,18,0,0,149,0,ITF,ITF5,17,Basilicata
2021-02-17,CAL,1681,672,1009,673,343,285,299,0,81,1471,210,ITF,ITF6,18,Calabria
2021-02-17,PUG,4252,1738,2514,2445,1208,597,1,0,1,3655,597,ITF,ITF4,16,Puglia
2021-01-02,LAZ,6704,2629,4075,6268,78,358,0,0,0,6704,0,ITI,ITI4,12,Lazio
2020-12-27,VEN,880,395,485,875,4,0,0,0,1,880,0,ITH,ITH3,5,Veneto
2021-02-22,ABR,2644,1175,1469,477,357,46,1094,419,251,2614,30,ITF,ITF1,13,Abruzzo
2021-01-22,FVG,90,30,60,89,1,0,0,0,0,0,90,ITH,ITH4,6,Friuli-Venezia Giulia
2021-03-02,LIG,3860,1592,2268,683,174,76,2923,1,3,3557,303,ITC,ITC3,7,Liguria
2021-01-04,EMR,7257,2510,4747,6164,516,577,0,0,0,7257,0,ITH,ITH5,8,Emilia-Romagna
2021-02-02,VEN,6402,1842,4560,2969,1287,1993,152,0,1,392,6010,ITH,ITH3,5,Veneto
2021-01-27,SAR,1408,494,914,1303,105,0,0,0,0,79,1329,ITG,ITG2,20,Sardegna
2021-01-12,MAR,1226,413,813,912,264,50,0,0,0,1226,0,ITI,ITI3,11,Marche
2021-02-19,BAS,1617,736,881,218,373,66,960,0,0,1555,62,ITF,ITF5,17,Basilicata
2021-02-11,ABR,816,262,554,473,189,154,0,0,0,773,43,ITF,ITF1,13,Abruzzo
2021-03-01,LIG,3266,1338,1928,498,106,60,2601,0,1,3149,117,ITC,ITC3,7,Liguria
2021-01-14,LAZ,5217,1960,3257,3872,450,811,84,0,0,5217,0,ITI,ITI4,12,Lazio
2021-02-17,PAT,1092,420,672,325,27,35,690,3,12,1001,91,ITH,ITH2,4,Provincia Autonoma Trento
2021-02-03,EMR,9269,2971,6298,6227,1340,1617,85,0,0,954,8315,ITH,ITH5,8,Emilia-Romagna
2021-03-01,CAM,12296,4281,8015,1095,3709,145,1720,0,5627,8185,4111,ITF,ITF3,15,Campania
2021-02-04,CAM,7943,3429,4514,3965,3685,292,1,0,0,1308,6635,ITF,ITF3,15,Campania
2021-02-04,PIE,10188,3336,6852,6233,2199,1756,0,0,0,581,9607,ITC,ITC1,1,Piemonte
2021-03-07,MAR,3559,1490,2069,443,274,0,1962,286,594,2983,576,ITI,ITI3,11,Marche
2021-01-31,PIE,4105,1748,2357,3076,654,375,0,0,0,112,3993,ITC,ITC1,1,Piemonte
2021-03-04,LAZ,18020,7668,10352,2721,1523,505,8052,1315,3904,13018,5002,ITI,ITI4,12,Lazio
2021-03-01,LOM,18122,7903,10219,2571,2559,804,10667,1493,28,16446,1676,ITC,ITC4,3,Lombardia
2021-01-03,EMR,2730,934,1796,2480,80,170,0,0,0,2730,0,ITH,ITH5,8,Emilia-Romagna
2021-01-16,EMR,5592,1717,3875,3687,793,1108,0,3,1,5592,0,ITH,ITH5,8,Emilia-Romagna
2021-01-28,TOS,6275,1880,4395,5421,66,788,0,0,0,349,5926,ITI,ITI1,9,Toscana
2021-01-06,LOM,7044,2486,4558,5264,1742,35,3,0,0,7044,0,ITC,ITC4,3,Lombardia
2021-01-20,PAB,609,248,361,283,76,0,250,0,0,401,208,ITH,ITH1,4,Provincia Autonoma Bolzano / Bozen
2021-01-08,BAS,554,219,335,265,230,59,0,0,0,554,0,ITF,ITF5,17,Basilicata
2021-02-20,BAS,1104,505,599,70,181,68,785,0,0,987,117,ITF,ITF5,17,Basilicata
2021-01-09,MOL,450,152,298,221,51,178,0,0,0,450,0,ITF,ITF2,14,Molise
2021-01-20,UMB,613,222,391,583,15,14,0,0,1,613,0,ITI,ITI2,10,Umbria
2021-02-11,VDA,231,107,124,53,38,0,127,13,0,222,9,ITC,ITC2,2,Valle d'Aosta / Vall√©e d'Aoste
2021-01-10,PAB,2,2,0,1,1,0,0,0,0,2,0,ITH,ITH1,4,Provincia Autonoma Bolzano / Bozen
2021-02-20,PAT,404,244,160,329,10,30,1,3,31,121,283,ITH,ITH2,4,Provincia Autonoma Trento
2021-02-07,SIC,2346,995,1351,1610,581,155,0,0,0,673,1673,ITG,ITG1,19,Sicilia
2021-02-25,VEN,7855,3321,4534,1495,569,467,4941,109,274,7263,592,ITH,ITH3,5,Veneto
2021-01-13,LIG,2717,993,1724,1880,346,487,0,0,4,2717,0,ITC,ITC3,7,Liguria
2021-01-04,MOL,314,131,183,301,13,0,0,0,0,314,0,ITF,ITF2,14,Molise
2021-03-06,PIE,12013,4464,7549,2039,1028,335,5945,0,2666,9466,2547,ITC,ITC1,1,Piemonte
2021-01-05,MOL,449,180,269,441,8,0,0,0,0,449,0,ITF,ITF2,14,Molise
2021-02-06,MOL,429,179,250,276,22,130,0,0,1,29,400,ITF,ITF2,14,Molise
2021-02-27,PAT,1021,453,568,441,31,0,434,3,112,598,423,ITH,ITH2,4,Provincia Autonoma Trento
2021-01-30,LIG,1650,561,1089,1251,140,257,0,0,2,25,1625,ITC,ITC3,7,Liguria
2021-02-19,EMR,7284,3000,4284,819,392,257,5816,0,0,6780,504,ITH,ITH5,8,Emilia-Romagna
2021-02-16,BAS,893,371,522,247,96,65,484,1,0,795,98,ITF,ITF5,17,Basilicata
2021-02-01,PAT,1218,334,884,766,78,374,0,0,0,92,1126,ITH,ITH2,4,Provincia Autonoma Trento
2021-02-25,UMB,1332,494,838,825,100,97,305,0,5,1280,52,ITI,ITI2,10,Umbria
2021-02-10,FVG,1352,496,856,745,487,119,0,0,1,1266,86,ITH,ITH4,6,Friuli-Venezia Giulia
2021-01-05,MAR,1562,586,976,1436,126,0,0,0,0,1562,0,ITI,ITI3,11,Marche
2021-01-26,FVG,1972,647,1325,1439,152,381,0,0,0,214,1758,ITH,ITH4,6,Friuli-Venezia Giulia
2021-01-10,SAR,2183,750,1433,1632,551,0,0,0,0,2183,0,ITG,ITG2,20,Sardegna
2021-02-09,LIG,1864,673,1191,1057,330,455,0,0,22,249,1615,ITC,ITC3,7,Liguria
2021-01-28,VEN,9180,2652,6528,6458,1288,1431,0,0,3,172,9008,ITH,ITH3,5,Veneto
2021-01-27,MAR,2118,780,1338,1752,226,140,0,0,0,122,1996,ITI,ITI3,11,Marche
2021-03-03,SIC,14390,6435,7955,2406,2317,506,4282,1323,3556,11310,3080,ITG,ITG1,19,Sicilia
2021-02-04,UMB,732,226,506,692,20,20,0,0,0,25,707,ITI,ITI2,10,Umbria
2021-02-21,CAL,607,286,321,36,164,47,330,30,0,530,77,ITF,ITF6,18,Calabria
2021-02-04,PAB,1840,556,1284,623,598,405,214,0,0,8,1832,ITH,ITH1,4,Provincia Autonoma Bolzano / Bozen
2020-12-31,CAM,1490,811,679,1273,216,1,0,0,0,1490,0,ITF,ITF3,15,Campania
2021-03-02,UMB,3570,1323,2247,318,272,53,1241,241,1445,3566,4,ITI,ITI2,10,Umbria
2021-01-30,MOL,460,158,302,189,92,179,0,0,0,12,448,ITF,ITF2,14,Molise
2021-02-01,SIC,6077,2684,3393,4168,1591,318,0,0,0,304,5773,ITG,ITG1,19,Sicilia
2021-01-29,EMR,10325,3476,6849,8080,1228,1017,0,0,0,289,10036,ITH,ITH5,8,Emilia-Romagna
2021-01-04,SIC,8373,4172,4201,7595,772,6,0,0,0,8373,0,ITG,ITG1,19,Sicilia
2021-01-17,PAB,2270,1025,1245,54,236,19,1961,0,0,2259,11,ITH,ITH1,4,Provincia Autonoma Bolzano / Bozen
2021-02-01,BAS,242,91,151,97,97,48,0,0,0,46,196,ITF,ITF5,17,Basilicata
2021-01-23,PAB,195,115,80,183,12,0,0,0,0,0,195,ITH,ITH1,4,Provincia Autonoma Bolzano / Bozen
2020-12-27,VDA,20,9,11,20,0,0,0,0,0,20,0,ITC,ITC2,2,Valle d'Aosta / Vall√©e d'Aoste
2021-02-15,LIG,2120,796,1324,962,255,240,661,1,1,1727,393,ITC,ITC3,7,Liguria
2021-01-28,PAB,867,307,560,584,214,69,0,0,0,10,857,ITH,ITH1,4,Provincia Autonoma Bolzano / Bozen
2021-02-16,CAL,1534,643,891,659,517,240,118,0,0,1255,279,ITF,ITF6,18,Calabria
2021-02-16,PUG,3368,1446,1922,2127,808,412,3,16,2,2723,645,ITF,ITF4,16,Puglia
2021-01-05,ABR,1614,604,1010,1604,10,0,0,0,0,1614,0,ITF,ITF1,13,Abruzzo
2021-01-19,BAS,199,84,115,78,77,44,0,0,0,199,0,ITF,ITF5,17,Basilicata
2021-01-08,PIE,5528,1761,3767,4078,1029,421,0,0,0,5528,0,ITC,ITC1,1,Piemonte
2020-12-31,PIE,3907,1332,2575,3413,360,134,0,0,0,3907,0,ITC,ITC1,1,Piemonte
2021-02-08,VDA,223,83,140,28,103,3,64,0,25,25,198,ITC,ITC2,2,Valle d'Aosta / Vall√©e d'Aoste
2021-02-12,EMR,5299,1672,3627,3391,917,704,287,0,0,3899,1400,ITH,ITH5,8,Emilia-Romagna
2021-02-24,CAM,11522,4072,7450,712,2311,85,5094,0,3320,10834,688,ITF,ITF3,15,Campania
2021-02-04,LIG,2779,970,1809,1840,459,471,0,1,8,179,2600,ITC,ITC3,7,Liguria
2021-02-25,MAR,3561,1446,2115,432,213,423,2489,3,1,3382,179,ITI,ITI3,11,Marche
2021-01-10,PAT,84,19,65,53,19,12,0,0,0,84,0,ITH,ITH2,4,Provincia Autonoma Trento
2021-01-14,MOL,646,239,407,418,113,115,0,0,0,646,0,ITF,ITF2,14,Molise
2021-02-20,LAZ,8781,4077,4704,1940,460,297,4752,1310,22,8364,417,ITI,ITI4,12,Lazio
2021-02-27,TOS,1919,703,1216,1353,314,126,1,106,19,1017,902,ITI,ITI1,9,Toscana
2021-02-28,LIG,1060,581,479,12,571,3,474,0,0,1059,1,ITC,ITC3,7,Liguria
2021-01-17,LIG,860,299,561,515,82,262,0,0,1,860,0,ITC,ITC3,7,Liguria
2021-01-25,TOS,5123,1895,3228,4158,56,909,0,0,0,248,4875,ITI,ITI1,9,Toscana
2020-12-30,LIG,10,4,6,10,0,0,0,0,0,10,0,ITC,ITC3,7,Liguria
2021-03-01,EMR,9933,3526,6407,1809,596,410,5572,309,1237,7709,2224,ITH,ITH5,8,Emilia-Romagna
2021-01-10,VEN,5019,1661,3358,3838,715,462,2,2,0,5019,0,ITH,ITH3,5,Veneto
2021-02-28,CAM,10398,3203,7195,485,3656,22,1943,0,4292,8500,1898,ITF,ITF3,15,Campania
2021-01-18,ABR,122,48,74,106,14,2,0,0,0,46,76,ITF,ITF1,13,Abruzzo
2021-01-29,LOM,13431,4111,9320,10442,2408,572,9,0,0,653,12778,ITC,ITC4,3,Lombardia
2021-01-31,PAT,74,15,59,55,13,6,0,0,0,0,74,ITH,ITH2,4,Provincia Autonoma Trento
2021-02-07,PIE,3087,974,2113,1649,662,776,0,0,0,445,2642,ITC,ITC1,1,Piemonte
2021-02-24,LOM,13604,5486,8118,3285,1624,1700,5791,1181,23,12791,813,ITC,ITC4,3,Lombardia
2021-01-23,LIG,804,293,511,631,129,43,0,0,1,149,655,ITC,ITC3,7,Liguria
2021-02-21,CAM,5833,2239,3594,780,653,22,3869,0,509,5608,225,ITF,ITF3,15,Campania
2021-01-28,CAM,8832,4122,4710,6216,2269,347,0,0,0,135,8697,ITF,ITF3,15,Campania
2021-01-23,EMR,2443,868,1575,1899,114,430,0,0,0,441,2002,ITH,ITH5,8,Emilia-Romagna
2021-03-07,EMR,5491,2160,3331,1245,654,12,2287,511,782,4239,1252,ITH,ITH5,8,Emilia-Romagna
2021-01-12,LIG,2403,855,1548,1694,268,439,0,0,2,2403,0,ITC,ITC3,7,Liguria
2021-01-03,BAS,900,344,556,790,108,0,0,0,2,900,0,ITF,ITF5,17,Basilicata
2021-01-22,SIC,1235,625,610,1035,82,118,0,0,0,242,993,ITG,ITG1,19,Sicilia
2021-01-29,SIC,9359,4320,5039,7150,1904,305,0,0,0,432,8927,ITG,ITG1,19,Sicilia
2021-02-19,PAT,875,344,531,168,54,70,563,0,20,817,58,ITH,ITH2,4,Provincia Autonoma Trento
2021-01-30,BAS,703,226,477,301,276,126,0,0,0,127,576,ITF,ITF5,17,Basilicata
2021-02-12,LAZ,6491,2644,3847,1992,423,302,3774,0,0,6414,77,ITI,ITI4,12,Lazio
2021-01-19,CAM,1095,474,621,534,390,171,0,0,0,1092,3,ITF,ITF3,15,Campania
2021-01-05,CAL,1350,618,732,1256,94,0,0,0,0,1350,0,ITF,ITF6,18,Calabria
2021-01-13,PIE,10041,3214,6827,6458,2255,1328,0,0,0,10041,0,ITC,ITC1,1,Piemonte
2021-01-19,PAT,403,77,326,363,4,36,0,0,0,403,0,ITH,ITH2,4,Provincia Autonoma Trento
2021-01-17,UMB,54,17,37,47,7,0,0,0,0,54,0,ITI,ITI2,10,Umbria
2021-02-05,ABR,1535,520,1015,1188,241,106,0,0,0,788,747,ITF,ITF1,13,Abruzzo
2021-02-08,LIG,1827,704,1123,1202,376,242,0,0,7,303,1524,ITC,ITC3,7,Liguria
2021-02-02,LOM,19770,6558,13212,13368,4647,1676,79,0,0,480,19290,ITC,ITC4,3,Lombardia
2021-02-11,VEN,3870,1186,2684,2492,639,728,9,1,1,3243,627,ITH,ITH3,5,Veneto
2021-01-25,LAZ,7761,3041,4720,7006,270,363,122,0,0,421,7340,ITI,ITI4,12,Lazio
2021-01-20,LOM,5528,1357,4171,1991,2186,1261,90,0,0,5413,115,ITC,ITC4,3,Lombardia
2021-01-05,FVG,1679,550,1129,1349,133,197,0,0,0,1679,0,ITH,ITH4,6,Friuli-Venezia Giulia
2021-03-02,EMR,11379,3748,7631,1916,775,211,5221,355,2901,9412,1967,ITH,ITH5,8,Emilia-Romagna
2021-02-19,TOS,8260,2928,5332,2964,1233,211,152,580,3120,7754,506,ITI,ITI1,9,Toscana
2021-02-19,PUG,4635,1961,2674,2995,1235,347,2,49,7,4244,391,ITF,ITF4,16,Puglia
2021-01-16,CAL,2394,1120,1274,1664,489,241,0,0,0,2394,0,ITF,ITF6,18,Calabria
2021-01-16,FVG,1231,360,871,771,212,248,0,0,0,1231,0,ITH,ITH4,6,Friuli-Venezia Giulia
2021-02-03,BAS,666,300,366,305,189,172,0,0,0,32,634,ITF,ITF5,17,Basilicata
2021-01-21,MAR,896,253,643,460,100,336,0,0,0,585,311,ITI,ITI3,11,Marche
2021-02-26,LAZ,12800,5575,7225,1908,1331,323,5114,1385,2739,11582,1218,ITI,ITI4,12,Lazio
2021-02-02,CAM,5722,2804,2918,3640,1728,354,0,0,0,443,5279,ITF,ITF3,15,Campania
2021-03-05,VDA,275,124,151,50,69,13,138,0,5,53,222,ITC,ITC2,2,Valle d'Aosta / Vall√©e d'Aoste
2021-01-02,LOM,199,72,127,177,22,0,0,0,0,199,0,ITC,ITC4,3,Lombardia
2021-01-28,PAT,530,147,383,390,33,107,0,0,0,48,482,ITH,ITH2,4,Provincia Autonoma Trento
2021-02-17,LAZ,8806,4369,4437,2282,432,499,4247,1345,1,8278,528,ITI,ITI4,12,Lazio
2021-01-16,VDA,236,80,156,127,36,22,51,0,0,236,0,ITC,ITC2,2,Valle d'Aosta / Vall√©e d'Aoste
2021-01-24,CAL,44,18,26,15,3,26,0,0,0,39,5,ITF,ITF6,18,Calabria
2021-01-14,EMR,8086,2572,5514,5390,1089,1606,0,1,0,8086,0,ITH,ITH5,8,Emilia-Romagna
2021-02-10,MOL,150,78,72,91,6,53,0,0,0,130,20,ITF,ITF2,14,Molise
2021-01-02,CAL,165,94,71,165,0,0,0,0,0,165,0,ITF,ITF6,18,Calabria
2021-01-18,MOL,114,48,66,97,17,0,0,0,0,114,0,ITF,ITF2,14,Molise
2020-12-28,PIE,1,1,0,1,0,0,0,0,0,1,0,ITC,ITC1,1,Piemonte
2021-02-03,PAT,845,313,532,354,25,73,393,0,0,414,431,ITH,ITH2,4,Provincia Autonoma Trento
2021-01-30,ABR,1509,566,943,1348,114,47,0,0,0,69,1440,ITF,ITF1,13,Abruzzo
2021-01-14,VEN,7053,1924,5129,3228,1335,2473,17,0,0,7053,0,ITH,ITH3,5,Veneto
2021-01-03,PUG,2004,942,1062,1814,44,145,0,0,1,2004,0,ITF,ITF4,16,Puglia
2021-02-04,VDA,294,86,208,168,91,34,1,0,0,8,286,ITC,ITC2,2,Valle d'Aosta / Vall√©e d'Aoste
2021-01-04,CAM,5826,2963,2863,4850,976,0,0,0,0,5826,0,ITF,ITF3,15,Campania
2021-01-12,VEN,5230,1516,3714,2250,1058,1752,168,0,2,5230,0,ITH,ITH3,5,Veneto
2021-02-14,PUG,784,348,436,681,32,70,0,0,1,662,122,ITF,ITF4,16,Puglia
2021-01-12,PAB,1527,398,1129,299,680,475,73,0,0,1527,0,ITH,ITH1,4,Provincia Autonoma Bolzano / Bozen
2021-01-23,VEN,4063,1255,2808,3403,206,450,1,0,3,34,4029,ITH,ITH3,5,Veneto
2021-02-18,ABR,2291,934,1357,670,380,416,610,215,0,2161,130,ITF,ITF1,13,Abruzzo
2021-03-02,SIC,14725,6310,8415,2379,1924,500,4466,1330,4126,11906,2819,ITG,ITG1,19,Sicilia
2021-01-28,MAR,1972,659,1313,1581,290,101,0,0,0,167,1805,ITI,ITI3,11,Marche
2021-02-06,LIG,1875,758,1117,1298,201,375,0,0,1,145,1730,ITC,ITC3,7,Liguria
2021-02-14,SAR,538,262,276,288,193,57,0,0,0,536,2,ITG,ITG2,20,Sardegna
2021-01-09,ABR,1483,565,918,1430,53,0,0,0,0,1483,0,ITF,ITF1,13,Abruzzo
2021-02-27,BAS,1884,817,1067,103,182,21,1578,0,0,1718,166,ITF,ITF5,17,Basilicata
2021-02-20,PUG,2948,1073,1875,2108,260,167,3,4,406,2693,255,ITF,ITF4,16,Puglia
2021-02-19,ABR,3301,1552,1749,990,433,371,1111,388,8,3201,100,ITF,ITF1,13,Abruzzo
2021-01-08,ABR,1525,507,1018,1487,38,0,0,0,0,1525,0,ITF,ITF1,13,Abruzzo
2021-01-07,PUG,5707,2448,3259,5210,276,217,0,1,3,5707,0,ITF,ITF4,16,Puglia
2021-01-08,VEN,9397,2831,6566,5977,1605,1807,3,1,4,9397,0,ITH,ITH3,5,Veneto
2021-01-25,FVG,1582,567,1015,1369,141,72,0,0,0,194,1388,ITH,ITH4,6,Friuli-Venezia Giulia
2021-02-01,PUG,3956,1656,2300,3437,301,209,0,4,5,375,3581,ITF,ITF4,16,Puglia
2021-03-01,BAS,540,279,261,121,129,4,168,68,50,376,164,ITF,ITF5,17,Basilicata
2020-12-27,PIE,912,368,544,760,76,76,0,0,0,912,0,ITC,ITC1,1,Piemonte
2021-02-17,BAS,1121,488,633,120,159,57,783,1,1,1045,76,ITF,ITF5,17,Basilicata
2021-02-19,SAR,1490,468,1022,674,436,378,1,1,0,1434,56,ITG,ITG2,20,Sardegna
2021-02-04,BAS,1092,440,652,551,260,281,0,0,0,63,1029,ITF,ITF5,17,Basilicata
2021-01-07,PAT,1269,310,959,649,64,556,0,0,0,1269,0,ITH,ITH2,4,Provincia Autonoma Trento
2021-01-22,PIE,3865,1248,2617,2280,650,935,0,0,0,2522,1343,ITC,ITC1,1,Piemonte
2021-01-07,ABR,1603,552,1051,1566,37,0,0,0,0,1603,0,ITF,ITF1,13,Abruzzo
2021-03-06,CAM,16154,6653,9501,954,4429,148,5795,950,3878,10490,5664,ITF,ITF3,15,Campania
2021-01-19,LIG,1332,421,911,688,313,328,0,0,3,1245,87,ITC,ITC3,7,Liguria
2021-01-21,FVG,894,345,549,863,31,0,0,0,0,1,893,ITH,ITH4,6,Friuli-Venezia Giulia
2021-02-23,CAM,10916,3364,7552,514,2210,220,3685,0,4287,10390,526,ITF,ITF3,15,Campania
2021-02-25,MOL,541,239,302,68,12,28,433,0,0,473,68,ITF,ITF2,14,Molise
2021-01-15,MOL,538,242,296,398,59,81,0,0,0,538,0,ITF,ITF2,14,Molise
2021-01-06,BAS,294,129,165,144,114,36,0,0,0,294,0,ITF,ITF5,17,Basilicata
2021-01-26,PAB,809,291,518,670,139,0,0,0,0,1,808,ITH,ITH1,4,Provincia Autonoma Bolzano / Bozen
2021-02-14,VEN,125,56,69,94,31,0,0,0,0,112,13,ITH,ITH3,5,Veneto
2021-02-15,VDA,264,136,128,24,29,24,170,15,2,229,35,ITC,ITC2,2,Valle d'Aosta / Vall√©e d'Aoste
2021-02-03,MOL,731,249,482,391,159,180,0,0,1,338,393,ITF,ITF2,14,Molise
2021-01-03,PAB,41,16,25,33,7,0,1,0,0,41,0,ITH,ITH1,4,Provincia Autonoma Bolzano / Bozen
2021-02-09,EMR,4138,1241,2897,2217,467,1198,256,0,0,2293,1845,ITH,ITH5,8,Emilia-Romagna
2021-03-03,CAM,13924,5496,8428,2016,5280,156,3473,3,2996,7294,6630,ITF,ITF3,15,Campania
2021-01-06,SAR,1615,549,1066,1510,105,0,0,0,0,1615,0,ITG,ITG2,20,Sardegna
2021-02-25,SAR,2894,1252,1642,1472,738,465,159,51,9,2288,606,ITG,ITG2,20,Sardegna
2021-02-19,UMB,743,293,450,281,16,14,432,0,0,526,217,ITI,ITI2,10,Umbria
2021-01-03,LIG,731,228,503,655,75,0,0,0,1,731,0,ITC,ITC3,7,Liguria
2021-01-18,LAZ,5835,2268,3567,3901,756,725,453,0,0,4857,978,ITI,ITI4,12,Lazio
2021-02-16,ABR,1978,869,1109,841,513,139,410,75,0,1966,12,ITF,ITF1,13,Abruzzo
2021-02-23,FVG,2610,1249,1361,105,105,206,1939,254,1,2432,178,ITH,ITH4,6,Friuli-Venezia Giulia
2020-12-29,LOM,100,43,57,100,0,0,0,0,0,100,0,ITC,ITC4,3,Lombardia
2021-01-18,TOS,1119,636,483,430,314,375,0,0,0,1021,98,ITI,ITI1,9,Toscana
2021-02-26,LOM,17288,7191,10097,2932,1808,1034,10187,1303,24,15732,1556,ITC,ITC4,3,Lombardia
2021-02-26,FVG,3715,2087,1628,75,139,433,1737,1032,299,3569,146,ITH,ITH4,6,Friuli-Venezia Giulia
2021-02-08,PUG,3958,1593,2365,2932,610,389,1,25,1,1569,2389,ITF,ITF4,16,Puglia
2021-02-22,TOS,9817,4253,5564,3483,2280,315,22,1014,2703,9539,278,ITI,ITI1,9,Toscana
2021-01-11,MAR,1176,411,765,1021,155,0,0,0,0,1176,0,ITI,ITI3,11,Marche
2021-01-30,MAR,1907,668,1239,1566,341,0,0,0,0,29,1878,ITI,ITI3,11,Marche
2021-02-14,EMR,1397,377,1020,860,479,39,19,0,0,1277,120,ITH,ITH5,8,Emilia-Romagna
2021-01-08,MAR,1574,588,986,1226,348,0,0,0,0,1574,0,ITI,ITI3,11,Marche
2021-01-29,LAZ,7593,2865,4728,6372,427,704,90,0,0,477,7116,ITI,ITI4,12,Lazio
2021-02-24,FVG,2510,1079,1431,22,53,309,1830,0,296,2492,18,ITH,ITH4,6,Friuli-Venezia Giulia
2021-03-04,CAM,14620,5333,9287,1788,5088,108,4197,1,3438,8722,5898,ITF,ITF3,15,Campania
2020-12-27,EMR,968,372,596,824,118,26,0,0,0,968,0,ITH,ITH5,8,Emilia-Romagna
2021-02-25,LIG,3427,1343,2084,544,216,88,2576,2,1,3297,130,ITC,ITC3,7,Liguria
2021-03-05,TOS,15640,5982,9658,3920,2390,75,4703,681,3871,10948,4692,ITI,ITI1,9,Toscana
2021-02-08,PIE,6895,2350,4545,3782,1556,1557,0,0,0,665,6230,ITC,ITC1,1,Piemonte
2021-02-10,LOM,13938,4389,9549,8025,2647,3166,96,0,4,7380,6558,ITC,ITC4,3,Lombardia
2021-02-05,PAT,796,269,527,466,22,65,243,0,0,279,517,ITH,ITH2,4,Provincia Autonoma Trento
2021-02-26,SIC,12197,5967,6230,1836,1970,360,3888,1733,2410,10511,1686,ITG,ITG1,19,Sicilia
2021-01-26,MAR,2016,746,1270,1736,194,86,0,0,0,92,1924,ITI,ITI3,11,Marche
2021-01-19,SAR,747,270,477,423,163,160,0,0,1,692,55,ITG,ITG2,20,Sardegna
2021-01-16,VEN,4598,1539,3059,3193,756,649,0,0,0,4598,0,ITH,ITH3,5,Veneto
2020-12-31,MAR,383,178,205,370,13,0,0,0,0,383,0,ITI,ITI3,11,Marche
2021-03-04,MAR,6431,2840,3591,1060,912,88,2798,808,765,5037,1394,ITI,ITI3,11,Marche
2021-01-17,SIC,1295,584,711,619,516,160,0,0,0,1245,50,ITG,ITG1,19,Sicilia
2021-02-14,MAR,738,301,437,578,160,0,0,0,0,738,0,ITI,ITI3,11,Marche
2021-02-23,LOM,11430,4669,6761,3789,1584,819,4245,990,3,11124,306,ITC,ITC4,3,Lombardia
2021-01-18,CAL,1230,550,680,982,237,11,0,0,0,1040,190,ITF,ITF6,18,Calabria
2020-12-30,SIC,173,101,72,156,17,0,0,0,0,173,0,ITG,ITG1,19,Sicilia
2021-02-11,LAZ,6656,2787,3869,2196,333,500,3627,0,0,6458,198,ITI,ITI4,12,Lazio
2021-02-28,LAZ,10199,3991,6208,1601,688,77,4552,682,2599,9685,514,ITI,ITI4,12,Lazio
2021-02-22,PIE,8059,3221,4838,1695,1240,518,3717,0,889,7468,591,ITC,ITC1,1,Piemonte
2021-01-13,LOM,25609,7883,17726,12003,9669,3620,307,10,0,25609,0,ITC,ITC4,3,Lombardia
2020-12-29,SIC,235,146,89,235,0,0,0,0,0,235,0,ITG,ITG1,19,Sicilia
2021-03-06,CAL,7942,4053,3889,701,1872,755,3795,813,6,7187,755,ITF,ITF6,18,Calabria
2021-01-28,CAL,2232,1107,1125,1920,312,0,0,0,0,84,2148,ITF,ITF6,18,Calabria
2021-02-25,BAS,1770,724,1046,67,14,0,1688,1,0,1723,47,ITF,ITF5,17,Basilicata
2021-02-05,PUG,5620,2267,3353,4560,525,526,0,3,6,1323,4297,ITF,ITF4,16,Puglia
2021-02-12,MOL,330,149,181,224,32,72,0,0,2,208,122,ITF,ITF2,14,Molise
2021-01-29,UMB,1221,343,878,934,16,271,0,0,0,79,1142,ITI,ITI2,10,Umbria
2021-01-05,PAB,820,283,537,718,102,0,0,0,0,820,0,ITH,ITH1,4,Provincia Autonoma Bolzano / Bozen
2021-02-07,PAB,2163,974,1189,99,397,1,1666,0,0,10,2153,ITH,ITH1,4,Provincia Autonoma Bolzano / Bozen
2021-01-19,VDA,256,77,179,160,24,15,57,0,0,256,0,ITC,ITC2,2,Valle d'Aosta / Vall√©e d'Aoste
2021-01-20,MOL,18,8,10,14,4,0,0,0,0,18,0,ITF,ITF2,14,Molise
2021-01-28,VDA,290,123,167,194,88,6,2,0,0,56,234,ITC,ITC2,2,Valle d'Aosta / Vall√©e d'Aoste
2021-02-28,BAS,808,344,464,32,31,0,745,0,0,780,28,ITF,ITF5,17,Basilicata
2021-02-11,FVG,1921,661,1260,1132,562,224,3,0,0,1728,193,ITH,ITH4,6,Friuli-Venezia Giulia
2021-02-21,BAS,206,86,120,14,2,11,178,0,1,206,0,ITF,ITF5,17,Basilicata
2021-01-14,ABR,530,189,341,364,166,0,0,0,0,530,0,ITF,ITF1,13,Abruzzo
2021-01-25,MOL,319,130,189,317,0,0,0,0,2,3,316,ITF,ITF2,14,Molise
2021-01-06,TOS,4519,1459,3060,3984,10,525,0,0,0,4519,0,ITI,ITI1,9,Toscana
2020-12-27,LIG,132,54,78,85,2,45,0,0,0,132,0,ITC,ITC3,7,Liguria
2021-02-07,UMB,54,17,37,46,8,0,0,0,0,1,53,ITI,ITI2,10,Umbria
2021-02-13,VDA,215,195,20,0,54,0,0,161,0,215,0,ITC,ITC2,2,Valle d'Aosta / Vall√©e d'Aoste
2020-12-28,LIG,76,27,49,73,3,0,0,0,0,76,0,ITC,ITC3,7,Liguria
2021-01-17,PAT,251,195,56,251,0,0,0,0,0,251,0,ITH,ITH2,4,Provincia Autonoma Trento
2021-01-21,PAB,915,426,489,719,101,68,27,0,0,138,777,ITH,ITH1,4,Provincia Autonoma Bolzano / Bozen
2020-12-27,PAB,143,65,78,136,6,0,1,0,0,143,0,ITH,ITH1,4,Provincia Autonoma Bolzano / Bozen
2021-01-12,TOS,3581,1398,2183,2944,283,354,0,0,0,3581,0,ITI,ITI1,9,Toscana
2021-02-24,VEN,8522,3653,4869,1438,721,494,5600,258,11,8040,482,ITH,ITH3,5,Veneto
2021-02-06,PUG,4422,1897,2525,3456,486,478,0,0,2,1584,2838,ITF,ITF4,16,Puglia
2021-01-05,EMR,9323,3163,6160,7924,635,764,0,0,0,9323,0,ITH,ITH5,8,Emilia-Romagna
2021-02-04,PAT,971,303,668,541,17,89,324,0,0,420,551,ITH,ITH2,4,Provincia Autonoma Trento
2021-02-07,TOS,2806,953,1853,2349,300,157,0,0,0,885,1921,ITI,ITI1,9,Toscana
2021-03-06,SIC,12591,5055,7536,1997,1982,758,3882,615,3357,9690,2901,ITG,ITG1,19,Sicilia
2021-01-01,LAZ,3553,1381,2172,3483,2,68,0,0,0,3553,0,ITI,ITI4,12,Lazio
2021-02-09,SIC,4370,1831,2539,2240,1490,640,0,0,0,3364,1006,ITG,ITG1,19,Sicilia
2021-02-07,SAR,1116,394,722,975,141,0,0,0,0,228,888,ITG,ITG2,20,Sardegna
2021-01-01,TOS,2368,786,1582,1716,2,650,0,0,0,2368,0,ITI,ITI1,9,Toscana
2021-02-13,CAM,5506,2547,2959,952,808,131,3613,0,2,5288,218,ITF,ITF3,15,Campania
2021-02-26,CAL,3077,1630,1447,538,688,406,1147,294,4,2610,467,ITF,ITF6,18,Calabria
2021-01-12,LAZ,5391,1974,3417,4343,464,584,0,0,0,5391,0,ITI,ITI4,12,Lazio
2021-02-01,SAR,1524,605,919,894,553,77,0,0,0,225,1299,ITG,ITG2,20,Sardegna
2021-02-17,FVG,2336,989,1347,327,194,228,1541,46,0,1858,478,ITH,ITH4,6,Friuli-Venezia Giulia
2021-01-04,SAR,591,217,374,565,26,0,0,0,0,591,0,ITG,ITG2,20,Sardegna
2021-01-23,LAZ,6883,2682,4201,6063,278,417,125,0,0,255,6628,ITI,ITI4,12,Lazio
2021-02-22,BAS,1758,756,1002,126,88,2,1542,0,0,1705,53,ITF,ITF5,17,Basilicata
2021-03-02,FVG,4214,1515,2699,1163,675,202,1535,5,634,2711,1503,ITH,ITH4,6,Friuli-Venezia Giulia
2021-02-12,VDA,263,96,167,51,50,26,131,0,5,217,46,ITC,ITC2,2,Valle d'Aosta / Vall√©e d'Aoste
2021-01-24,CAM,4128,2123,2005,3140,822,166,0,0,0,383,3745,ITF,ITF3,15,Campania
2021-01-02,EMR,2347,903,1444,2071,79,197,0,0,0,2347,0,ITH,ITH5,8,Emilia-Romagna
2021-01-17,PUG,1295,586,709,819,147,329,0,0,0,1226,69,ITF,ITF4,16,Puglia
2021-02-27,PUG,13219,4395,8824,1568,769,126,4447,344,5965,12115,1104,ITF,ITF4,16,Puglia
2021-01-23,FVG,816,324,492,768,48,0,0,0,0,4,812,ITH,ITH4,6,Friuli-Venezia Giulia
2021-01-07,MOL,598,209,389,414,39,145,0,0,0,598,0,ITF,ITF2,14,Molise
2021-01-20,EMR,1321,269,1052,391,143,787,0,0,0,1320,1,ITH,ITH5,8,Emilia-Romagna
2021-02-04,PUG,5781,2322,3459,4385,810,580,0,0,6,1163,4618,ITF,ITF4,16,Puglia
2021-02-22,SIC,8034,4158,3876,1107,934,554,4065,1053,321,7543,491,ITG,ITG1,19,Sicilia
2021-01-16,LAZ,5343,2071,3272,3350,461,1062,470,0,0,5343,0,ITI,ITI4,12,Lazio
2021-02-21,PIE,4860,2001,2859,612,262,47,3202,0,737,4757,103,ITC,ITC1,1,Piemonte
2021-02-05,SIC,7211,3230,3981,3616,2740,855,0,0,0,2130,5081,ITG,ITG1,19,Sicilia
2021-02-08,TOS,4095,1358,2737,3373,345,377,0,0,0,3636,459,ITI,ITI1,9,Toscana
2021-02-13,MAR,1064,455,609,457,517,90,0,0,0,1012,52,ITI,ITI3,11,Marche
2021-01-30,TOS,4620,1622,2998,3763,219,638,0,0,0,197,4423,ITI,ITI1,9,Toscana
2021-01-10,LOM,10511,3955,6556,6865,3619,8,17,2,0,10511,0,ITC,ITC4,3,Lombardia
2021-01-11,MOL,557,194,363,196,250,111,0,0,0,557,0,ITF,ITF2,14,Molise
2021-02-25,ABR,3086,1347,1739,615,557,18,1508,262,126,2558,528,ITF,ITF1,13,Abruzzo
2021-02-10,ABR,948,313,635,622,210,116,0,0,0,504,444,ITF,ITF1,13,Abruzzo
2021-03-03,LOM,24241,10338,13903,6150,5912,1490,8572,1647,470,17393,6848,ITC,ITC4,3,Lombardia
2021-01-26,ABR,1542,567,975,1513,29,0,0,0,0,29,1513,ITF,ITF1,13,Abruzzo
2021-02-16,FVG,2502,1129,1373,260,273,220,1749,0,0,2387,115,ITH,ITH4,6,Friuli-Venezia Giulia
2021-03-07,LIG,1289,757,532,150,273,179,331,355,1,1074,215,ITC,ITC3,7,Liguria
2021-02-28,PIE,10333,3900,6433,528,444,53,6600,0,2708,10090,243,ITC,ITC1,1,Piemonte
2021-01-18,SAR,904,326,578,714,190,0,0,0,0,780,124,ITG,ITG2,20,Sardegna
2021-01-17,VEN,1932,780,1152,1587,220,120,3,0,2,1583,349,ITH,ITH3,5,Veneto
2021-02-14,VDA,48,16,32,6,0,42,0,0,0,1,47,ITC,ITC2,2,Valle d'Aosta / Vall√©e d'Aoste
2021-02-03,VDA,351,114,237,157,141,52,1,0,0,14,337,ITC,ITC2,2,Valle d'Aosta / Vall√©e d'Aoste
2021-01-05,TOS,5244,1755,3489,4354,11,879,0,0,0,5244,0,ITI,ITI1,9,Toscana
2021-01-26,VDA,139,48,91,115,12,12,0,0,0,0,139,ITC,ITC2,2,Valle d'Aosta / Vall√©e d'Aoste
2020-12-31,SAR,32,16,16,28,4,0,0,0,0,32,0,ITG,ITG2,20,Sardegna
2021-03-07,FVG,1733,702,1031,1,133,0,143,424,1032,1732,1,ITH,ITH4,6,Friuli-Venezia Giulia
2021-01-08,TOS,5944,1641,4303,5360,39,545,0,0,0,5944,0,ITI,ITI1,9,Toscana
2021-02-09,BAS,491,213,278,200,237,54,0,0,0,316,175,ITF,ITF5,17,Basilicata
2021-01-09,LIG,1324,475,849,988,147,188,0,0,1,1324,0,ITC,ITC3,7,Liguria
2020-12-29,LAZ,440,155,285,440,0,0,0,0,0,440,0,ITI,ITI4,12,Lazio
2021-01-10,EMR,7122,2660,4462,5639,977,499,6,0,1,7122,0,ITH,ITH5,8,Emilia-Romagna
2020-12-31,VEN,3220,1044,2176,2701,265,252,0,0,2,3220,0,ITH,ITH3,5,Veneto
2021-01-09,PAB,600,317,283,75,439,74,12,0,0,600,0,ITH,ITH1,4,Provincia Autonoma Bolzano / Bozen
2021-02-27,CAL,3673,1907,1766,421,588,395,1971,296,2,3295,378,ITF,ITF6,18,Calabria
2021-02-03,PUG,5026,1998,3028,4361,478,184,0,0,3,728,4298,ITF,ITF4,16,Puglia
2021-02-26,PUG,13238,4767,8471,2073,817,278,4965,509,4596,12228,1010,ITF,ITF4,16,Puglia
2021-01-23,PUG,3036,1291,1745,2522,206,307,0,0,1,885,2151,ITF,ITF4,16,Puglia
2021-01-23,SIC,4149,2147,2002,3912,221,16,0,0,0,225,3924,ITG,ITG1,19,Sicilia
2021-02-25,CAM,12415,4476,7939,600,2672,124,4906,0,4113,11227,1188,ITF,ITF3,15,Campania
2021-02-01,VEN,8520,2489,6031,4204,1960,2108,245,0,3,166,8354,ITH,ITH3,5,Veneto
2021-02-01,LOM,16021,5305,10716,11567,3510,901,43,0,0,324,15697,ITC,ITC4,3,Lombardia
2021-01-19,VEN,1309,472,837,726,253,324,6,0,0,1160,149,ITH,ITH3,5,Veneto
2021-01-12,EMR,9313,3084,6229,6350,1332,1631,0,0,0,9313,0,ITH,ITH5,8,Emilia-Romagna
2021-02-24,SAR,2407,1291,1116,1192,614,300,2,299,0,2218,189,ITG,ITG2,20,Sardegna
2021-01-09,BAS,557,160,397,282,207,67,0,0,1,557,0,ITF,ITF5,17,Basilicata
2021-01-31,MAR,1925,770,1155,1530,395,0,0,0,0,105,1820,ITI,ITI3,11,Marche
2021-02-15,PIE,4185,1414,2771,2298,978,907,1,0,1,2980,1205,ITC,ITC1,1,Piemonte
2021-01-16,UMB,221,73,148,146,32,43,0,0,0,221,0,ITI,ITI2,10,Umbria
2021-03-03,LIG,4270,1700,2570,996,236,254,2778,3,3,3333,937,ITC,ITC3,7,Liguria
2021-01-15,TOS,3878,1347,2531,2758,676,444,0,0,0,3878,0,ITI,ITI1,9,Toscana
2021-01-14,MAR,2010,692,1318,1112,600,298,0,0,0,2010,0,ITI,ITI3,11,Marche
2021-02-27,VDA,230,84,146,69,30,1,126,4,0,124,106,ITC,ITC2,2,Valle d'Aosta / Vall√©e d'Aoste
2021-01-17,CAL,867,418,449,527,292,48,0,0,0,801,66,ITF,ITF6,18,Calabria
2021-01-22,MOL,126,35,91,21,32,73,0,0,0,126,0,ITF,ITF2,14,Molise
2021-02-06,VDA,289,104,185,170,44,0,74,1,0,92,197,ITC,ITC2,2,Valle d'Aosta / Vall√©e d'Aoste
2021-01-02,VDA,6,5,1,0,0,6,0,0,0,6,0,ITC,ITC2,2,Valle d'Aosta / Vall√©e d'Aoste
2021-01-22,VDA,56,21,35,36,0,20,0,0,0,20,36,ITC,ITC2,2,Valle d'Aosta / Vall√©e d'Aoste
2021-01-17,CAM,1155,551,604,718,286,151,0,0,0,702,453,ITF,ITF3,15,Campania
2021-01-15,ABR,379,149,230,223,121,35,0,0,0,379,0,ITF,ITF1,13,Abruzzo
2021-02-10,PAT,849,289,560,310,10,51,478,0,0,508,341,ITH,ITH2,4,Provincia Autonoma Trento
2021-02-08,ABR,1201,398,803,710,227,264,0,0,0,491,710,ITF,ITF1,13,Abruzzo
2021-02-09,PAB,317,126,191,64,22,2,227,0,2,1,316,ITH,ITH1,4,Provincia Autonoma Bolzano / Bozen
2021-01-28,UMB,1240,392,848,891,4,345,0,0,0,19,1221,ITI,ITI2,10,Umbria
2021-01-16,BAS,721,304,417,273,285,161,0,0,2,721,0,ITF,ITF5,17,Basilicata
2021-01-10,UMB,1056,275,781,740,9,307,0,0,0,1056,0,ITI,ITI2,10,Umbria
2021-02-02,VDA,271,70,201,225,43,3,0,0,0,2,269,ITC,ITC2,2,Valle d'Aosta / Vall√©e d'Aoste
2021-01-02,TOS,3497,1097,2400,2682,15,800,0,0,0,3497,0,ITI,ITI1,9,Toscana
2021-03-04,MOL,850,417,433,252,493,69,0,36,0,526,324,ITF,ITF2,14,Molise
2020-12-27,MAR,200,97,103,184,12,4,0,0,0,200,0,ITI,ITI3,11,Marche
2021-01-19,UMB,103,23,80,21,2,80,0,0,0,103,0,ITI,ITI2,10,Umbria
2021-01-01,LIG,144,55,89,139,5,0,0,0,0,144,0,ITC,ITC3,7,Liguria
2021-01-13,VEN,5975,1600,4375,2790,1302,1880,3,0,0,5975,0,ITH,ITH3,5,Veneto
2021-01-01,LOM,24,7,17,21,3,0,0,0,0,24,0,ITC,ITC4,3,Lombardia
2021-01-21,EMR,2150,725,1425,1281,216,653,0,0,0,809,1341,ITH,ITH5,8,Emilia-Romagna
2021-02-03,PIE,10146,3293,6853,6614,2298,1234,0,0,0,610,9536,ITC,ITC1,1,Piemonte
2021-02-03,UMB,725,174,551,560,37,128,0,0,0,67,658,ITI,ITI2,10,Umbria
2021-03-07,CAL,2325,1140,1185,95,486,262,1284,197,1,2253,72,ITF,ITF6,18,Calabria
2021-02-12,PIE,6845,2180,4665,3520,1617,1706,0,0,2,3888,2957,ITC,ITC1,1,Piemonte
2021-02-05,PAB,2789,1036,1753,641,677,394,1077,0,0,6,2783,ITH,ITH1,4,Provincia Autonoma Bolzano / Bozen
2021-03-03,PAT,1605,609,996,71,43,58,1222,19,192,1049,556,ITH,ITH2,4,Provincia Autonoma Trento
2021-02-16,VDA,325,53,272,10,58,12,5,4,236,320,5,ITC,ITC2,2,Valle d'Aosta / Vall√©e d'Aoste
2021-01-07,VEN,8361,2321,6040,5467,1087,1807,0,0,0,8361,0,ITH,ITH3,5,Veneto
2021-02-26,VEN,7944,3087,4857,1601,1067,591,4382,30,273,6733,1211,ITH,ITH3,5,Veneto
2021-01-04,PIE,5562,1678,3884,4590,737,235,0,0,0,5562,0,ITC,ITC1,1,Piemonte
2021-01-04,UMB,809,397,412,808,1,0,0,0,0,809,0,ITI,ITI2,10,Umbria
2021-01-21,LOM,5313,1562,3751,1869,3181,260,2,0,1,4626,687,ITC,ITC4,3,Lombardia
2021-02-11,CAL,2341,1043,1298,1464,636,241,0,0,0,1081,1260,ITF,ITF6,18,Calabria
2021-01-13,PAT,420,123,297,391,6,23,0,0,0,420,0,ITH,ITH2,4,Provincia Autonoma Trento
2021-02-18,FVG,3206,1485,1721,229,139,331,1495,34,978,2800,406,ITH,ITH4,6,Friuli-Venezia Giulia
2021-02-19,FVG,3247,1287,1960,564,322,312,1586,35,428,2818,429,ITH,ITH4,6,Friuli-Venezia Giulia
2021-01-18,LIG,2091,724,1367,1224,419,438,0,0,10,1940,151,ITC,ITC3,7,Liguria
2021-01-17,BAS,328,133,195,96,178,54,0,0,0,327,1,ITF,ITF5,17,Basilicata
2021-02-05,SAR,1897,749,1148,1214,515,164,1,3,0,433,1464,ITG,ITG2,20,Sardegna
2021-02-06,UMB,396,138,258,333,47,16,0,0,0,34,362,ITI,ITI2,10,Umbria
2021-01-10,SIC,3618,1615,2003,2126,1028,464,0,0,0,3618,0,ITG,ITG1,19,Sicilia
2021-01-16,LIG,1262,547,715,739,223,299,0,0,1,1262,0,ITC,ITC3,7,Liguria
2021-02-22,LIG,3292,1444,1848,695,210,226,2159,0,2,3155,137,ITC,ITC3,7,Liguria
2021-02-23,VEN,7300,3213,4087,978,523,206,5372,69,152,7041,259,ITH,ITH3,5,Veneto
2021-02-23,PAT,1086,389,697,271,20,17,727,3,48,875,211,ITH,ITH2,4,Provincia Autonoma Trento
2021-02-21,ABR,1220,551,669,2,4,3,1209,2,0,1219,1,ITF,ITF1,13,Abruzzo
2021-01-03,PIE,3061,966,2095,2714,295,52,0,0,0,3061,0,ITC,ITC1,1,Piemonte
2021-01-07,UMB,1291,383,908,883,4,404,0,0,0,1291,0,ITI,ITI2,10,Umbria
2021-02-26,UMB,653,250,403,381,71,40,154,4,3,645,8,ITI,ITI2,10,Umbria
2021-02-21,MAR,377,142,235,204,115,57,0,0,1,376,1,ITI,ITI3,11,Marche
2021-01-21,ABR,157,47,110,10,6,141,0,0,0,157,0,ITF,ITF1,13,Abruzzo
2020-12-27,MOL,50,20,30,29,4,17,0,0,0,50,0,ITF,ITF2,14,Molise
2021-01-19,PAB,810,349,461,170,65,0,575,0,0,680,130,ITH,ITH1,4,Provincia Autonoma Bolzano / Bozen
2021-02-07,VDA,292,120,172,110,72,0,105,2,3,190,102,ITC,ITC2,2,Valle d'Aosta / Vall√©e d'Aoste
2021-01-09,VDA,443,199,244,225,196,22,0,0,0,443,0,ITC,ITC2,2,Valle d'Aosta / Vall√©e d'Aoste
2021-02-21,VDA,18,3,15,0,0,18,0,0,0,0,18,ITC,ITC2,2,Valle d'Aosta / Vall√©e d'Aoste
2021-01-21,VDA,33,12,21,0,0,33,0,0,0,33,0,ITC,ITC2,2,Valle d'Aosta / Vall√©e d'Aoste
2021-01-26,EMR,8325,3000,5325,6599,694,1032,0,0,0,218,8107,ITH,ITH5,8,Emilia-Romagna
2021-01-11,LIG,2525,939,1586,1920,329,275,0,0,1,2525,0,ITC,ITC3,7,Liguria
2021-03-01,UMB,1510,777,733,114,28,0,1249,118,1,1396,114,ITI,ITI2,10,Umbria
2021-02-09,CAL,2147,904,1243,1422,494,231,0,0,0,948,1199,ITF,ITF6,18,Calabria
2021-01-31,VEN,4713,1546,3167,3666,679,360,4,2,2,386,4327,ITH,ITH3,5,Veneto
2021-01-09,VEN,7924,2535,5389,5170,1165,1573,3,11,2,7924,0,ITH,ITH3,5,Veneto
2021-02-24,PAT,1302,518,784,229,24,28,955,1,65,907,395,ITH,ITH2,4,Provincia Autonoma Trento
2021-03-07,VDA,64,30,34,16,19,0,26,2,1,11,53,ITC,ITC2,2,Valle d'Aosta / Vall√©e d'Aoste
2021-02-06,MAR,2432,889,1543,1396,640,396,0,0,0,522,1910,ITI,ITI3,11,Marche
2021-01-22,PAT,1628,422,1206,874,128,623,0,0,3,316,1312,ITH,ITH2,4,Provincia Autonoma Trento
2021-01-09,CAL,1916,1036,880,1529,387,0,0,0,0,1916,0,ITF,ITF6,18,Calabria
2021-01-08,CAM,10455,4969,5486,6714,3529,212,0,0,0,10455,0,ITF,ITF3,15,Campania
2021-01-26,SAR,1336,453,883,1296,39,0,0,0,1,27,1309,ITG,ITG2,20,Sardegna
2021-02-04,EMR,9902,3190,6712,6427,1683,1674,118,0,0,1239,8663,ITH,ITH5,8,Emilia-Romagna
2021-02-16,PAT,654,240,414,73,14,3,554,0,10,649,5,ITH,ITH2,4,Provincia Autonoma Trento
2021-02-19,MOL,169,93,76,95,70,1,0,0,3,167,2,ITF,ITF2,14,Molise
2021-02-21,VEN,4625,1203,3422,492,15,18,417,2,3681,4620,5,ITH,ITH3,5,Veneto
2020-12-30,PAB,362,168,194,321,41,0,0,0,0,362,0,ITH,ITH1,4,Provincia Autonoma Bolzano / Bozen
2021-01-15,SIC,5079,2233,2846,2824,1776,479,0,0,0,5079,0,ITG,ITG1,19,Sicilia
2021-03-07,SIC,7648,2885,4763,813,846,335,3043,150,2461,6774,874,ITG,ITG1,19,Sicilia
2021-03-06,BAS,1129,479,650,252,160,8,328,185,196,684,445,ITF,ITF5,17,Basilicata
2021-01-22,BAS,66,24,42,6,60,0,0,0,0,66,0,ITF,ITF5,17,Basilicata
2021-02-23,ABR,2784,1274,1510,324,423,215,1436,286,100,2773,11,ITF,ITF1,13,Abruzzo
2021-01-28,MOL,613,217,396,430,28,154,0,0,1,17,596,ITF,ITF2,14,Molise
2021-01-05,UMB,850,428,422,845,5,0,0,0,0,850,0,ITI,ITI2,10,Umbria
2021-02-28,SAR,367,169,198,244,76,47,0,0,0,141,226,ITG,ITG2,20,Sardegna
2020-12-28,SIC,207,124,83,205,2,0,0,0,0,207,0,ITG,ITG1,19,Sicilia
2021-01-09,PAT,184,40,144,139,14,31,0,0,0,184,0,ITH,ITH2,4,Provincia Autonoma Trento
2021-01-18,VDA,213,74,139,29,111,27,46,0,0,213,0,ITC,ITC2,2,Valle d'Aosta / Vall√©e d'Aoste
2021-02-08,BAS,557,193,364,436,72,49,0,0,0,151,406,ITF,ITF5,17,Basilicata
2021-01-24,LIG,752,234,518,629,63,60,0,0,0,113,639,ITC,ITC3,7,Liguria
2021-01-25,VDA,147,65,82,125,16,6,0,0,0,0,147,ITC,ITC2,2,Valle d'Aosta / Vall√©e d'Aoste
2021-01-27,VDA,151,71,80,53,27,18,53,0,0,79,72,ITC,ITC2,2,Valle d'Aosta / Vall√©e d'Aoste
2021-03-07,VEN,3859,1502,2357,1544,845,11,770,0,689,3332,527,ITH,ITH3,5,Veneto
2021-01-30,PIE,5977,2134,3843,4367,1115,495,0,0,0,218,5759,ITC,ITC1,1,Piemonte
2021-01-11,LOM,15976,5309,10667,10161,5163,552,100,0,0,15976,0,ITC,ITC4,3,Lombardia
2021-02-05,BAS,981,441,540,516,274,191,0,0,0,63,918,ITF,ITF5,17,Basilicata
2021-03-02,VEN,11120,4455,6665,2696,1796,1096,3283,412,1837,7960,3160,ITH,ITH3,5,Veneto
2021-02-25,PUG,11365,4839,6526,1640,863,403,5488,699,2272,10257,1108,ITF,ITF4,16,Puglia
2021-01-15,CAM,4980,2381,2599,2740,2049,191,0,0,0,4980,0,ITF,ITF3,15,Campania
2021-01-01,SIC,815,437,378,740,75,0,0,0,0,815,0,ITG,ITG1,19,Sicilia
2021-02-06,PIE,7979,2663,5316,5097,1627,1255,0,0,0,400,7579,ITC,ITC1,1,Piemonte
2021-01-03,PAT,483,158,325,409,12,62,0,0,0,483,0,ITH,ITH2,4,Provincia Autonoma Trento
2021-02-03,CAM,8902,4002,4900,4735,3452,714,1,0,0,878,8024,ITF,ITF3,15,Campania
2021-02-06,SAR,1970,697,1273,1544,286,139,0,0,1,569,1401,ITG,ITG2,20,Sardegna
2021-02-20,MOL,1018,441,577,20,57,8,933,0,0,998,20,ITF,ITF2,14,Molise
2021-02-22,UMB,1858,777,1081,732,120,1,1005,0,0,1769,89,ITI,ITI2,10,Umbria
2021-01-04,PAT,853,223,630,481,49,322,1,0,0,853,0,ITH,ITH2,4,Provincia Autonoma Trento
2021-02-11,EMR,4241,1412,2829,2527,660,719,333,0,2,3402,839,ITH,ITH5,8,Emilia-Romagna
2021-01-02,ABR,548,218,330,540,8,0,0,0,0,548,0,ITF,ITF1,13,Abruzzo
2021-01-15,LOM,24394,7181,17213,10225,9914,3844,405,6,0,24394,0,ITC,ITC4,3,Lombardia
2021-02-01,LIG,2376,871,1505,1851,209,315,0,0,1,76,2300,ITC,ITC3,7,Liguria
2021-03-06,LAZ,17633,6765,10868,3431,1348,327,7824,931,3772,13442,4191,ITI,ITI4,12,Lazio
2021-01-13,BAS,915,386,529,588,178,148,0,0,1,915,0,ITF,ITF5,17,Basilicata
2021-02-06,ABR,1611,742,869,1168,371,72,0,0,0,602,1009,ITF,ITF1,13,Abruzzo
2021-02-25,PAT,1565,615,950,119,23,32,1310,1,80,1099,466,ITH,ITH2,4,Provincia Autonoma Trento
2021-02-27,SIC,12440,5567,6873,1513,2423,277,3838,1021,3368,11235,1205,ITG,ITG1,19,Sicilia
2021-02-15,MOL,144,70,74,117,12,15,0,0,0,141,3,ITF,ITF2,14,Molise
2021-02-04,FVG,2731,807,1924,1723,543,465,0,0,0,36,2695,ITH,ITH4,6,Friuli-Venezia Giulia
2021-01-10,BAS,77,24,53,9,68,0,0,0,0,77,0,ITF,ITF5,17,Basilicata
2020-12-28,CAL,6,2,4,6,0,0,0,0,0,6,0,ITF,ITF6,18,Calabria
2021-02-13,SAR,1454,563,891,732,464,253,0,0,5,1450,4,ITG,ITG2,20,Sardegna
2021-02-28,VDA,260,86,174,78,58,24,93,3,4,77,183,ITC,ITC2,2,Valle d'Aosta / Vall√©e d'Aoste
2021-01-06,FVG,709,264,445,514,195,0,0,0,0,709,0,ITH,ITH4,6,Friuli-Venezia Giulia
2021-01-31,VDA,290,90,200,231,41,18,0,0,0,58,232,ITC,ITC2,2,Valle d'Aosta / Vall√©e d'Aoste
2021-01-24,SAR,90,34,56,89,1,0,0,0,0,5,85,ITG,ITG2,20,Sardegna
2020-12-27,TOS,620,267,353,460,147,13,0,0,0,620,0,ITI,ITI1,9,Toscana
2021-02-14,PAT,246,186,60,246,0,0,0,0,0,11,235,ITH,ITH2,4,Provincia Autonoma Trento
2021-02-13,SIC,3105,1167,1938,1295,1241,569,0,0,0,2848,257,ITG,ITG1,19,Sicilia
2021-02-28,PUG,5601,1734,3867,559,258,25,1483,194,3082,5415,186,ITF,ITF4,16,Puglia
2020-12-30,FVG,630,246,384,601,29,0,0,0,0,630,0,ITH,ITH4,6,Friuli-Venezia Giulia
2021-03-02,SAR,2686,1404,1282,1024,729,229,319,383,2,1703,983,ITG,ITG2,20,Sardegna
2021-02-13,EMR,3602,1078,2524,2779,492,145,186,0,0,3005,597,ITH,ITH5,8,Emilia-Romagna
2021-01-28,PIE,5555,1801,3754,4107,876,571,1,0,0,351,5204,ITC,ITC1,1,Piemonte
2021-01-25,SIC,7511,3696,3815,6633,808,70,0,0,0,322,7189,ITG,ITG1,19,Sicilia
2021-01-11,PIE,8740,2980,5760,6053,1561,1126,0,0,0,8740,0,ITC,ITC1,1,Piemonte
2021-01-07,TOS,6018,1751,4267,5308,30,680,0,0,0,6018,0,ITI,ITI1,9,Toscana
2021-03-07,LOM,8791,3895,4896,2700,1625,72,3660,410,324,6468,2323,ITC,ITC4,3,Lombardia
2021-02-11,SAR,1313,490,823,588,356,368,1,0,0,1202,111,ITG,ITG2,20,Sardegna
2021-01-30,CAM,10721,5079,5642,6930,3564,227,0,0,0,39,10682,ITF,ITF3,15,Campania
2021-01-11,BAS,183,66,117,78,64,41,0,0,0,183,0,ITF,ITF5,17,Basilicata
2021-02-06,PAT,572,296,276,178,8,0,386,0,0,432,140,ITH,ITH2,4,Provincia Autonoma Trento
2021-02-02,PIE,10178,3490,6688,6826,2034,1318,0,0,0,814,9364,ITC,ITC1,1,Piemonte
2021-02-04,LAZ,6045,2281,3764,4460,621,892,72,0,0,942,5103,ITI,ITI4,12,Lazio
2021-01-18,PAB,1656,638,1018,369,299,7,981,0,0,1652,4,ITH,ITH1,4,Provincia Autonoma Bolzano / Bozen
2021-01-28,BAS,904,401,503,540,281,82,1,0,0,120,784,ITF,ITF5,17,Basilicata
2021-01-22,LAZ,3662,1442,2220,3379,90,70,123,0,0,148,3514,ITI,ITI4,12,Lazio
2021-02-15,UMB,1367,692,675,10,8,0,1349,0,0,1366,1,ITI,ITI2,10,Umbria
2021-02-07,FVG,1559,483,1076,864,693,2,0,0,0,385,1174,ITH,ITH4,6,Friuli-Venezia Giulia
2021-02-23,VDA,216,123,93,0,165,0,0,35,16,216,0,ITC,ITC2,2,Valle d'Aosta / Vall√©e d'Aoste
2021-02-20,LIG,1321,631,690,156,462,118,585,0,0,1320,1,ITC,ITC3,7,Liguria
2021-03-07,PAB,97,11,86,53,40,0,3,0,1,5,92,ITH,ITH1,4,Provincia Autonoma Bolzano / Bozen
2020-12-28,LOM,103,44,59,102,1,0,0,0,0,103,0,ITC,ITC4,3,Lombardia
2021-01-17,MOL,78,38,40,78,0,0,0,0,0,48,30,ITF,ITF2,14,Molise
2021-01-19,FVG,7,2,5,5,0,2,0,0,0,7,0,ITH,ITH4,6,Friuli-Venezia Giulia
2021-03-02,LOM,21556,9185,12371,2977,4162,1951,10661,1675,130,18716,2840,ITC,ITC4,3,Lombardia
2021-01-08,LAZ,7707,2887,4820,6517,392,798,0,0,0,7707,0,ITI,ITI4,12,Lazio
2021-01-26,PUG,5361,2398,2963,4846,282,232,1,0,0,574,4787,ITF,ITF4,16,Puglia
2021-02-20,SIC,4598,2445,2153,564,851,316,2248,513,106,4472,126,ITG,ITG1,19,Sicilia
2021-01-02,PIE,3539,1134,2405,3072,414,53,0,0,0,3539,0,ITC,ITC1,1,Piemonte
2021-01-27,EMR,8315,2933,5382,6885,775,654,0,1,0,463,7852,ITH,ITH5,8,Emilia-Romagna
2021-02-09,LAZ,8392,3484,4908,3258,581,548,4005,0,0,4571,3821,ITI,ITI4,12,Lazio
2021-03-07,CAM,9551,4342,5209,452,3315,85,2983,1011,1705,5850,3701,ITF,ITF3,15,Campania
2021-01-15,FVG,2028,606,1422,1283,370,375,0,0,0,2028,0,ITH,ITH4,6,Friuli-Venezia Giulia
2021-01-14,LOM,26192,7650,18542,11486,9522,4717,459,8,0,26192,0,ITC,ITC4,3,Lombardia
2021-02-02,ABR,1798,677,1121,1243,413,142,0,0,0,241,1557,ITF,ITF1,13,Abruzzo
2021-01-12,UMB,784,247,537,665,14,105,0,0,0,784,0,ITI,ITI2,10,Umbria
2021-02-20,VEN,6312,1980,4332,1764,306,28,970,6,3238,6307,5,ITH,ITH3,5,Veneto
2021-02-17,MAR,1791,664,1127,968,522,300,1,0,0,1672,119,ITI,ITI3,11,Marche
2021-01-26,TOS,5392,1791,3601,4357,84,951,0,0,0,219,5173,ITI,ITI1,9,Toscana
2020-12-31,LAZ,5218,2095,3123,4927,12,279,0,0,0,5218,0,ITI,ITI4,12,Lazio
2021-03-06,TOS,7022,2796,4226,3789,1612,98,30,347,1146,2862,4160,ITI,ITI1,9,Toscana
2021-01-01,UMB,269,102,167,268,1,0,0,0,0,269,0,ITI,ITI2,10,Umbria
2021-01-15,CAL,2793,1258,1535,1690,691,412,0,0,0,2793,0,ITF,ITF6,18,Calabria
2021-01-23,LOM,1114,357,757,500,578,36,0,0,0,916,198,ITC,ITC4,3,Lombardia
2021-03-05,LIG,4573,2027,2546,720,315,81,3141,311,5,3508,1065,ITC,ITC3,7,Liguria
2021-01-26,PAT,497,138,359,397,16,84,0,0,0,25,472,ITH,ITH2,4,Provincia Autonoma Trento
2021-02-26,MAR,3564,1490,2074,446,231,330,2514,4,39,3088,476,ITI,ITI3,11,Marche
2020-12-31,TOS,805,202,603,97,10,698,0,0,0,805,0,ITI,ITI1,9,Toscana
2020-12-27,SIC,89,54,35,62,2,25,0,0,0,89,0,ITG,ITG1,19,Sicilia
2021-01-04,VDA,142,59,83,126,16,0,0,0,0,142,0,ITC,ITC2,2,Valle d'Aosta / Vall√©e d'Aoste
2021-01-21,MOL,6,2,4,0,6,0,0,0,0,6,0,ITF,ITF2,14,Molise
2021-01-01,PAB,1,1,0,1,0,0,0,0,0,1,0,ITH,ITH1,4,Provincia Autonoma Bolzano / Bozen
2020-12-31,PAT,1597,440,1157,819,108,670,0,0,0,1597,0,ITH,ITH2,4,Provincia Autonoma Trento
2021-02-14,CAM,3933,1926,2007,550,905,17,2461,0,0,3890,43,ITF,ITF3,15,Campania
2021-02-23,TOS,7698,3312,4386,1489,1569,202,503,1104,2831,7537,161,ITI,ITI1,9,Toscana
2021-03-02,VDA,339,166,173,17,106,39,107,65,5,336,3,ITC,ITC2,2,Valle d'Aosta / Vall√©e d'Aoste
2021-01-17,MAR,1598,682,916,964,588,46,0,0,0,1549,49,ITI,ITI3,11,Marche
2021-01-14,UMB,749,200,549,696,35,17,0,0,1,749,0,ITI,ITI2,10,Umbria
2021-01-18,PAT,640,154,486,527,40,73,0,0,0,586,54,ITH,ITH2,4,Provincia Autonoma Trento
2021-01-20,ABR,447,156,291,147,96,204,0,0,0,445,2,ITF,ITF1,13,Abruzzo
2021-01-13,PAB,1316,409,907,367,588,255,106,0,0,1316,0,ITH,ITH1,4,Provincia Autonoma Bolzano / Bozen
2021-01-31,LIG,620,267,353,414,71,135,0,0,0,9,611,ITC,ITC3,7,Liguria
2021-03-05,UMB,3876,1159,2717,604,363,7,1,347,2554,3222,654,ITI,ITI2,10,Umbria
2021-02-18,CAL,1798,802,996,585,509,299,344,0,61,1575,223,ITF,ITF6,18,Calabria
2021-03-06,PUG,13182,4999,8183,1649,693,70,4592,460,5718,11596,1586,ITF,ITF4,16,Puglia
2021-02-13,CAL,1330,582,748,731,488,111,0,0,0,967,363,ITF,ITF6,18,Calabria
2020-12-28,LAZ,959,412,547,957,2,0,0,0,0,959,0,ITI,ITI4,12,Lazio
2021-02-12,SAR,2235,932,1303,986,749,499,1,0,0,2174,61,ITG,ITG2,20,Sardegna
2021-01-15,SAR,1563,573,990,1170,390,0,0,3,0,1563,0,ITG,ITG2,20,Sardegna
2021-01-18,SIC,1548,646,902,721,619,208,0,0,0,1432,116,ITG,ITG1,19,Sicilia
2021-01-08,PUG,5571,2335,3236,4842,401,325,0,0,3,5571,0,ITF,ITF4,16,Puglia
2021-01-25,CAL,1064,512,552,1021,43,0,0,0,0,156,908,ITF,ITF6,18,Calabria
2021-03-07,TOS,4569,1936,2633,2350,915,60,0,510,734,1872,2697,ITI,ITI1,9,Toscana
2021-02-19,CAL,1461,652,809,544,341,195,380,1,0,1200,261,ITF,ITF6,18,Calabria
2021-03-01,PUG,14314,5567,8747,1920,896,61,5701,817,4919,12976,1338,ITF,ITF4,16,Puglia
2021-02-21,SIC,5171,2503,2668,376,650,173,3681,138,153,5066,105,ITG,ITG1,19,Sicilia
2021-02-10,LIG,2232,809,1423,1313,414,496,5,0,4,989,1243,ITC,ITC3,7,Liguria
2021-02-25,LOM,14186,5871,8315,2716,1455,1176,7616,1216,7,12791,1395,ITC,ITC4,3,Lombardia
2021-02-05,EMR,9293,2959,6334,6211,1287,1608,187,0,0,1625,7668,ITH,ITH5,8,Emilia-Romagna
2021-02-01,ABR,1632,573,1059,1384,247,1,0,0,0,271,1361,ITF,ITF1,13,Abruzzo
2021-02-09,PUG,3805,1558,2247,2525,660,615,0,0,5,2133,1672,ITF,ITF4,16,Puglia
2021-01-19,LOM,7924,2306,5618,3109,2931,1770,113,1,0,7448,476,ITC,ITC4,3,Lombardia
2021-03-02,MAR,4962,1943,3019,589,274,242,3316,3,538,4396,566,ITI,ITI3,11,Marche
2021-01-05,LAZ,7370,2802,4568,6690,102,577,0,1,0,7370,0,ITI,ITI4,12,Lazio
2021-02-14,LOM,3500,1514,1986,2601,875,24,0,0,0,2936,564,ITC,ITC4,3,Lombardia
2021-02-27,LOM,13554,5707,7847,1954,1805,523,8134,1090,48,13019,535,ITC,ITC4,3,Lombardia
2021-02-02,UMB,942,274,668,713,17,212,0,0,0,32,910,ITI,ITI2,10,Umbria
2021-01-11,CAL,2154,1040,1114,1759,392,3,0,0,0,2154,0,ITF,ITF6,18,Calabria
2021-01-26,CAM,7297,3701,3596,5742,1333,222,0,0,0,352,6945,ITF,ITF3,15,Campania
2021-02-21,FVG,799,280,519,213,177,25,383,1,0,422,377,ITH,ITH4,6,Friuli-Venezia Giulia
2020-12-27,BAS,106,41,65,104,2,0,0,0,0,106,0,ITF,ITF5,17,Basilicata
2021-01-11,VDA,325,112,213,238,57,30,0,0,0,325,0,ITC,ITC2,2,Valle d'Aosta / Vall√©e d'Aoste
2021-01-20,VDA,23,8,15,0,0,6,17,0,0,23,0,ITC,ITC2,2,Valle d'Aosta / Vall√©e d'Aoste
2021-02-15,PAT,528,186,342,144,28,27,320,0,9,415,113,ITH,ITH2,4,Provincia Autonoma Trento
2021-01-13,TOS,4063,1398,2665,3308,350,405,0,0,0,4063,0,ITI,ITI1,9,Toscana
2021-01-06,PAT,42,13,29,42,0,0,0,0,0,42,0,ITH,ITH2,4,Provincia Autonoma Trento
2021-01-03,SAR,90,36,54,89,1,0,0,0,0,90,0,ITG,ITG2,20,Sardegna
2021-02-28,PAT,242,121,121,231,0,0,0,0,11,242,0,ITH,ITH2,4,Provincia Autonoma Trento
2021-01-20,SIC,808,410,398,422,194,192,0,0,0,573,235,ITG,ITG1,19,Sicilia
2021-01-27,TOS,4835,1572,3263,4019,74,742,0,0,0,207,4628,ITI,ITI1,9,Toscana
2021-01-25,PAT,774,205,569,482,30,262,0,0,0,23,751,ITH,ITH2,4,Provincia Autonoma Trento
2021-02-10,TOS,4262,1280,2982,3536,241,484,0,1,0,3739,523,ITI,ITI1,9,Toscana
2021-03-05,LOM,26049,10726,15323,6851,6118,1329,9574,1772,405,18184,7865,ITC,ITC4,3,Lombardia
2021-02-03,LIG,2207,757,1450,1573,251,382,0,0,1,114,2093,ITC,ITC3,7,Liguria
2021-02-21,EMR,4404,1693,2711,394,267,190,3553,0,0,3967,437,ITH,ITH5,8,Emilia-Romagna
2021-01-16,PAB,2748,1229,1519,449,360,77,1861,0,1,2748,0,ITH,ITH1,4,Provincia Autonoma Bolzano / Bozen
2021-02-18,BAS,1065,400,665,264,78,149,574,0,0,849,216,ITF,ITF5,17,Basilicata
2021-02-19,VEN,7269,3111,4158,1484,900,505,4372,3,5,7067,202,ITH,ITH3,5,Veneto
2021-01-07,CAL,2180,1061,1119,1883,297,0,0,0,0,2180,0,ITF,ITF6,18,Calabria
2021-02-12,CAM,6549,2872,3677,1808,1467,214,3056,0,4,6336,213,ITF,ITF3,15,Campania
2021-02-28,EMR,6799,2520,4279,1768,463,53,4217,4,294,4956,1843,ITH,ITH5,8,Emilia-Romagna
2021-01-22,CAM,1523,775,748,970,344,209,0,0,0,673,850,ITF,ITF3,15,Campania
2021-02-22,PUG,9395,4424,4971,1397,718,140,6609,221,310,9066,329,ITF,ITF4,16,Puglia
2021-03-05,FVG,3156,1221,1935,801,528,18,1663,2,144,2469,687,ITH,ITH4,6,Friuli-Venezia Giulia
2021-01-19,MOL,173,63,110,90,59,22,0,0,2,162,11,ITF,ITF2,14,Molise
2021-01-06,VEN,8126,2380,5746,6304,1010,807,1,2,2,8126,0,ITH,ITH3,5,Veneto
2021-02-23,CAL,1549,728,821,437,381,206,522,2,1,1434,115,ITF,ITF6,18,Calabria
2021-02-05,LIG,2492,907,1585,1606,419,464,0,0,3,301,2191,ITC,ITC3,7,Liguria
2021-02-08,PAT,1148,318,830,550,59,237,302,0,0,340,808,ITH,ITH2,4,Provincia Autonoma Trento
2020-12-29,SAR,57,32,25,56,1,0,0,0,0,57,0,ITG,ITG2,20,Sardegna
