data_somministrazione,area,totale,sesso_maschile,sesso_femminile,prima_dose,seconda_dose,codice_NUTS1,codice_NUTS2,codice_regione_ISTAT,nome_area
2021-01-26,MAR,2020,747,1273,90,1930,ITI,ITI3,11,Marche
2021-03-09,CAL,6407,3309,3098,5426,981,ITF,ITF6,18,Calabria
2021-05-17,VEN,26489,12976,13513,16475,10014,ITH,ITH3,5,Veneto
2021-03-26,LIG,9330,4025,5305,6175,3155,ITC,ITC3,7,Liguria
2021-03-28,LOM,20481,7817,12664,14317,6164,ITC,ITC4,3,Lombardia
2021-04-11,SIC,15378,7593,7785,8348,7030,ITG,ITG1,19,Sicilia
2021-05-22,TOS,26009,12654,13355,21724,4285,ITI,ITI1,9,Toscana
2021-02-06,VEN,4095,1354,2741,709,3386,ITH,ITH3,5,Veneto
2021-04-14,LOM,47171,21024,26147,34201,12970,ITC,ITC4,3,Lombardia
2021-02-20,CAL,1433,764,669,1114,319,ITF,ITF6,18,Calabria
2021-05-26,LAZ,47480,21806,25674,35378,12102,ITI,ITI4,12,Lazio
2021-07-04,LIG,2331,1281,1050,1964,367,ITC,ITC3,7,Liguria
2021-01-02,LIG,691,245,446,691,0,ITC,ITC3,7,Liguria
2021-01-04,LOM,6100,2103,3997,6100,0,ITC,ITC4,3,Lombardia
2021-01-30,FVG,2277,745,1532,270,2007,ITH,ITH4,6,Friuli-Venezia Giulia
2021-03-04,LAZ,19412,8719,10693,14394,5018,ITI,ITI4,12,Lazio
2021-04-21,PAT,2910,1359,1551,2860,50,ITH,ITH2,4,Provincia Autonoma Trento
2021-05-05,TOS,30112,13439,16673,15601,14511,ITI,ITI1,9,Toscana
2021-06-12,LAZ,63762,29040,34722,34412,29350,ITI,ITI4,12,Lazio
2021-04-24,PAB,5105,2450,2655,4620,485,ITH,ITH1,4,Provincia Autonoma Bolzano / Bozen
2021-07-03,UMB,6313,3174,3139,2971,3342,ITI,ITI2,10,Umbria
2021-02-05,VDA,294,102,192,101,193,ITC,ITC2,2,Valle d'Aosta / Vallée d'Aoste
2021-02-07,PUG,1579,669,910,253,1326,ITF,ITF4,16,Puglia
2021-05-19,SAR,17018,8664,8354,12780,4238,ITG,ITG2,20,Sardegna
2021-01-21,PUG,2132,904,1228,1271,861,ITF,ITF4,16,Puglia
2021-01-22,ABR,118,57,61,118,0,ITF,ITF1,13,Abruzzo
2021-02-22,VDA,316,94,222,213,103,ITC,ITC2,2,Valle d'Aosta / Vallée d'Aoste
2021-03-28,CAM,15556,7504,8052,13931,1625,ITF,ITF3,15,Campania
2021-04-23,PIE,27447,12603,14844,20685,6762,ITC,ITC1,1,Piemonte
2021-02-28,TOS,1649,667,982,922,727,ITI,ITI1,9,Toscana
2021-05-01,PUG,27610,12645,14965,16960,10650,ITF,ITF4,16,Puglia
2021-06-05,SAR,17865,8430,9435,11413,6452,ITG,ITG2,20,Sardegna
2021-02-23,VEN,7383,3254,4129,7112,271,ITH,ITH3,5,Veneto
2021-04-19,MAR,9601,4497,5104,8020,1581,ITI,ITI3,11,Marche
2021-05-31,CAL,15265,7326,7939,7384,7881,ITF,ITF6,18,Calabria
2021-02-25,SAR,2899,1255,1644,2294,605,ITG,ITG2,20,Sardegna
2021-01-04,CAM,5826,2963,2863,5826,0,ITF,ITF3,15,Campania
2021-02-11,TOS,5384,2022,3362,5142,242,ITI,ITI1,9,Toscana
2021-05-16,VDA,688,341,347,347,341,ITC,ITC2,2,Valle d'Aosta / Vallée d'Aoste
2021-01-30,EMR,10079,3520,6559,141,9938,ITH,ITH5,8,Emilia-Romagna
2021-03-14,SAR,607,376,231,607,0,ITG,ITG2,20,Sardegna
2021-03-24,MOL,1631,658,973,1229,402,ITF,ITF2,14,Molise
2020-12-30,SIC,184,109,75,184,0,ITG,ITG1,19,Sicilia
2021-02-09,TOS,4488,1468,3020,3877,611,ITI,ITI1,9,Toscana
2021-04-05,PAB,301,144,157,23,278,ITH,ITH1,4,Provincia Autonoma Bolzano / Bozen
2021-07-02,MOL,2571,1248,1323,126,2445,ITF,ITF2,14,Molise
2021-06-14,LAZ,62530,29326,33204,32415,30115,ITI,ITI4,12,Lazio
2021-06-19,CAM,61121,29082,32039,23412,37709,ITF,ITF3,15,Campania
2021-06-27,PAB,4413,2307,2106,607,3806,ITH,ITH1,4,Provincia Autonoma Bolzano / Bozen
2021-01-16,SIC,2579,1152,1427,2579,0,ITG,ITG1,19,Sicilia
2021-01-28,PAT,530,147,383,48,482,ITH,ITH2,4,Provincia Autonoma Trento
2021-07-01,SIC,30586,13866,16720,10613,19973,ITG,ITG1,19,Sicilia
2021-01-11,PAT,732,223,509,732,0,ITH,ITH2,4,Provincia Autonoma Trento
2021-01-22,BAS,67,24,43,67,0,ITF,ITF5,17,Basilicata
2021-06-19,LOM,103294,51499,51795,58506,44788,ITC,ITC4,3,Lombardia
2021-03-21,LAZ,18226,7162,11064,13175,5051,ITI,ITI4,12,Lazio
2021-04-09,SIC,20282,9876,10406,11206,9076,ITG,ITG1,19,Sicilia
2021-01-12,PAB,1709,459,1250,1709,0,ITH,ITH1,4,Provincia Autonoma Bolzano / Bozen
2021-03-23,SIC,20831,10006,10825,15318,5513,ITG,ITG1,19,Sicilia
2021-01-02,PUG,2950,1302,1648,2950,0,ITF,ITF4,16,Puglia
2021-01-03,ABR,471,185,286,471,0,ITF,ITF1,13,Abruzzo
2021-07-04,MOL,697,351,346,97,600,ITF,ITF2,14,Molise
2021-04-12,PUG,29251,13779,15472,26374,2877,ITF,ITF4,16,Puglia
2020-12-30,LAZ,1630,629,1001,1630,0,ITI,ITI4,12,Lazio
2021-02-16,PAT,666,246,420,661,5,ITH,ITH2,4,Provincia Autonoma Trento
2021-03-09,CAM,14124,6870,7254,10339,3785,ITF,ITF3,15,Campania
2021-05-02,BAS,4180,2001,2179,3551,629,ITF,ITF5,17,Basilicata
2021-06-26,FVG,9495,4835,4660,3356,6139,ITH,ITH4,6,Friuli-Venezia Giulia
2021-04-15,BAS,3386,1659,1727,2632,754,ITF,ITF5,17,Basilicata
2021-07-01,LAZ,47580,22745,24835,7158,40422,ITI,ITI4,12,Lazio
2021-01-17,MOL,78,38,40,48,30,ITF,ITF2,14,Molise
2021-06-15,LIG,17072,8294,8778,9013,8059,ITC,ITC3,7,Liguria
2021-07-04,PUG,6992,3440,3552,2256,4736,ITF,ITF4,16,Puglia
2021-02-14,MAR,738,301,437,738,0,ITI,ITI3,11,Marche
2021-04-28,VEN,32395,15168,17227,23377,9018,ITH,ITH3,5,Veneto
2021-04-23,EMR,29562,13811,15751,14680,14882,ITH,ITH5,8,Emilia-Romagna
2021-04-23,PAT,3638,1770,1868,3584,54,ITH,ITH2,4,Provincia Autonoma Trento
2021-01-30,PAT,386,132,254,152,234,ITH,ITH2,4,Provincia Autonoma Trento
2021-04-21,FVG,7754,3458,4296,4074,3680,ITH,ITH4,6,Friuli-Venezia Giulia
2020-12-28,SIC,214,128,86,214,0,ITG,ITG1,19,Sicilia
2021-01-13,EMR,9077,2942,6135,9077,0,ITH,ITH5,8,Emilia-Romagna
2021-03-27,ABR,6121,2620,3501,3635,2486,ITF,ITF1,13,Abruzzo
2021-04-09,LAZ,27578,12511,15067,19325,8253,ITI,ITI4,12,Lazio
2021-01-11,FVG,1882,608,1274,1882,0,ITH,ITH4,6,Friuli-Venezia Giulia
2021-03-23,LAZ,25224,11783,13441,18628,6596,ITI,ITI4,12,Lazio
2021-04-10,MOL,2640,1261,1379,2488,152,ITF,ITF2,14,Molise
2021-05-10,PAT,3212,1646,1566,2707,505,ITH,ITH2,4,Provincia Autonoma Trento
2021-06-26,PIE,40975,20848,20127,22598,18377,ITC,ITC1,1,Piemonte
2021-03-07,LIG,1915,1138,777,1614,301,ITC,ITC3,7,Liguria
2021-05-31,CAM,40710,20654,20056,30401,10309,ITF,ITF3,15,Campania
2021-01-03,BAS,901,344,557,901,0,ITF,ITF5,17,Basilicata
2021-01-01,UMB,273,104,169,273,0,ITI,ITI2,10,Umbria
2021-02-05,MOL,593,269,324,55,538,ITF,ITF2,14,Molise
2021-04-11,UMB,3097,1504,1593,3048,49,ITI,ITI2,10,Umbria
2021-04-30,SAR,11134,5301,5833,6923,4211,ITG,ITG2,20,Sardegna
2021-01-18,VEN,2762,776,1986,2563,199,ITH,ITH3,5,Veneto
2021-01-05,ABR,1615,604,1011,1615,0,ITF,ITF1,13,Abruzzo
2021-04-11,CAM,17523,8606,8917,15441,2082,ITF,ITF3,15,Campania
2021-05-24,FVG,11418,5523,5895,7802,3616,ITH,ITH4,6,Friuli-Venezia Giulia
2021-06-04,BAS,4829,2286,2543,3783,1046,ITF,ITF5,17,Basilicata
2021-02-22,ABR,2642,1173,1469,2612,30,ITF,ITF1,13,Abruzzo
2021-06-02,UMB,3914,1881,2033,3874,40,ITI,ITI2,10,Umbria
2021-02-13,FVG,566,179,387,560,6,ITH,ITH4,6,Friuli-Venezia Giulia
2021-02-18,LAZ,10018,4975,5043,9207,811,ITI,ITI4,12,Lazio
2021-02-21,PUG,2177,474,1703,2115,62,ITF,ITF4,16,Puglia
2021-04-28,CAM,36434,17641,18793,26678,9756,ITF,ITF3,15,Campania
2021-01-18,CAM,958,399,559,714,244,ITF,ITF3,15,Campania
2021-06-01,PUG,34762,17391,17371,21911,12851,ITF,ITF4,16,Puglia
2021-02-24,BAS,1803,743,1060,1734,69,ITF,ITF5,17,Basilicata
2021-05-15,PUG,43534,18953,24581,23531,20003,ITF,ITF4,16,Puglia
2021-05-26,EMR,33220,14728,18492,10299,22921,ITH,ITH5,8,Emilia-Romagna
2021-04-26,LIG,10555,4981,5574,7918,2637,ITC,ITC3,7,Liguria
2021-05-12,LAZ,47544,21575,25969,30897,16647,ITI,ITI4,12,Lazio
2021-06-17,VEN,50954,25550,25404,26048,24906,ITH,ITH3,5,Veneto
2021-06-29,PAT,6217,3131,3086,2716,3501,ITH,ITH2,4,Provincia Autonoma Trento
2021-06-12,EMR,40422,21369,19053,35513,4909,ITH,ITH5,8,Emilia-Romagna
2021-06-12,PAT,5359,2688,2671,472,4887,ITH,ITH2,4,Provincia Autonoma Trento
2021-03-09,VEN,16543,7446,9097,10220,6323,ITH,ITH3,5,Veneto
2021-04-05,MAR,5691,2358,3333,4422,1269,ITI,ITI3,11,Marche
2021-02-05,ABR,1534,521,1013,788,746,ITF,ITF1,13,Abruzzo
2021-03-04,EMR,16452,5350,11102,13435,3017,ITH,ITH5,8,Emilia-Romagna
2021-02-19,MOL,169,93,76,167,2,ITF,ITF2,14,Molise
2021-01-16,LIG,1278,557,721,1278,0,ITC,ITC3,7,Liguria
2021-05-16,ABR,9577,4137,5440,5765,3812,ITF,ITF1,13,Abruzzo
2021-05-31,VEN,31598,16217,15381,21684,9914,ITH,ITH3,5,Veneto
2021-02-01,LAZ,5676,2178,3498,354,5322,ITI,ITI4,12,Lazio
2021-03-02,FVG,4220,1519,2701,2721,1499,ITH,ITH4,6,Friuli-Venezia Giulia
2021-03-21,PAT,129,69,60,129,0,ITH,ITH2,4,Provincia Autonoma Trento
2021-06-03,PUG,50314,24408,25906,31082,19232,ITF,ITF4,16,Puglia
2021-06-04,ABR,15607,7376,8231,10919,4688,ITF,ITF1,13,Abruzzo
2021-06-27,MAR,9818,4750,5068,4528,5290,ITI,ITI3,11,Marche
2021-02-22,BAS,1790,773,1017,1737,53,ITF,ITF5,17,Basilicata
2021-02-20,UMB,283,101,182,259,24,ITI,ITI2,10,Umbria
2021-05-24,PIE,28985,13422,15563,17024,11961,ITC,ITC1,1,Piemonte
2021-06-19,SAR,15330,7507,7823,9210,6120,ITG,ITG2,20,Sardegna
2021-02-02,LIG,2671,1005,1666,129,2542,ITC,ITC3,7,Liguria
2021-05-18,ABR,12110,5660,6450,7730,4380,ITF,ITF1,13,Abruzzo
2021-03-22,PAB,1144,523,621,1139,5,ITH,ITH1,4,Provincia Autonoma Bolzano / Bozen
2021-04-15,VDA,810,377,433,671,139,ITC,ITC2,2,Valle d'Aosta / Vallée d'Aoste
2021-05-24,EMR,29944,13716,16228,18468,11476,ITH,ITH5,8,Emilia-Romagna
2021-06-05,LOM,102110,52794,49316,92343,9767,ITC,ITC4,3,Lombardia
2021-02-13,EMR,3627,1084,2543,3029,598,ITH,ITH5,8,Emilia-Romagna
2021-02-24,ABR,3305,1441,1864,3129,176,ITF,ITF1,13,Abruzzo
2021-03-19,MAR,3834,1598,2236,337,3497,ITI,ITI3,11,Marche
2021-03-26,VEN,29580,13143,16437,24118,5462,ITH,ITH3,5,Veneto
2021-04-30,CAL,14973,7342,7631,10616,4357,ITF,ITF6,18,Calabria
2021-03-09,UMB,4088,2000,2088,2800,1288,ITI,ITI2,10,Umbria
2021-03-10,MOL,1737,720,1017,1687,50,ITF,ITF2,14,Molise
2021-03-28,SAR,4646,1839,2807,4566,80,ITG,ITG2,20,Sardegna
2021-03-04,FVG,3451,1597,1854,2792,659,ITH,ITH4,6,Friuli-Venezia Giulia
2021-03-02,PIE,11202,4506,6696,10386,816,ITC,ITC1,1,Piemonte
2021-03-14,LOM,14874,5348,9526,11591,3283,ITC,ITC4,3,Lombardia
2021-01-04,SAR,592,217,375,592,0,ITG,ITG2,20,Sardegna
2021-06-01,MOL,2598,1322,1276,2490,108,ITF,ITF2,14,Molise
2021-04-28,LIG,14444,6520,7924,6460,7984,ITC,ITC3,7,Liguria
2021-03-10,PUG,14809,6613,8196,11686,3123,ITF,ITF4,16,Puglia
2021-06-12,FVG,8076,4631,3445,6918,1158,ITH,ITH4,6,Friuli-Venezia Giulia
2021-02-04,LIG,2817,986,1831,179,2638,ITC,ITC3,7,Liguria
2021-04-02,TOS,31983,13566,18417,23957,8026,ITI,ITI1,9,Toscana
2021-05-24,PAT,4383,2012,2371,1361,3022,ITH,ITH2,4,Provincia Autonoma Trento
2021-03-17,MAR,3430,1496,1934,107,3323,ITI,ITI3,11,Marche
2021-03-28,VEN,31294,13603,17691,27682,3612,ITH,ITH3,5,Veneto
2021-05-15,LIG,7306,3264,4042,4352,2954,ITC,ITC3,7,Liguria
2021-05-31,SIC,37907,17049,20858,21571,16336,ITG,ITG1,19,Sicilia
2021-06-19,VEN,48411,24642,23769,25928,22483,ITH,ITH3,5,Veneto
2021-01-13,LAZ,5694,2151,3543,5694,0,ITI,ITI4,12,Lazio
2021-02-21,LIG,869,491,378,865,4,ITC,ITC3,7,Liguria
2021-02-23,LOM,11829,4803,7026,11497,332,ITC,ITC4,3,Lombardia
2021-03-02,PAT,1307,440,867,931,376,ITH,ITH2,4,Provincia Autonoma Trento
2021-03-21,FVG,2672,1000,1672,2263,409,ITH,ITH4,6,Friuli-Venezia Giulia
2021-06-24,TOS,29406,14595,14811,19679,9727,ITI,ITI1,9,Toscana
2021-01-18,CAL,1290,583,707,1052,238,ITF,ITF6,18,Calabria
2021-04-23,LAZ,37696,18097,19599,22420,15276,ITI,ITI4,12,Lazio
2021-06-10,PAT,6125,2978,3147,1916,4209,ITH,ITH2,4,Provincia Autonoma Trento
2021-03-29,PUG,13537,6598,6939,6796,6741,ITF,ITF4,16,Puglia
2021-06-12,PIE,42468,22380,20088,39848,2620,ITC,ITC1,1,Piemonte
2021-03-05,PAB,1840,625,1215,1397,443,ITH,ITH1,4,Provincia Autonoma Bolzano / Bozen
2021-05-17,CAM,49359,21700,27659,24103,25256,ITF,ITF3,15,Campania
2021-07-03,CAL,14957,7030,7927,5175,9782,ITF,ITF6,18,Calabria
2021-06-23,BAS,3306,1555,1751,2431,875,ITF,ITF5,17,Basilicata
2021-01-09,TOS,4485,1596,2889,4485,0,ITI,ITI1,9,Toscana
2021-02-06,CAM,5341,2666,2675,2102,3239,ITF,ITF3,15,Campania
2021-04-13,VDA,373,171,202,329,44,ITC,ITC2,2,Valle d'Aosta / Vallée d'Aoste
2021-02-28,MAR,2836,1251,1585,2830,6,ITI,ITI3,11,Marche
2021-04-11,CAL,4186,1902,2284,2243,1943,ITF,ITF6,18,Calabria
2021-04-14,VEN,15906,6895,9011,9279,6627,ITH,ITH3,5,Veneto
2021-05-27,PAB,6087,3200,2887,4077,2010,ITH,ITH1,4,Provincia Autonoma Bolzano / Bozen
2021-05-31,UMB,5802,2837,2965,4918,884,ITI,ITI2,10,Umbria
2021-03-12,PUG,14275,6434,7841,10347,3928,ITF,ITF4,16,Puglia
2021-04-16,SAR,14449,6490,7959,9106,5343,ITG,ITG2,20,Sardegna
2021-01-04,VEN,6736,2034,4702,6736,0,ITH,ITH3,5,Veneto
2021-03-27,VDA,333,164,169,302,31,ITC,ITC2,2,Valle d'Aosta / Vallée d'Aoste
2021-06-08,MAR,13914,7013,6901,11303,2611,ITI,ITI3,11,Marche
2021-05-14,UMB,5323,2507,2816,3506,1817,ITI,ITI2,10,Umbria
2021-03-02,SIC,14666,6305,8361,11892,2774,ITG,ITG1,19,Sicilia
2021-05-30,ABR,8657,4110,4547,5404,3253,ITF,ITF1,13,Abruzzo
2021-03-09,SAR,5547,2742,2805,4818,729,ITG,ITG2,20,Sardegna
2021-01-04,SIC,8385,4190,4195,8385,0,ITG,ITG1,19,Sicilia
2021-04-03,ABR,5160,2257,2903,3563,1597,ITF,ITF1,13,Abruzzo
2021-01-28,LIG,2847,971,1876,39,2808,ITC,ITC3,7,Liguria
2021-02-11,PIE,6764,2107,4657,3006,3758,ITC,ITC1,1,Piemonte
2021-05-05,SAR,10163,4647,5516,8150,2013,ITG,ITG2,20,Sardegna
2021-01-18,SIC,1563,639,924,1410,153,ITG,ITG1,19,Sicilia
2021-01-23,VEN,4051,1246,2805,31,4020,ITH,ITH3,5,Veneto
2021-06-29,VEN,44579,22278,22301,18972,25607,ITH,ITH3,5,Veneto
2021-07-01,CAL,12062,5691,6371,5242,6820,ITF,ITF6,18,Calabria
2021-01-26,PAB,810,291,519,1,809,ITH,ITH1,4,Provincia Autonoma Bolzano / Bozen
2021-04-09,PIE,25858,11392,14466,21351,4507,ITC,ITC1,1,Piemonte
2021-06-24,CAM,64938,31279,33659,12726,52212,ITF,ITF3,15,Campania
2021-07-02,PAB,3148,1626,1522,979,2169,ITH,ITH1,4,Provincia Autonoma Bolzano / Bozen
2021-03-21,VEN,11981,4753,7228,8518,3463,ITH,ITH3,5,Veneto
2021-04-28,SIC,29208,13703,15505,20112,9096,ITG,ITG1,19,Sicilia
2020-12-30,PIE,730,322,408,730,0,ITC,ITC1,1,Piemonte
2021-03-16,CAM,8086,3519,4567,3772,4314,ITF,ITF3,15,Campania
2021-03-24,PAB,2064,999,1065,2051,13,ITH,ITH1,4,Provincia Autonoma Bolzano / Bozen
2021-06-05,PIE,36924,18916,18008,32467,4457,ITC,ITC1,1,Piemonte
2021-04-28,LOM,95727,43665,52062,68823,26904,ITC,ITC4,3,Lombardia
2021-06-22,TOS,30981,15574,15407,22809,8172,ITI,ITI1,9,Toscana
2021-02-25,PIE,12219,5252,6967,11672,547,ITC,ITC1,1,Piemonte
2021-06-24,LOM,106096,54925,51171,77813,28283,ITC,ITC4,3,Lombardia
2021-03-16,LAZ,13544,5739,7805,7100,6444,ITI,ITI4,12,Lazio
2021-03-16,LOM,25496,10113,15383,16418,9078,ITC,ITC4,3,Lombardia
2021-01-23,EMR,2448,871,1577,443,2005,ITH,ITH5,8,Emilia-Romagna
2021-05-12,LOM,87474,41745,45729,59919,27555,ITC,ITC4,3,Lombardia
2021-01-21,MAR,918,261,657,591,327,ITI,ITI3,11,Marche
2021-05-30,BAS,2775,1419,1356,923,1852,ITF,ITF5,17,Basilicata
2021-04-09,PAT,2740,1162,1578,1540,1200,ITH,ITH2,4,Provincia Autonoma Trento
2021-05-02,VDA,765,345,420,605,160,ITC,ITC2,2,Valle d'Aosta / Vallée d'Aoste
2021-05-07,EMR,35271,16961,18310,23416,11855,ITH,ITH5,8,Emilia-Romagna
2021-05-17,TOS,29694,14812,14882,20822,8872,ITI,ITI1,9,Toscana
2021-02-18,FVG,3218,1492,1726,2811,407,ITH,ITH4,6,Friuli-Venezia Giulia
2021-04-03,BAS,1808,749,1059,1472,336,ITF,ITF5,17,Basilicata
2021-05-01,MAR,9318,3924,5394,3576,5742,ITI,ITI3,11,Marche
2021-01-22,VDA,56,21,35,20,36,ITC,ITC2,2,Valle d'Aosta / Vallée d'Aoste
2021-02-11,PAT,1135,365,770,796,339,ITH,ITH2,4,Provincia Autonoma Trento
2021-03-21,TOS,3293,1627,1666,1860,1433,ITI,ITI1,9,Toscana
2021-07-03,EMR,30643,15186,15457,10839,19804,ITH,ITH5,8,Emilia-Romagna
2021-02-09,PUG,3839,1569,2270,2167,1672,ITF,ITF4,16,Puglia
2021-03-09,LAZ,21957,9911,12046,16758,5199,ITI,ITI4,12,Lazio
2021-01-08,VDA,299,130,169,299,0,ITC,ITC2,2,Valle d'Aosta / Vallée d'Aoste
2021-01-23,TOS,3966,1360,2606,640,3326,ITI,ITI1,9,Toscana
2021-02-25,PAT,1641,643,998,1200,441,ITH,ITH2,4,Provincia Autonoma Trento
2021-06-29,TOS,36947,17983,18964,8116,28831,ITI,ITI1,9,Toscana
2021-01-11,LAZ,5542,2109,3433,5542,0,ITI,ITI4,12,Lazio
2021-04-02,FVG,6594,2926,3668,4756,1838,ITH,ITH4,6,Friuli-Venezia Giulia
2021-05-20,PUG,33566,15230,18336,21227,12339,ITF,ITF4,16,Puglia
2021-06-14,UMB,5369,2744,2625,3360,2009,ITI,ITI2,10,Umbria
2020-12-30,PAT,7,3,4,7,0,ITH,ITH2,4,Provincia Autonoma Trento
2021-03-06,VDA,22,4,18,22,0,ITC,ITC2,2,Valle d'Aosta / Vallée d'Aoste
2021-05-03,TOS,11927,5507,6420,10610,1317,ITI,ITI1,9,Toscana
2021-06-05,PAT,4081,1915,2166,750,3331,ITH,ITH2,4,Provincia Autonoma Trento
2021-01-25,CAM,5746,2927,2819,163,5583,ITF,ITF3,15,Campania
2021-03-24,PUG,13569,6507,7062,6262,7307,ITF,ITF4,16,Puglia
2021-07-01,CAM,59439,28820,30619,18679,40760,ITF,ITF3,15,Campania
2021-01-12,MOL,336,114,222,336,0,ITF,ITF2,14,Molise
2021-01-16,VEN,4611,1542,3069,4611,0,ITH,ITH3,5,Veneto
2021-02-01,CAL,2516,1199,1317,244,2272,ITF,ITF6,18,Calabria
2021-03-10,PAB,1268,529,739,1125,143,ITH,ITH1,4,Provincia Autonoma Bolzano / Bozen
2021-01-26,PUG,5363,2397,2966,571,4792,ITF,ITF4,16,Puglia
2021-03-23,CAM,15740,7443,8297,13227,2513,ITF,ITF3,15,Campania
2021-07-02,PUG,43121,20495,22626,16420,26701,ITF,ITF4,16,Puglia
2021-03-14,VEN,15176,5942,9234,14282,894,ITH,ITH3,5,Veneto
2021-05-06,PAB,5181,2747,2434,2613,2568,ITH,ITH1,4,Provincia Autonoma Bolzano / Bozen
2021-05-12,CAL,16401,7999,8402,10913,5488,ITF,ITF6,18,Calabria
2021-02-05,BAS,987,444,543,64,923,ITF,ITF5,17,Basilicata
2021-03-05,MAR,6208,2868,3340,4740,1468,ITI,ITI3,11,Marche
2021-04-16,FVG,6950,3020,3930,5025,1925,ITH,ITH4,6,Friuli-Venezia Giulia
2021-05-06,PUG,39556,17296,22260,19877,19679,ITF,ITF4,16,Puglia
2021-05-19,CAM,51155,22603,28552,34546,16609,ITF,ITF3,15,Campania
2021-02-24,MOL,666,278,388,333,333,ITF,ITF2,14,Molise
2021-05-22,PAT,3258,1598,1660,925,2333,ITH,ITH2,4,Provincia Autonoma Trento
2021-05-26,CAL,18669,9279,9390,10400,8269,ITF,ITF6,18,Calabria
2021-01-06,FVG,710,264,446,710,0,ITH,ITH4,6,Friuli-Venezia Giulia
2021-01-07,MAR,1808,636,1172,1808,0,ITI,ITI3,11,Marche
2021-01-21,LIG,1106,385,721,675,431,ITC,ITC3,7,Liguria
2021-03-02,SAR,3061,1640,1421,1908,1153,ITG,ITG2,20,Sardegna
2021-05-16,BAS,4972,2468,2504,2859,2113,ITF,ITF5,17,Basilicata
2021-03-30,CAL,6381,2754,3627,3636,2745,ITF,ITF6,18,Calabria
2021-04-02,PIE,20143,8304,11839,11716,8427,ITC,ITC1,1,Piemonte
2021-04-28,SAR,9026,4282,4744,5323,3703,ITG,ITG2,20,Sardegna
2021-02-12,ABR,1228,567,661,1039,189,ITF,ITF1,13,Abruzzo
2021-01-18,SAR,904,326,578,780,124,ITG,ITG2,20,Sardegna
2021-05-29,PIE,32798,15226,17572,20630,12168,ITC,ITC1,1,Piemonte
2021-06-24,SAR,19150,9197,9953,8204,10946,ITG,ITG2,20,Sardegna
2021-02-23,SIC,8685,4590,4095,8219,466,ITG,ITG1,19,Sicilia
2021-05-23,ABR,9881,4696,5185,7189,2692,ITF,ITF1,13,Abruzzo
2021-02-18,PIE,4791,2094,2697,4361,430,ITC,ITC1,1,Piemonte
2021-03-16,SAR,4374,1949,2425,3452,922,ITG,ITG2,20,Sardegna
2021-03-17,PAB,582,213,369,580,2,ITH,ITH1,4,Provincia Autonoma Bolzano / Bozen
2021-03-09,SIC,13081,5702,7379,10881,2200,ITG,ITG1,19,Sicilia
2021-05-10,VEN,36456,17048,19408,26604,9852,ITH,ITH3,5,Veneto
2021-02-07,MOL,66,32,34,19,47,ITF,ITF2,14,Molise
2021-05-18,MOL,1645,877,768,990,655,ITF,ITF2,14,Molise
2021-05-19,PIE,33157,15307,17850,22032,11125,ITC,ITC1,1,Piemonte
2021-02-13,SIC,2977,1123,1854,2722,255,ITG,ITG1,19,Sicilia
2021-05-24,LOM,89505,43479,46026,49511,39994,ITC,ITC4,3,Lombardia
2021-03-22,MOL,1148,440,708,905,243,ITF,ITF2,14,Molise
2021-02-18,EMR,7039,2892,4147,6456,583,ITH,ITH5,8,Emilia-Romagna
2021-05-04,BAS,4137,1991,2146,3614,523,ITF,ITF5,17,Basilicata
2021-03-14,PIE,8205,3336,4869,5308,2897,ITC,ITC1,1,Piemonte
2021-04-09,SAR,12307,5472,6835,7954,4353,ITG,ITG2,20,Sardegna
2021-03-08,BAS,1460,713,747,847,613,ITF,ITF5,17,Basilicata
2021-06-24,FVG,10939,5583,5356,1917,9022,ITH,ITH4,6,Friuli-Venezia Giulia
2021-05-10,PIE,28951,13957,14994,15833,13118,ITC,ITC1,1,Piemonte
2021-06-06,PAB,4530,2176,2354,855,3675,ITH,ITH1,4,Provincia Autonoma Bolzano / Bozen
2021-05-24,SIC,35702,17313,18389,15711,19991,ITG,ITG1,19,Sicilia
2021-01-30,PIE,5980,2136,3844,218,5762,ITC,ITC1,1,Piemonte
2021-02-26,PAB,1526,551,975,1496,30,ITH,ITH1,4,Provincia Autonoma Bolzano / Bozen
2021-03-05,PUG,17685,7167,10518,15380,2305,ITF,ITF4,16,Puglia
2021-02-11,LOM,17080,5010,12070,9707,7373,ITC,ITC4,3,Lombardia
2021-04-07,TOS,35824,15462,20362,28576,7248,ITI,ITI1,9,Toscana
2021-01-06,CAL,932,503,429,932,0,ITF,ITF6,18,Calabria
2021-02-26,PUG,13762,5054,8708,12728,1034,ITF,ITF4,16,Puglia
2020-12-31,PUG,1634,782,852,1634,0,ITF,ITF4,16,Puglia
2021-02-16,LIG,2426,956,1470,2004,422,ITC,ITC3,7,Liguria
2021-03-16,FVG,3155,1288,1867,1074,2081,ITH,ITH4,6,Friuli-Venezia Giulia
2021-06-16,BAS,4590,2082,2508,2136,2454,ITF,ITF5,17,Basilicata
2021-05-12,FVG,10868,5034,5834,9460,1408,ITH,ITH4,6,Friuli-Venezia Giulia
2021-05-27,LIG,16869,8648,8221,12724,4145,ITC,ITC3,7,Liguria
2021-02-25,VEN,7898,3339,4559,7293,605,ITH,ITH3,5,Veneto
2021-03-09,PAT,1585,591,994,939,646,ITH,ITH2,4,Provincia Autonoma Trento
2021-03-23,UMB,3790,1682,2108,2161,1629,ITI,ITI2,10,Umbria
2021-05-04,ABR,10749,5050,5699,7133,3616,ITF,ITF1,13,Abruzzo
2021-05-17,LAZ,44505,20368,24137,35934,8571,ITI,ITI4,12,Lazio
2021-05-27,MAR,13730,6816,6914,9429,4301,ITI,ITI3,11,Marche
2021-06-07,EMR,40383,20724,19659,34135,6248,ITH,ITH5,8,Emilia-Romagna
2021-06-17,PAT,6591,3456,3135,2115,4476,ITH,ITH2,4,Provincia Autonoma Trento
2021-02-11,CAM,6279,2704,3575,6213,66,ITF,ITF3,15,Campania
2021-03-08,ABR,5148,1693,3455,4178,970,ITF,ITF1,13,Abruzzo
2021-03-31,MAR,7373,3086,4287,4350,3023,ITI,ITI3,11,Marche
2021-04-14,LIG,13068,5667,7401,10866,2202,ITC,ITC3,7,Liguria
2021-07-01,UMB,9606,4759,4847,3386,6220,ITI,ITI2,10,Umbria
2021-02-03,VDA,351,114,237,14,337,ITC,ITC2,2,Valle d'Aosta / Vallée d'Aoste
2021-04-09,VEN,31194,13764,17430,22850,8344,ITH,ITH3,5,Veneto
2021-04-16,CAL,10215,4979,5236,8630,1585,ITF,ITF6,18,Calabria
2021-06-01,PAB,3558,2317,1241,2086,1472,ITH,ITH1,4,Provincia Autonoma Bolzano / Bozen
2021-02-08,UMB,635,203,432,88,547,ITI,ITI2,10,Umbria
2021-04-11,SAR,5398,2443,2955,4277,1121,ITG,ITG2,20,Sardegna
2021-06-24,PIE,39068,19580,19488,18821,20247,ITC,ITC1,1,Piemonte
2021-02-18,CAL,1849,848,1001,1621,228,ITF,ITF6,18,Calabria
2021-04-01,VDA,777,394,383,765,12,ITC,ITC2,2,Valle d'Aosta / Vallée d'Aoste
2021-06-05,VEN,46641,24023,22618,38665,7976,ITH,ITH3,5,Veneto
2021-01-24,ABR,50,22,28,6,44,ITF,ITF1,13,Abruzzo
2021-02-06,LAZ,6159,2492,3667,840,5319,ITI,ITI4,12,Lazio
2021-03-16,PIE,10523,4269,6254,4463,6060,ITC,ITC1,1,Piemonte
2021-05-19,UMB,9411,4211,5200,5668,3743,ITI,ITI2,10,Umbria
2021-06-07,SAR,12557,6142,6415,9553,3004,ITG,ITG2,20,Sardegna
2021-06-15,PUG,42118,20591,21527,22579,19539,ITF,ITF4,16,Puglia
2021-06-08,PUG,39045,19003,20042,21300,17745,ITF,ITF4,16,Puglia
2021-05-12,PIE,31898,15196,16702,18994,12904,ITC,ITC1,1,Piemonte
2021-02-19,PAB,2252,512,1740,2241,11,ITH,ITH1,4,Provincia Autonoma Bolzano / Bozen
2021-05-29,LIG,6863,3251,3612,3993,2870,ITC,ITC3,7,Liguria
2021-05-31,LOM,95641,47395,48246,79446,16195,ITC,ITC4,3,Lombardia
2021-06-21,CAL,15050,6905,8145,7720,7330,ITF,ITF6,18,Calabria
2021-02-04,SAR,2272,816,1456,916,1356,ITG,ITG2,20,Sardegna
2021-03-01,ABR,3478,1385,2093,2727,751,ITF,ITF1,13,Abruzzo
2021-04-02,SAR,8993,3548,5445,5751,3242,ITG,ITG2,20,Sardegna
2021-02-06,UMB,396,138,258,34,362,ITI,ITI2,10,Umbria
2021-03-14,PAT,108,65,43,21,87,ITH,ITH2,4,Provincia Autonoma Trento
2021-05-17,SIC,31914,15383,16531,19227,12687,ITG,ITG1,19,Sicilia
2021-06-12,TOS,29380,15146,14234,24993,4387,ITI,ITI1,9,Toscana
2021-03-21,SIC,15217,7340,7877,11248,3969,ITG,ITG1,19,Sicilia
2021-04-16,TOS,28943,12878,16065,22047,6896,ITI,ITI1,9,Toscana
2021-06-18,ABR,9981,4906,5075,6520,3461,ITF,ITF1,13,Abruzzo
2021-03-26,LOM,41302,15695,25607,28160,13142,ITC,ITC4,3,Lombardia
2021-01-04,CAL,1068,529,539,1068,0,ITF,ITF6,18,Calabria
2021-02-06,SIC,4699,2099,2600,1465,3234,ITG,ITG1,19,Sicilia
2021-05-22,LOM,70577,33827,36750,32426,38151,ITC,ITC4,3,Lombardia
2021-02-11,LAZ,7000,3012,3988,6467,533,ITI,ITI4,12,Lazio
2021-05-20,MOL,2661,1371,1290,2475,186,ITF,ITF2,14,Molise
2021-02-09,LIG,1941,690,1251,257,1684,ITC,ITC3,7,Liguria
2021-04-11,LAZ,19155,8470,10685,13274,5881,ITI,ITI4,12,Lazio
2021-04-16,CAM,34321,16559,17762,23656,10665,ITF,ITF3,15,Campania
2021-05-19,FVG,12036,5934,6102,9692,2344,ITH,ITH4,6,Friuli-Venezia Giulia
2021-06-09,BAS,4423,2072,2351,3999,424,ITF,ITF5,17,Basilicata
2021-06-13,PUG,21675,10863,10812,16499,5176,ITF,ITF4,16,Puglia
2021-04-23,CAL,13115,6439,6676,9523,3592,ITF,ITF6,18,Calabria
2021-01-06,CAM,7652,3749,3903,7652,0,ITF,ITF3,15,Campania
2021-02-13,LAZ,6612,2627,3985,6194,418,ITI,ITI4,12,Lazio
2021-04-13,BAS,2115,1052,1063,1298,817,ITF,ITF5,17,Basilicata
2021-05-29,LOM,88303,42410,45893,42244,46059,ITC,ITC4,3,Lombardia
2021-02-18,LOM,14050,4924,9126,13014,1036,ITC,ITC4,3,Lombardia
2021-03-07,PAT,22,6,16,22,0,ITH,ITH2,4,Provincia Autonoma Trento
2021-03-01,BAS,548,284,264,382,166,ITF,ITF5,17,Basilicata
2021-03-29,MAR,5867,2569,3298,3439,2428,ITI,ITI3,11,Marche
2021-01-09,PAT,190,40,150,190,0,ITH,ITH2,4,Provincia Autonoma Trento
2021-01-13,CAL,2048,1033,1015,2048,0,ITF,ITF6,18,Calabria
2021-02-24,VDA,183,82,101,164,19,ITC,ITC2,2,Valle d'Aosta / Vallée d'Aoste
2021-04-16,LAZ,34430,15697,18733,22337,12093,ITI,ITI4,12,Lazio
2021-06-21,EMR,37092,18749,18343,16237,20855,ITH,ITH5,8,Emilia-Romagna
2021-04-18,CAL,5845,2793,3052,4932,913,ITF,ITF6,18,Calabria
2021-04-08,BAS,766,351,415,756,10,ITF,ITF5,17,Basilicata
2021-07-01,TOS,31911,15421,16490,10961,20950,ITI,ITI1,9,Toscana
2021-01-27,VDA,151,71,80,79,72,ITC,ITC2,2,Valle d'Aosta / Vallée d'Aoste
2021-02-06,PAT,574,298,276,433,141,ITH,ITH2,4,Provincia Autonoma Trento
2021-03-26,TOS,20679,9394,11285,14914,5765,ITI,ITI1,9,Toscana
2021-06-27,MOL,1963,927,1036,740,1223,ITF,ITF2,14,Molise
2021-04-20,VDA,933,430,503,739,194,ITC,ITC2,2,Valle d'Aosta / Vallée d'Aoste
2021-04-22,BAS,5036,2346,2690,3433,1603,ITF,ITF5,17,Basilicata
2021-01-23,LAZ,7214,2869,4345,585,6629,ITI,ITI4,12,Lazio
2021-03-30,EMR,23346,10338,13008,18305,5041,ITH,ITH5,8,Emilia-Romagna
2021-01-06,LAZ,5124,1962,3162,5124,0,ITI,ITI4,12,Lazio
2021-01-10,VDA,220,71,149,220,0,ITC,ITC2,2,Valle d'Aosta / Vallée d'Aoste
2021-02-23,PAT,1112,395,717,899,213,ITH,ITH2,4,Provincia Autonoma Trento
2021-03-09,TOS,11129,4567,6562,5577,5552,ITI,ITI1,9,Toscana
2021-03-24,MAR,7032,2983,4049,3364,3668,ITI,ITI3,11,Marche
2021-03-28,FVG,4937,2354,2583,4779,158,ITH,ITH4,6,Friuli-Venezia Giulia
2021-04-05,PUG,12747,6191,6556,12214,533,ITF,ITF4,16,Puglia
2020-12-27,VDA,20,9,11,20,0,ITC,ITC2,2,Valle d'Aosta / Vallée d'Aoste
2021-03-19,PUG,7963,3654,4309,3414,4549,ITF,ITF4,16,Puglia
2021-01-07,MOL,598,209,389,598,0,ITF,ITF2,14,Molise
2021-01-11,VEN,7239,2102,5137,7239,0,ITH,ITH3,5,Veneto
2021-06-01,MAR,12068,6160,5908,9973,2095,ITI,ITI3,11,Marche
2021-02-28,LIG,1058,580,478,1049,9,ITC,ITC3,7,Liguria
2021-05-07,UMB,10092,4697,5395,6904,3188,ITI,ITI2,10,Umbria
2021-06-20,PAB,4955,2697,2258,369,4586,ITH,ITH1,4,Provincia Autonoma Bolzano / Bozen
2021-06-27,PUG,18179,9029,9150,9947,8232,ITF,ITF4,16,Puglia
2021-01-18,FVG,1961,606,1355,1867,94,ITH,ITH4,6,Friuli-Venezia Giulia
2021-03-03,ABR,4633,1891,2742,3727,906,ITF,ITF1,13,Abruzzo
2021-03-10,MAR,5672,2404,3268,4532,1140,ITI,ITI3,11,Marche
2021-05-24,CAM,31358,15151,16207,16209,15149,ITF,ITF3,15,Campania
2021-01-04,FVG,1507,558,949,1507,0,ITH,ITH4,6,Friuli-Venezia Giulia
2021-04-09,TOS,24595,10580,14015,21186,3409,ITI,ITI1,9,Toscana
2021-05-17,PAT,4294,2122,2172,3943,351,ITH,ITH2,4,Provincia Autonoma Trento
2021-02-13,CAM,5508,2550,2958,5291,217,ITF,ITF3,15,Campania
2021-02-21,MAR,376,141,235,375,1,ITI,ITI3,11,Marche
2021-04-04,CAL,1570,785,785,1149,421,ITF,ITF6,18,Calabria
2021-04-21,VEN,32331,13179,19152,16273,16058,ITH,ITH3,5,Veneto
2021-06-30,BAS,3389,1634,1755,2278,1111,ITF,ITF5,17,Basilicata
2021-02-07,PAB,2362,1058,1304,14,2348,ITH,ITH1,4,Provincia Autonoma Bolzano / Bozen
2021-02-12,MOL,332,150,182,208,124,ITF,ITF2,14,Molise
2021-02-25,SIC,9868,5155,4713,8704,1164,ITG,ITG1,19,Sicilia
2021-03-28,PIE,16062,6901,9161,8440,7622,ITC,ITC1,1,Piemonte
2021-04-23,SAR,12864,5741,7123,7388,5476,ITG,ITG2,20,Sardegna
2021-05-22,VEN,34760,16671,18089,13366,21394,ITH,ITH3,5,Veneto
2021-02-11,VEN,4012,1238,2774,3384,628,ITH,ITH3,5,Veneto
2021-04-08,ABR,7394,3337,4057,5064,2330,ITF,ITF1,13,Abruzzo
2021-06-05,SIC,59909,28496,31413,49333,10576,ITG,ITG1,19,Sicilia
2021-04-23,CAM,32322,15520,16802,23174,9148,ITF,ITF3,15,Campania
2021-05-10,SAR,9739,4341,5398,7201,2538,ITG,ITG2,20,Sardegna
2021-01-28,VEN,9210,2662,6548,172,9038,ITH,ITH3,5,Veneto
2021-04-22,ABR,6729,3249,3480,4999,1730,ITF,ITF1,13,Abruzzo
2021-06-26,CAL,15341,7074,8267,7414,7927,ITF,ITF6,18,Calabria
2021-01-30,SAR,3863,1392,2471,362,3501,ITG,ITG2,20,Sardegna
2021-03-14,SIC,8773,3927,4846,4937,3836,ITG,ITG1,19,Sicilia
2021-04-11,PIE,20841,9327,11514,18687,2154,ITC,ITC1,1,Piemonte
2021-05-18,PAB,3342,1753,1589,2156,1186,ITH,ITH1,4,Provincia Autonoma Bolzano / Bozen
2021-01-04,EMR,7315,2527,4788,7315,0,ITH,ITH5,8,Emilia-Romagna
2021-01-04,PIE,5564,1679,3885,5564,0,ITC,ITC1,1,Piemonte
2021-04-23,LOM,73495,33310,40185,56947,16548,ITC,ITC4,3,Lombardia
2021-06-17,TOS,32412,16562,15850,26963,5449,ITI,ITI1,9,Toscana
2021-04-28,PIE,26048,11740,14308,16013,10035,ITC,ITC1,1,Piemonte
2021-01-18,PIE,6167,2048,4119,5918,249,ITC,ITC1,1,Piemonte
2021-03-22,ABR,4344,1908,2436,2373,1971,ITF,ITF1,13,Abruzzo
2021-05-10,LOM,85262,40879,44383,63686,21576,ITC,ITC4,3,Lombardia
2021-02-11,SIC,5235,2059,3176,4772,463,ITG,ITG1,19,Sicilia
2021-01-30,LOM,12313,4565,7748,154,12159,ITC,ITC4,3,Lombardia
2021-06-30,ABR,10913,5299,5614,4408,6505,ITF,ITF1,13,Abruzzo
2021-02-06,FVG,1154,338,816,22,1132,ITH,ITH4,6,Friuli-Venezia Giulia
2021-02-17,BAS,1135,493,642,1059,76,ITF,ITF5,17,Basilicata
2021-02-25,LAZ,12680,5537,7143,11602,1078,ITI,ITI4,12,Lazio
2021-04-14,PAT,3119,1465,1654,2382,737,ITH,ITH2,4,Provincia Autonoma Trento
2021-02-04,TOS,4253,1594,2659,961,3292,ITI,ITI1,9,Toscana
2021-02-23,FVG,2644,1278,1366,2464,180,ITH,ITH4,6,Friuli-Venezia Giulia
2021-03-28,PAT,753,294,459,751,2,ITH,ITH2,4,Provincia Autonoma Trento
2021-06-07,CAL,17009,7903,9106,13800,3209,ITF,ITF6,18,Calabria
2021-01-19,MAR,231,86,145,142,89,ITI,ITI3,11,Marche
2021-05-28,BAS,3614,1809,1805,951,2663,ITF,ITF5,17,Basilicata
2021-06-05,LAZ,65910,32508,33402,43184,22726,ITI,ITI4,12,Lazio
2021-02-14,PUG,786,347,439,662,124,ITF,ITF4,16,Puglia
2021-05-15,TOS,29337,13850,15487,23450,5887,ITI,ITI1,9,Toscana
2021-05-19,EMR,33717,14959,18758,18543,15174,ITH,ITH5,8,Emilia-Romagna
2021-02-02,MAR,1193,398,795,72,1121,ITI,ITI3,11,Marche
2021-06-09,VDA,1027,535,492,991,36,ITC,ITC2,2,Valle d'Aosta / Vallée d'Aoste
2021-06-11,BAS,4224,1975,2249,3195,1029,ITF,ITF5,17,Basilicata
2021-05-25,PUG,34648,16171,18477,21145,13503,ITF,ITF4,16,Puglia
2021-01-04,PAT,872,229,643,872,0,ITH,ITH2,4,Provincia Autonoma Trento
2021-03-01,VDA,181,66,115,147,34,ITC,ITC2,2,Valle d'Aosta / Vallée d'Aoste
2021-03-15,MOL,832,338,494,587,245,ITF,ITF2,14,Molise
2021-04-28,TOS,19121,8179,10942,3814,15307,ITI,ITI1,9,Toscana
2021-05-13,MAR,12603,5695,6908,7104,5499,ITI,ITI3,11,Marche
2021-05-17,FVG,8804,4086,4718,6319,2485,ITH,ITH4,6,Friuli-Venezia Giulia
2021-03-02,VEN,11490,4625,6865,8181,3309,ITH,ITH3,5,Veneto
2021-03-09,FVG,4009,1722,2287,1262,2747,ITH,ITH4,6,Friuli-Venezia Giulia
2021-04-12,MAR,8564,3770,4794,8082,482,ITI,ITI3,11,Marche
2021-02-12,PAB,730,217,513,482,248,ITH,ITH1,4,Provincia Autonoma Bolzano / Bozen
2021-03-23,PIE,13120,5491,7629,6875,6245,ITC,ITC1,1,Piemonte
2021-04-19,PUG,27654,12855,14799,24611,3043,ITF,ITF4,16,Puglia
2021-04-10,PAB,5396,2666,2730,4808,588,ITH,ITH1,4,Provincia Autonoma Bolzano / Bozen
2021-06-07,CAM,55725,26790,28935,51692,4033,ITF,ITF3,15,Campania
2021-04-06,UMB,5287,2165,3122,2900,2387,ITI,ITI2,10,Umbria
2021-05-20,MAR,12433,5845,6588,7724,4709,ITI,ITI3,11,Marche
2021-01-10,ABR,1139,409,730,1139,0,ITF,ITF1,13,Abruzzo
2021-05-30,VDA,865,429,436,694,171,ITC,ITC2,2,Valle d'Aosta / Vallée d'Aoste
2021-06-14,CAL,13988,6337,7651,9354,4634,ITF,ITF6,18,Calabria
2021-01-16,PIE,7771,2630,5141,7771,0,ITC,ITC1,1,Piemonte
2021-02-11,SAR,1315,490,825,1204,111,ITG,ITG2,20,Sardegna
2021-01-23,PAT,577,334,243,388,189,ITH,ITH2,4,Provincia Autonoma Trento
2021-01-30,SIC,7693,3534,4159,168,7525,ITG,ITG1,19,Sicilia
2021-03-28,UMB,1095,441,654,1071,24,ITI,ITI2,10,Umbria
2021-04-28,FVG,7285,3219,4066,3797,3488,ITH,ITH4,6,Friuli-Venezia Giulia
2021-04-29,ABR,12671,5850,6821,9576,3095,ITF,ITF1,13,Abruzzo
2021-06-05,LIG,8088,4115,3973,4936,3152,ITC,ITC3,7,Liguria
2021-01-30,UMB,1575,486,1089,44,1531,ITI,ITI2,10,Umbria
2021-04-09,LIG,12450,5557,6893,10684,1766,ITC,ITC3,7,Liguria
2021-05-03,PAT,4259,2197,2062,4105,154,ITH,ITH2,4,Provincia Autonoma Trento
2021-06-05,TOS,28417,13593,14824,20807,7610,ITI,ITI1,9,Toscana
2020-12-31,PAB,913,519,394,913,0,ITH,ITH1,4,Provincia Autonoma Bolzano / Bozen
2021-02-04,LOM,27820,8109,19711,2013,25807,ITC,ITC4,3,Lombardia
2021-03-28,SIC,10974,5143,5831,6962,4012,ITG,ITG1,19,Sicilia
2021-06-25,ABR,10810,5349,5461,4805,6005,ITF,ITF1,13,Abruzzo
2021-03-04,CAL,5482,3191,2291,4685,797,ITF,ITF6,18,Calabria
2021-02-20,LAZ,9207,4274,4933,8436,771,ITI,ITI4,12,Lazio
2021-02-25,CAM,12425,4478,7947,11237,1188,ITF,ITF3,15,Campania
2021-03-31,LIG,11923,5273,6650,9153,2770,ITC,ITC3,7,Liguria
2021-04-24,PUG,29355,13367,15988,25410,3945,ITF,ITF4,16,Puglia
2021-04-09,LOM,52369,22364,30005,36376,15993,ITC,ITC4,3,Lombardia
2021-06-12,CAL,12885,6136,6749,10489,2396,ITF,ITF6,18,Calabria
2021-05-31,LAZ,51533,22897,28636,31800,19733,ITI,ITI4,12,Lazio
2021-01-10,BAS,77,24,53,77,0,ITF,ITF5,17,Basilicata
2021-01-15,ABR,379,149,230,379,0,ITF,ITF1,13,Abruzzo
2021-02-07,MAR,1871,735,1136,344,1527,ITI,ITI3,11,Marche
2021-04-20,BAS,4035,1921,2114,2202,1833,ITF,ITF5,17,Basilicata
2021-01-11,TOS,5094,1691,3403,5094,0,ITI,ITI1,9,Toscana
2021-04-11,EMR,15277,6934,8343,12229,3048,ITH,ITH5,8,Emilia-Romagna
2021-04-19,PAB,1872,858,1014,1690,182,ITH,ITH1,4,Provincia Autonoma Bolzano / Bozen
2021-05-28,VDA,975,414,561,563,412,ITC,ITC2,2,Valle d'Aosta / Vallée d'Aoste
2021-05-24,SAR,14480,7261,7219,8497,5983,ITG,ITG2,20,Sardegna
2021-02-17,VDA,327,144,183,227,100,ITC,ITC2,2,Valle d'Aosta / Vallée d'Aoste
2021-04-21,TOS,29616,12675,16941,17493,12123,ITI,ITI1,9,Toscana
2021-04-23,VEN,31240,13837,17403,22531,8709,ITH,ITH3,5,Veneto
2021-06-15,PAB,1999,1156,843,468,1531,ITH,ITH1,4,Provincia Autonoma Bolzano / Bozen
2021-01-23,FVG,816,324,492,4,812,ITH,ITH4,6,Friuli-Venezia Giulia
2021-02-13,SAR,1456,565,891,1454,2,ITG,ITG2,20,Sardegna
2021-02-23,TOS,7722,3325,4397,7561,161,ITI,ITI1,9,Toscana
2021-07-01,PAT,6828,3546,3282,3573,3255,ITH,ITH2,4,Provincia Autonoma Trento
2021-04-04,LAZ,17533,8106,9427,12268,5265,ITI,ITI4,12,Lazio
2021-04-09,CAM,30044,14153,15891,23910,6134,ITF,ITF3,15,Campania
2021-04-05,MOL,391,189,202,292,99,ITF,ITF2,14,Molise
2021-05-05,PAT,4988,2580,2408,4692,296,ITH,ITH2,4,Provincia Autonoma Trento
2021-06-03,TOS,31981,15406,16575,27434,4547,ITI,ITI1,9,Toscana
2021-06-05,CAM,77028,37282,39746,71005,6023,ITF,ITF3,15,Campania
2021-01-08,BAS,554,219,335,554,0,ITF,ITF5,17,Basilicata
2021-03-29,MOL,2033,835,1198,1547,486,ITF,ITF2,14,Molise
2021-02-16,VEN,6644,2870,3774,6468,176,ITH,ITH3,5,Veneto
2021-04-04,LOM,7611,3230,4381,3716,3895,ITC,ITC4,3,Lombardia
2021-01-31,MOL,268,70,198,6,262,ITF,ITF2,14,Molise
2021-02-11,EMR,4254,1415,2839,3413,841,ITH,ITH5,8,Emilia-Romagna
2021-04-27,ABR,9085,4368,4717,6618,2467,ITF,ITF1,13,Abruzzo
2021-06-14,CAM,36717,17722,18995,18713,18004,ITF,ITF3,15,Campania
2021-03-15,BAS,2360,986,1374,524,1836,ITF,ITF5,17,Basilicata
2021-05-29,SAR,17999,8650,9349,13406,4593,ITG,ITG2,20,Sardegna
2021-01-16,PAT,319,148,171,319,0,ITH,ITH2,4,Provincia Autonoma Trento
2021-01-17,BAS,328,133,195,327,1,ITF,ITF5,17,Basilicata
2021-05-05,FVG,9757,4262,5495,6289,3468,ITH,ITH4,6,Friuli-Venezia Giulia
2021-02-18,SAR,1878,732,1146,1814,64,ITG,ITG2,20,Sardegna
2021-04-04,SIC,6805,3322,3483,5513,1292,ITG,ITG1,19,Sicilia
2021-07-02,ABR,11611,5838,5773,4790,6821,ITF,ITF1,13,Abruzzo
2021-01-23,PIE,4257,1325,2932,879,3378,ITC,ITC1,1,Piemonte
2021-04-17,PAB,5239,2602,2637,5195,44,ITH,ITH1,4,Provincia Autonoma Bolzano / Bozen
2021-01-07,PAB,918,327,591,918,0,ITH,ITH1,4,Provincia Autonoma Bolzano / Bozen
2021-01-14,PUG,4072,1591,2481,4072,0,ITF,ITF4,16,Puglia
2021-03-21,PIE,10728,4741,5987,4195,6533,ITC,ITC1,1,Piemonte
2021-01-07,PUG,5718,2459,3259,5718,0,ITF,ITF4,16,Puglia
2021-01-31,MAR,1918,769,1149,102,1816,ITI,ITI3,11,Marche
2021-04-02,LOM,41186,16850,24336,26730,14456,ITC,ITC4,3,Lombardia
2021-04-17,PUG,39963,18941,21022,36394,3569,ITF,ITF4,16,Puglia
2021-02-25,CAL,2888,1555,1333,2292,596,ITF,ITF6,18,Calabria
2021-05-29,VEN,32986,16666,16320,25328,7658,ITH,ITH3,5,Veneto
2020-12-28,LIG,80,30,50,80,0,ITC,ITC3,7,Liguria
2021-01-25,FVG,1583,567,1016,194,1389,ITH,ITH4,6,Friuli-Venezia Giulia
2021-02-19,PUG,4734,2012,2722,4342,392,ITF,ITF4,16,Puglia
2021-04-27,BAS,4727,2242,2485,4402,325,ITF,ITF5,17,Basilicata
2021-06-03,LIG,15518,7688,7830,9157,6361,ITC,ITC3,7,Liguria
2021-07-01,FVG,11623,6048,5575,2635,8988,ITH,ITH4,6,Friuli-Venezia Giulia
2021-03-23,FVG,3888,1681,2207,1747,2141,ITH,ITH4,6,Friuli-Venezia Giulia
2021-04-07,LIG,13677,6107,7570,11389,2288,ITC,ITC3,7,Liguria
2021-03-15,ABR,3683,1447,2236,1876,1807,ITF,ITF1,13,Abruzzo
2021-04-07,MAR,8176,3614,4562,7829,347,ITI,ITI3,11,Marche
2021-02-10,VDA,248,77,171,141,107,ITC,ITC2,2,Valle d'Aosta / Vallée d'Aoste
2021-01-17,ABR,188,59,129,181,7,ITF,ITF1,13,Abruzzo
2021-02-09,MAR,124,42,82,46,78,ITI,ITI3,11,Marche
2021-03-11,CAL,7236,3430,3806,5969,1267,ITF,ITF6,18,Calabria
2021-04-04,EMR,9879,4717,5162,7612,2267,ITH,ITH5,8,Emilia-Romagna
2021-04-04,PIE,9261,4062,5199,6547,2714,ITC,ITC1,1,Piemonte
2021-06-04,VDA,908,383,525,474,434,ITC,ITC2,2,Valle d'Aosta / Vallée d'Aoste
2021-01-18,UMB,613,218,395,529,84,ITI,ITI2,10,Umbria
2021-01-19,MOL,173,63,110,162,11,ITF,ITF2,14,Molise
2021-04-21,PIE,25756,11841,13915,20416,5340,ITC,ITC1,1,Piemonte
2021-05-17,SAR,12815,6258,6557,9271,3544,ITG,ITG2,20,Sardegna
2021-02-04,VEN,7386,2025,5361,551,6835,ITH,ITH3,5,Veneto
2021-04-15,ABR,7819,3679,4140,5979,1840,ITF,ITF1,13,Abruzzo
2021-04-16,LOM,53679,23925,29754,39323,14356,ITC,ITC4,3,Lombardia
2021-05-08,MAR,12267,5475,6792,5022,7245,ITI,ITI3,11,Marche
2021-06-19,CAL,15578,7295,8283,8315,7263,ITF,ITF6,18,Calabria
2021-01-11,PIE,8745,2981,5764,8745,0,ITC,ITC1,1,Piemonte
2021-02-06,SAR,1971,698,1273,569,1402,ITG,ITG2,20,Sardegna
2021-04-29,MOL,2238,1145,1093,891,1347,ITF,ITF2,14,Molise
2021-05-03,LOM,83699,39752,43947,71574,12125,ITC,ITC4,3,Lombardia
2021-04-23,FVG,7467,3377,4090,3602,3865,ITH,ITH4,6,Friuli-Venezia Giulia
2021-01-11,EMR,9347,3273,6074,9347,0,ITH,ITH5,8,Emilia-Romagna
2021-01-23,LOM,1115,357,758,916,199,ITC,ITC4,3,Lombardia
2021-02-23,SAR,1537,1026,511,1285,252,ITG,ITG2,20,Sardegna
2021-04-12,MOL,1299,557,742,1048,251,ITF,ITF2,14,Molise
2021-06-10,TOS,26336,13514,12822,25802,534,ITI,ITI1,9,Toscana
2021-05-24,TOS,33714,16701,17013,24145,9569,ITI,ITI1,9,Toscana
2021-06-17,LIG,16274,7719,8555,8769,7505,ITC,ITC3,7,Liguria
2021-01-19,PUG,1221,452,769,1211,10,ITF,ITF4,16,Puglia
2021-06-29,PAB,1854,998,856,238,1616,ITH,ITH1,4,Provincia Autonoma Bolzano / Bozen
2021-02-15,LAZ,8026,3540,4486,7395,631,ITI,ITI4,12,Lazio
2021-01-25,TOS,5126,1895,3231,247,4879,ITI,ITI1,9,Toscana
2021-01-29,LAZ,8043,3080,4963,813,7230,ITI,ITI4,12,Lazio
2021-03-18,PAT,2320,957,1363,1240,1080,ITH,ITH2,4,Provincia Autonoma Trento
2021-03-21,PAB,768,285,483,14,754,ITH,ITH1,4,Provincia Autonoma Bolzano / Bozen
2021-01-09,MAR,1714,606,1108,1714,0,ITI,ITI3,11,Marche
2021-06-28,PIE,38348,19042,19306,15659,22689,ITC,ITC1,1,Piemonte
2021-04-30,VEN,49987,23475,26512,34324,15663,ITH,ITH3,5,Veneto
2021-06-12,PAB,4907,2659,2248,1619,3288,ITH,ITH1,4,Provincia Autonoma Bolzano / Bozen
2021-04-06,PIE,20249,8815,11434,15053,5196,ITC,ITC1,1,Piemonte
2021-05-02,SAR,5887,2670,3217,5306,581,ITG,ITG2,20,Sardegna
2021-05-30,UMB,5982,2999,2983,5780,202,ITI,ITI2,10,Umbria
2021-01-20,VEN,1038,368,670,386,652,ITH,ITH3,5,Veneto
2021-04-18,TOS,8359,4091,4268,7331,1028,ITI,ITI1,9,Toscana
2020-12-27,PIE,913,369,544,913,0,ITC,ITC1,1,Piemonte
2021-04-02,MAR,6887,2984,3903,6148,739,ITI,ITI3,11,Marche
2021-05-14,CAL,19915,9567,10348,13052,6863,ITF,ITF6,18,Calabria
2021-03-08,UMB,3696,1822,1874,2335,1361,ITI,ITI2,10,Umbria
2021-06-09,PAT,6237,3077,3160,2164,4073,ITH,ITH2,4,Provincia Autonoma Trento
2021-06-16,SIC,39774,18499,21275,21064,18710,ITG,ITG1,19,Sicilia
2021-01-14,PAB,1946,575,1371,1946,0,ITH,ITH1,4,Provincia Autonoma Bolzano / Bozen
2021-02-08,SAR,1470,533,937,856,614,ITG,ITG2,20,Sardegna
2021-03-16,MAR,3473,1486,1987,290,3183,ITI,ITI3,11,Marche
2021-04-27,CAL,9953,4893,5060,8009,1944,ITF,ITF6,18,Calabria
2021-06-16,UMB,6312,3091,3221,3219,3093,ITI,ITI2,10,Umbria
2021-01-19,VDA,256,77,179,256,0,ITC,ITC2,2,Valle d'Aosta / Vallée d'Aoste
2021-03-25,SIC,20355,9460,10895,14890,5465,ITG,ITG1,19,Sicilia
2021-06-22,ABR,10222,4790,5432,5378,4844,ITF,ITF1,13,Abruzzo
2021-06-26,PAT,1384,720,664,672,712,ITH,ITH2,4,Provincia Autonoma Trento
2021-04-07,PAB,1798,823,975,1258,540,ITH,ITH1,4,Provincia Autonoma Bolzano / Bozen
2021-02-03,CAL,2814,1450,1364,572,2242,ITF,ITF6,18,Calabria
2021-03-25,UMB,3898,1698,2200,2835,1063,ITI,ITI2,10,Umbria
2021-06-02,LIG,8530,4342,4188,5363,3167,ITC,ITC3,7,Liguria
2021-07-03,SIC,33628,16080,17548,8903,24725,ITG,ITG1,19,Sicilia
2021-01-04,PUG,4508,2016,2492,4508,0,ITF,ITF4,16,Puglia
2021-06-21,LOM,111600,57181,54419,80766,30834,ITC,ITC4,3,Lombardia
2021-04-12,VDA,486,186,300,323,163,ITC,ITC2,2,Valle d'Aosta / Vallée d'Aoste
2021-04-29,VDA,1291,634,657,757,534,ITC,ITC2,2,Valle d'Aosta / Vallée d'Aoste
2021-06-02,CAM,42781,20119,22662,38120,4661,ITF,ITF3,15,Campania
2021-06-19,LIG,7155,3648,3507,5505,1650,ITC,ITC3,7,Liguria
2021-06-28,PAT,6742,3479,3263,2945,3797,ITH,ITH2,4,Provincia Autonoma Trento
2021-02-17,LAZ,9187,4608,4579,8310,877,ITI,ITI4,12,Lazio
2021-02-22,CAM,10682,3294,7388,10419,263,ITF,ITF3,15,Campania
2021-03-02,PAB,695,200,495,693,2,ITH,ITH1,4,Provincia Autonoma Bolzano / Bozen
2021-03-07,MOL,1132,501,631,1130,2,ITF,ITF2,14,Molise
2021-04-06,PAT,2261,950,1311,1496,765,ITH,ITH2,4,Provincia Autonoma Trento
2021-04-17,BAS,3461,1655,1806,2199,1262,ITF,ITF5,17,Basilicata
2021-06-24,MAR,13667,6595,7072,6298,7369,ITI,ITI3,11,Marche
2021-05-28,LAZ,56940,26427,30513,43733,13207,ITI,ITI4,12,Lazio
2021-06-15,MOL,2215,1042,1173,764,1451,ITF,ITF2,14,Molise
2021-06-30,EMR,32872,16599,16273,17296,15576,ITH,ITH5,8,Emilia-Romagna
2021-03-11,CAM,17998,9056,8942,10719,7279,ITF,ITF3,15,Campania
2021-03-19,PAB,1906,773,1133,799,1107,ITH,ITH1,4,Provincia Autonoma Bolzano / Bozen
2021-06-02,LOM,84628,43572,41056,78297,6331,ITC,ITC4,3,Lombardia
2021-03-06,SIC,12638,5058,7580,9856,2782,ITG,ITG1,19,Sicilia
2021-07-04,VDA,587,250,337,6,581,ITC,ITC2,2,Valle d'Aosta / Vallée d'Aoste
2021-06-09,FVG,11158,5874,5284,9773,1385,ITH,ITH4,6,Friuli-Venezia Giulia
2021-03-11,LOM,36216,13476,22740,26307,9909,ITC,ITC4,3,Lombardia
2021-05-16,CAM,51145,23225,27920,33573,17572,ITF,ITF3,15,Campania
2021-06-11,EMR,44922,23327,21595,38427,6495,ITH,ITH5,8,Emilia-Romagna
2021-02-20,CAM,8573,3080,5493,8270,303,ITF,ITF3,15,Campania
2021-03-29,BAS,2434,880,1554,2147,287,ITF,ITF5,17,Basilicata
2021-07-03,VEN,37742,19601,18141,11170,26572,ITH,ITH3,5,Veneto
2021-03-27,UMB,4251,1513,2738,3911,340,ITI,ITI2,10,Umbria
2021-06-17,MOL,2307,1017,1290,938,1369,ITF,ITF2,14,Molise
2021-06-28,EMR,37447,18278,19169,17957,19490,ITH,ITH5,8,Emilia-Romagna
2021-06-14,SIC,42387,20155,22232,27632,14755,ITG,ITG1,19,Sicilia
2021-01-05,BAS,946,409,537,946,0,ITF,ITF5,17,Basilicata
2021-03-01,FVG,2957,1041,1916,2905,52,ITH,ITH4,6,Friuli-Venezia Giulia
2021-03-20,EMR,16085,6829,9256,9121,6964,ITH,ITH5,8,Emilia-Romagna
2021-06-13,PAB,3619,2019,1600,427,3192,ITH,ITH1,4,Provincia Autonoma Bolzano / Bozen
2021-06-20,PUG,21210,10685,10525,14077,7133,ITF,ITF4,16,Puglia
2021-05-25,PAB,3838,1991,1847,2953,885,ITH,ITH1,4,Provincia Autonoma Bolzano / Bozen
2021-01-23,SAR,60,22,38,0,60,ITG,ITG2,20,Sardegna
2021-05-13,MOL,3039,1410,1629,2582,457,ITF,ITF2,14,Molise
2021-02-14,PAB,297,130,167,297,0,ITH,ITH1,4,Provincia Autonoma Bolzano / Bozen
2021-02-18,SIC,5277,3100,2177,4847,430,ITG,ITG1,19,Sicilia
2021-06-18,VDA,998,443,555,599,399,ITC,ITC2,2,Valle d'Aosta / Vallée d'Aoste
2021-04-30,CAM,42322,20191,22131,25824,16498,ITF,ITF3,15,Campania
2021-05-08,PAB,4427,2382,2045,3764,663,ITH,ITH1,4,Provincia Autonoma Bolzano / Bozen
2021-01-30,LAZ,7013,2895,4118,808,6205,ITI,ITI4,12,Lazio
2021-02-01,UMB,1284,341,943,48,1236,ITI,ITI2,10,Umbria
2021-02-04,CAM,7943,3429,4514,1308,6635,ITF,ITF3,15,Campania
2021-05-12,SIC,36769,17316,19453,21860,14909,ITG,ITG1,19,Sicilia
2021-03-13,BAS,1798,890,908,753,1045,ITF,ITF5,17,Basilicata
2021-02-18,UMB,1496,582,914,1030,466,ITI,ITI2,10,Umbria
2021-03-03,PAB,1180,394,786,1167,13,ITH,ITH1,4,Provincia Autonoma Bolzano / Bozen
2021-05-17,LOM,94633,45351,49282,30224,64409,ITC,ITC4,3,Lombardia
2021-01-27,FVG,1272,425,847,450,822,ITH,ITH4,6,Friuli-Venezia Giulia
2021-02-07,BAS,375,159,216,49,326,ITF,ITF5,17,Basilicata
2021-01-01,CAM,919,506,413,919,0,ITF,ITF3,15,Campania
2021-04-28,MOL,1693,923,770,476,1217,ITF,ITF2,14,Molise
2021-05-14,VEN,46701,22208,24493,25839,20862,ITH,ITH3,5,Veneto
2021-05-18,BAS,5897,2857,3040,3405,2492,ITF,ITF5,17,Basilicata
2021-02-04,PUG,5928,2365,3563,1193,4735,ITF,ITF4,16,Puglia
2021-05-09,EMR,25609,12252,13357,18642,6967,ITH,ITH5,8,Emilia-Romagna
2021-01-29,EMR,10414,3496,6918,290,10124,ITH,ITH5,8,Emilia-Romagna
2021-04-08,SIC,16701,8249,8452,8235,8466,ITG,ITG1,19,Sicilia
2021-05-07,FVG,10608,4852,5756,7099,3509,ITH,ITH4,6,Friuli-Venezia Giulia
2021-01-15,LAZ,6582,2708,3874,6582,0,ITI,ITI4,12,Lazio
2021-02-20,VEN,6424,2014,4410,6353,71,ITH,ITH3,5,Veneto
2021-03-04,PAT,2362,794,1568,1583,779,ITH,ITH2,4,Provincia Autonoma Trento
2020-12-30,LIG,12,5,7,12,0,ITC,ITC3,7,Liguria
2021-02-15,EMR,2904,851,2053,2779,125,ITH,ITH5,8,Emilia-Romagna
2021-04-25,LAZ,24522,11249,13273,16705,7817,ITI,ITI4,12,Lazio
2021-04-20,PIE,25489,11667,13822,19143,6346,ITC,ITC1,1,Piemonte
2021-03-25,CAM,20321,9653,10668,16818,3503,ITF,ITF3,15,Campania
2021-05-01,BAS,4704,2137,2567,3953,751,ITF,ITF5,17,Basilicata
2021-01-19,ABR,111,55,56,91,20,ITF,ITF1,13,Abruzzo
2021-03-18,TOS,9980,3984,5996,6008,3972,ITI,ITI1,9,Toscana
2021-05-09,FVG,7355,3301,4054,3498,3857,ITH,ITH4,6,Friuli-Venezia Giulia
2021-02-07,ABR,778,307,471,201,577,ITF,ITF1,13,Abruzzo
2021-02-22,SAR,1639,949,690,1411,228,ITG,ITG2,20,Sardegna
2021-03-02,MAR,4993,1961,3032,4427,566,ITI,ITI3,11,Marche
2021-04-13,CAL,6897,3380,3517,5586,1311,ITF,ITF6,18,Calabria
2021-05-07,PIE,33074,15644,17430,18949,14125,ITC,ITC1,1,Piemonte
2021-06-26,TOS,34507,16738,17769,10212,24295,ITI,ITI1,9,Toscana
2021-01-27,EMR,8361,2947,5414,462,7899,ITH,ITH5,8,Emilia-Romagna
2021-01-27,PIE,4196,1453,2743,999,3197,ITC,ITC1,1,Piemonte
2021-05-19,LOM,82870,39584,43286,33816,49054,ITC,ITC4,3,Lombardia
2021-06-10,MAR,14673,7563,7110,12660,2013,ITI,ITI3,11,Marche
2021-01-20,CAL,1403,627,776,1402,1,ITF,ITF6,18,Calabria
2021-02-13,PIE,4153,1334,2819,2931,1222,ITC,ITC1,1,Piemonte
2021-03-11,SAR,6428,3092,3336,5226,1202,ITG,ITG2,20,Sardegna
2021-02-08,LOM,10083,2919,7164,2130,7953,ITC,ITC4,3,Lombardia
2021-05-17,PUG,32829,15206,17623,20974,11855,ITF,ITF4,16,Puglia
2021-06-09,TOS,34735,17514,17221,34310,425,ITI,ITI1,9,Toscana
2021-07-03,LIG,8654,4291,4363,5380,3274,ITC,ITC3,7,Liguria
2021-02-25,LOM,15293,6349,8944,13721,1572,ITC,ITC4,3,Lombardia
2021-01-03,CAL,6,3,3,6,0,ITF,ITF6,18,Calabria
2021-04-11,LIG,4246,1929,2317,3997,249,ITC,ITC3,7,Liguria
2021-06-02,VEN,20305,10232,10073,15960,4345,ITH,ITH3,5,Veneto
2021-02-21,MOL,574,227,347,572,2,ITF,ITF2,14,Molise
2021-03-29,VDA,493,233,260,453,40,ITC,ITC2,2,Valle d'Aosta / Vallée d'Aoste
2021-01-21,ABR,157,47,110,157,0,ITF,ITF1,13,Abruzzo
2021-03-27,CAL,8772,3986,4786,4693,4079,ITF,ITF6,18,Calabria
2021-05-16,UMB,5218,2492,2726,5169,49,ITI,ITI2,10,Umbria
2021-06-20,VDA,1131,545,586,487,644,ITC,ITC2,2,Valle d'Aosta / Vallée d'Aoste
2021-02-04,MOL,758,295,463,77,681,ITF,ITF2,14,Molise
2021-04-04,TOS,13921,6608,7313,13668,253,ITI,ITI1,9,Toscana
2021-05-26,FVG,13417,6701,6716,9983,3434,ITH,ITH4,6,Friuli-Venezia Giulia
2021-03-12,VDA,531,175,356,305,226,ITC,ITC2,2,Valle d'Aosta / Vallée d'Aoste
2021-05-01,ABR,10734,5042,5692,5760,4974,ITF,ITF1,13,Abruzzo
2021-05-24,MAR,10800,5113,5687,8121,2679,ITI,ITI3,11,Marche
2021-02-15,FVG,2454,911,1543,2200,254,ITH,ITH4,6,Friuli-Venezia Giulia
2021-05-15,MOL,2980,1398,1582,2596,384,ITF,ITF2,14,Molise
2021-02-06,LOM,15258,5537,9721,1015,14243,ITC,ITC4,3,Lombardia
2021-02-20,SIC,7138,3692,3446,6897,241,ITG,ITG1,19,Sicilia
2021-04-06,LAZ,24392,11115,13277,17278,7114,ITI,ITI4,12,Lazio
2021-05-20,ABR,12746,5902,6844,7488,5258,ITF,ITF1,13,Abruzzo
2021-05-10,PAB,3018,1300,1718,1413,1605,ITH,ITH1,4,Provincia Autonoma Bolzano / Bozen
2021-05-09,PIE,27134,12928,14206,13513,13621,ITC,ITC1,1,Piemonte
2021-06-04,SAR,14477,6928,7549,9922,4555,ITG,ITG2,20,Sardegna
2021-01-18,LIG,2141,746,1395,1984,157,ITC,ITC3,7,Liguria
2021-01-27,PAT,810,280,530,94,716,ITH,ITH2,4,Provincia Autonoma Trento
2021-02-03,SIC,5920,2779,3141,721,5199,ITG,ITG1,19,Sicilia
2021-03-16,TOS,4899,1882,3017,2648,2251,ITI,ITI1,9,Toscana
2021-06-21,SAR,14006,6727,7279,5190,8816,ITG,ITG2,20,Sardegna
2020-12-27,LAZ,274,132,142,274,0,ITI,ITI4,12,Lazio
2021-02-13,PAT,537,333,204,172,365,ITH,ITH2,4,Provincia Autonoma Trento
2021-02-27,TOS,1984,756,1228,1082,902,ITI,ITI1,9,Toscana
2021-03-11,VEN,19827,8888,10939,14256,5571,ITH,ITH3,5,Veneto
2021-03-13,SAR,2755,1076,1679,2474,281,ITG,ITG2,20,Sardegna
2021-05-26,PIE,32740,15102,17638,15666,17074,ITC,ITC1,1,Piemonte
2021-01-20,CAM,1257,650,607,1257,0,ITF,ITF3,15,Campania
2021-04-27,SIC,26303,12650,13653,15488,10815,ITG,ITG1,19,Sicilia
2021-02-15,PIE,4432,1597,2835,3227,1205,ITC,ITC1,1,Piemonte
2021-03-08,VDA,485,233,252,240,245,ITC,ITC2,2,Valle d'Aosta / Vallée d'Aoste
2021-04-23,UMB,6604,2782,3822,3484,3120,ITI,ITI2,10,Umbria
2021-05-12,EMR,38891,18283,20608,29226,9665,ITH,ITH5,8,Emilia-Romagna
2021-02-25,UMB,1332,495,837,1280,52,ITI,ITI2,10,Umbria
2021-05-04,VDA,1135,510,625,462,673,ITC,ITC2,2,Valle d'Aosta / Vallée d'Aoste
2021-02-01,EMR,10320,3610,6710,362,9958,ITH,ITH5,8,Emilia-Romagna
2021-06-15,MAR,12910,6415,6495,9860,3050,ITI,ITI3,11,Marche
2021-03-11,UMB,3582,1722,1860,2576,1006,ITI,ITI2,10,Umbria
2021-01-28,TOS,6282,1882,4400,354,5928,ITI,ITI1,9,Toscana
2021-05-01,MOL,2647,1268,1379,424,2223,ITF,ITF2,14,Molise
2021-01-13,UMB,449,139,310,449,0,ITI,ITI2,10,Umbria
2021-06-16,VDA,683,365,318,642,41,ITC,ITC2,2,Valle d'Aosta / Vallée d'Aoste
2021-06-19,UMB,4564,2199,2365,2534,2030,ITI,ITI2,10,Umbria
2021-03-05,MOL,1219,649,570,1015,204,ITF,ITF2,14,Molise
2021-05-31,PAT,4721,2174,2547,1676,3045,ITH,ITH2,4,Provincia Autonoma Trento
2021-01-30,CAM,10722,5080,5642,38,10684,ITF,ITF3,15,Campania
2021-03-25,BAS,1885,604,1281,1541,344,ITF,ITF5,17,Basilicata
2021-02-06,CAL,2911,1341,1570,444,2467,ITF,ITF6,18,Calabria
2021-06-13,MOL,2785,1485,1300,2460,325,ITF,ITF2,14,Molise
2021-01-27,BAS,412,175,237,113,299,ITF,ITF5,17,Basilicata
2021-04-17,MOL,3054,1501,1553,1568,1486,ITF,ITF2,14,Molise
2021-07-03,CAM,65489,31577,33912,8082,57407,ITF,ITF3,15,Campania
2021-02-10,BAS,548,238,310,496,52,ITF,ITF5,17,Basilicata
2021-03-14,LIG,1659,752,907,1055,604,ITC,ITC3,7,Liguria
2021-04-11,FVG,3433,1520,1913,2527,906,ITH,ITH4,6,Friuli-Venezia Giulia
2021-01-12,MAR,1229,415,814,1229,0,ITI,ITI3,11,Marche
2021-05-21,BAS,4574,2320,2254,1491,3083,ITF,ITF5,17,Basilicata
2021-06-07,FVG,9128,4736,4392,8162,966,ITH,ITH4,6,Friuli-Venezia Giulia
2021-06-22,LIG,15580,7356,8224,7488,8092,ITC,ITC3,7,Liguria
2021-01-16,SAR,1492,525,967,1492,0,ITG,ITG2,20,Sardegna
2021-01-16,CAM,3371,1677,1694,3371,0,ITF,ITF3,15,Campania
2021-05-10,LIG,12644,5639,7005,6273,6371,ITC,ITC3,7,Liguria
2021-06-19,SIC,43735,20778,22957,18597,25138,ITG,ITG1,19,Sicilia
2021-05-05,VEN,44322,21238,23084,37751,6571,ITH,ITH3,5,Veneto
2021-04-23,SIC,28551,13694,14857,22729,5822,ITG,ITG1,19,Sicilia
2021-01-23,CAL,401,186,215,359,42,ITF,ITF6,18,Calabria
2021-07-01,VEN,48787,24941,23846,20200,28587,ITH,ITH3,5,Veneto
2021-06-07,PIE,34878,17855,17023,30090,4788,ITC,ITC1,1,Piemonte
2021-06-26,LAZ,55846,26303,29543,25068,30778,ITI,ITI4,12,Lazio
2021-01-16,LOM,15432,5734,9698,15432,0,ITC,ITC4,3,Lombardia
2021-04-30,LAZ,41359,18319,23040,27146,14213,ITI,ITI4,12,Lazio
2021-02-10,ABR,947,312,635,503,444,ITF,ITF1,13,Abruzzo
2021-01-18,EMR,3128,879,2249,2449,679,ITH,ITH5,8,Emilia-Romagna
2021-03-15,VDA,362,123,239,159,203,ITC,ITC2,2,Valle d'Aosta / Vallée d'Aoste
2021-03-16,EMR,12247,5028,7219,4938,7309,ITH,ITH5,8,Emilia-Romagna
2021-05-11,VDA,647,325,322,496,151,ITC,ITC2,2,Valle d'Aosta / Vallée d'Aoste
2021-01-25,EMR,6462,2146,4316,207,6255,ITH,ITH5,8,Emilia-Romagna
2021-06-22,MAR,12995,6374,6621,6551,6444,ITI,ITI3,11,Marche
2021-07-01,EMR,32614,15916,16698,13932,18682,ITH,ITH5,8,Emilia-Romagna
2021-01-06,UMB,846,325,521,846,0,ITI,ITI2,10,Umbria
2021-04-27,VDA,978,423,555,686,292,ITC,ITC2,2,Valle d'Aosta / Vallée d'Aoste
2021-06-12,UMB,7706,3683,4023,6129,1577,ITI,ITI2,10,Umbria
2021-03-23,EMR,18797,8144,10653,12110,6687,ITH,ITH5,8,Emilia-Romagna
2021-04-26,MAR,9132,4045,5087,6110,3022,ITI,ITI3,11,Marche
2021-01-17,VDA,131,56,75,131,0,ITC,ITC2,2,Valle d'Aosta / Vallée d'Aoste
2021-04-16,UMB,8095,3739,4356,6257,1838,ITI,ITI2,10,Umbria
2021-06-23,VDA,1043,551,492,427,616,ITC,ITC2,2,Valle d'Aosta / Vallée d'Aoste
2021-04-30,UMB,6249,2971,3278,2852,3397,ITI,ITI2,10,Umbria
2021-06-19,LAZ,60037,28093,31944,29739,30298,ITI,ITI4,12,Lazio
2021-03-19,TOS,10142,4460,5682,7274,2868,ITI,ITI1,9,Toscana
2021-06-20,MOL,421,174,247,51,370,ITF,ITF2,14,Molise
2021-03-04,UMB,4484,1855,2629,3657,827,ITI,ITI2,10,Umbria
2021-04-24,MOL,2551,1202,1349,710,1841,ITF,ITF2,14,Molise
2021-06-26,SIC,36742,17507,19235,16187,20555,ITG,ITG1,19,Sicilia
2021-01-24,PAB,12,10,2,0,12,ITH,ITH1,4,Provincia Autonoma Bolzano / Bozen
2021-01-31,PUG,1816,832,984,75,1741,ITF,ITF4,16,Puglia
2021-02-26,MOL,563,260,303,490,73,ITF,ITF2,14,Molise
2021-03-28,CAL,2691,1231,1460,1568,1123,ITF,ITF6,18,Calabria
2021-01-20,UMB,602,221,381,602,0,ITI,ITI2,10,Umbria
2021-04-30,SIC,34978,16328,18650,23968,11010,ITG,ITG1,19,Sicilia
2021-06-06,MOL,2060,1059,1001,1737,323,ITF,ITF2,14,Molise
2021-04-01,BAS,2697,1107,1590,1976,721,ITF,ITF5,17,Basilicata
2021-05-03,LIG,13279,5922,7357,6464,6815,ITC,ITC3,7,Liguria
2021-05-31,FVG,8881,4415,4466,6706,2175,ITH,ITH4,6,Friuli-Venezia Giulia
2021-02-03,BAS,669,301,368,32,637,ITF,ITF5,17,Basilicata
2021-05-12,VEN,36742,17785,18957,31636,5106,ITH,ITH3,5,Veneto
2021-07-04,PAB,2086,970,1116,60,2026,ITH,ITH1,4,Provincia Autonoma Bolzano / Bozen
2021-03-21,LIG,550,220,330,69,481,ITC,ITC3,7,Liguria
2020-12-28,PIE,1,1,0,1,0,ITC,ITC1,1,Piemonte
2021-01-23,LIG,809,295,514,153,656,ITC,ITC3,7,Liguria
2021-06-29,LIG,14926,7109,7817,8568,6358,ITC,ITC3,7,Liguria
2021-01-09,LOM,12419,4574,7845,12419,0,ITC,ITC4,3,Lombardia
2021-01-30,CAL,2182,1150,1032,347,1835,ITF,ITF6,18,Calabria
2021-06-24,VEN,55086,27910,27176,17439,37647,ITH,ITH3,5,Veneto
2021-01-23,CAM,3839,2029,1810,273,3566,ITF,ITF3,15,Campania
2021-03-04,SIC,15071,6569,8502,10954,4117,ITG,ITG1,19,Sicilia
2021-06-26,SAR,18736,8780,9956,5511,13225,ITG,ITG2,20,Sardegna
2021-03-07,LOM,12087,5361,6726,9528,2559,ITC,ITC4,3,Lombardia
2021-03-16,VEN,12527,5353,7174,6907,5620,ITH,ITH3,5,Veneto
2021-03-21,CAM,10071,4674,5397,7681,2390,ITF,ITF3,15,Campania
2021-05-17,LIG,12023,5519,6504,8701,3322,ITC,ITC3,7,Liguria
2021-06-12,SIC,44510,21746,22764,38633,5877,ITG,ITG1,19,Sicilia
2021-01-21,TOS,1589,686,903,867,722,ITI,ITI1,9,Toscana
2021-05-07,LAZ,48218,22604,25614,30467,17751,ITI,ITI4,12,Lazio
2021-03-11,LAZ,25327,11927,13400,19097,6230,ITI,ITI4,12,Lazio
2021-03-09,EMR,14754,6019,8735,10799,3955,ITH,ITH5,8,Emilia-Romagna
2021-06-30,VDA,1117,542,575,425,692,ITC,ITC2,2,Valle d'Aosta / Vallée d'Aoste
2021-01-12,PUG,4213,1770,2443,4213,0,ITF,ITF4,16,Puglia
2021-02-16,LOM,9506,3073,6433,9058,448,ITC,ITC4,3,Lombardia
2021-03-02,CAM,12761,4558,8203,8416,4345,ITF,ITF3,15,Campania
2021-05-20,PAB,4726,2336,2390,3257,1469,ITH,ITH1,4,Provincia Autonoma Bolzano / Bozen
2021-01-11,CAL,2168,1047,1121,2168,0,ITF,ITF6,18,Calabria
2020-12-27,ABR,37,19,18,37,0,ITF,ITF1,13,Abruzzo
2021-01-25,CAL,1077,516,561,148,929,ITF,ITF6,18,Calabria
2021-06-10,LOM,101654,51736,49918,87259,14395,ITC,ITC4,3,Lombardia
2021-06-24,SIC,41480,19250,22230,17207,24273,ITG,ITG1,19,Sicilia
2021-01-15,BAS,814,351,463,814,0,ITF,ITF5,17,Basilicata
2021-02-11,LIG,1979,767,1212,1103,876,ITC,ITC3,7,Liguria
2021-07-01,SAR,19738,9730,10008,6951,12787,ITG,ITG2,20,Sardegna
2021-03-02,LOM,22812,9702,13110,19773,3039,ITC,ITC4,3,Lombardia
2021-05-05,CAL,13533,6472,7061,8481,5052,ITF,ITF6,18,Calabria
2021-03-23,SAR,6413,2879,3534,5335,1078,ITG,ITG2,20,Sardegna
2021-05-22,LIG,6649,3220,3429,4966,1683,ITC,ITC3,7,Liguria
2021-06-07,SIC,49519,23354,26165,41612,7907,ITG,ITG1,19,Sicilia
2021-01-16,TOS,3271,1046,2225,3271,0,ITI,ITI1,9,Toscana
2021-03-20,ABR,4793,2199,2594,2622,2171,ITF,ITF1,13,Abruzzo
2021-04-16,EMR,29230,13763,15467,20393,8837,ITH,ITH5,8,Emilia-Romagna
2021-01-06,EMR,8287,2955,5332,8287,0,ITH,ITH5,8,Emilia-Romagna
2021-04-26,TOS,10140,4932,5208,7589,2551,ITI,ITI1,9,Toscana
2021-04-03,VDA,676,341,335,661,15,ITC,ITC2,2,Valle d'Aosta / Vallée d'Aoste
2021-04-04,VEN,7783,3533,4250,6635,1148,ITH,ITH3,5,Veneto
2021-02-13,UMB,114,27,87,111,3,ITI,ITI2,10,Umbria
2021-03-20,VDA,208,86,122,172,36,ITC,ITC2,2,Valle d'Aosta / Vallée d'Aoste
2021-03-30,LAZ,26802,12966,13836,19653,7149,ITI,ITI4,12,Lazio
2021-06-19,PIE,39924,20250,19674,23296,16628,ITC,ITC1,1,Piemonte
2021-01-02,TOS,3497,1096,2401,3497,0,ITI,ITI1,9,Toscana
2021-04-30,EMR,36605,16788,19817,21811,14794,ITH,ITH5,8,Emilia-Romagna
2021-05-24,UMB,9054,4509,4545,8175,879,ITI,ITI2,10,Umbria
2021-04-18,UMB,1531,681,850,601,930,ITI,ITI2,10,Umbria
2021-01-11,UMB,1303,341,962,1303,0,ITI,ITI2,10,Umbria
2021-03-28,EMR,13499,6025,7474,9629,3870,ITH,ITH5,8,Emilia-Romagna
2021-04-07,PUG,15700,7126,8574,9022,6678,ITF,ITF4,16,Puglia
2020-12-27,BAS,106,41,65,106,0,ITF,ITF5,17,Basilicata
2021-01-26,MOL,450,184,266,8,442,ITF,ITF2,14,Molise
2021-06-28,VDA,986,496,490,329,657,ITC,ITC2,2,Valle d'Aosta / Vallée d'Aoste
2021-02-04,FVG,2725,808,1917,35,2690,ITH,ITH4,6,Friuli-Venezia Giulia
2021-05-15,MAR,13970,6377,7593,8077,5893,ITI,ITI3,11,Marche
2021-05-05,UMB,7207,3298,3909,3903,3304,ITI,ITI2,10,Umbria
2021-05-06,MOL,2679,1214,1465,2081,598,ITF,ITF2,14,Molise
2021-06-11,VDA,1047,483,564,764,283,ITC,ITC2,2,Valle d'Aosta / Vallée d'Aoste
2021-04-18,LAZ,23808,10577,13231,16158,7650,ITI,ITI4,12,Lazio
2021-03-20,BAS,1294,573,721,281,1013,ITF,ITF5,17,Basilicata
2021-01-25,SIC,7420,3674,3746,291,7129,ITG,ITG1,19,Sicilia
2021-06-10,LIG,18166,9370,8796,12542,5624,ITC,ITC3,7,Liguria
2021-02-19,MAR,1990,730,1260,1855,135,ITI,ITI3,11,Marche
2021-04-30,FVG,7333,3236,4097,3696,3637,ITH,ITH4,6,Friuli-Venezia Giulia
2021-06-13,ABR,9692,4859,4833,7856,1836,ITF,ITF1,13,Abruzzo
2021-06-28,BAS,3603,1724,1879,2094,1509,ITF,ITF5,17,Basilicata
2021-01-25,UMB,648,323,325,5,643,ITI,ITI2,10,Umbria
2021-05-05,SIC,26274,12180,14094,16647,9627,ITG,ITG1,19,Sicilia
2021-03-19,LIG,5296,2234,3062,2150,3146,ITC,ITC3,7,Liguria
2021-05-19,SIC,42667,20654,22013,28315,14352,ITG,ITG1,19,Sicilia
2021-02-04,PIE,10206,3341,6865,588,9618,ITC,ITC1,1,Piemonte
2021-03-02,LIG,4074,1689,2385,3764,310,ITC,ITC3,7,Liguria
2021-03-26,PAT,3230,1256,1974,2620,610,ITH,ITH2,4,Provincia Autonoma Trento
2021-01-11,CAM,4070,1871,2199,4070,0,ITF,ITF3,15,Campania
2021-03-31,PAB,1832,694,1138,821,1011,ITH,ITH1,4,Provincia Autonoma Bolzano / Bozen
2020-12-28,LOM,107,47,60,107,0,ITC,ITC4,3,Lombardia
2021-03-02,CAL,4365,2490,1875,3610,755,ITF,ITF6,18,Calabria
2021-05-24,VEN,33020,16404,16616,8025,24995,ITH,ITH3,5,Veneto
2021-06-24,LIG,10878,5316,5562,6134,4744,ITC,ITC3,7,Liguria
2021-03-16,CAL,3855,1891,1964,2194,1661,ITF,ITF6,18,Calabria
2021-03-06,BAS,1359,537,822,760,599,ITF,ITF5,17,Basilicata
2021-04-02,LIG,11788,5219,6569,9301,2487,ITC,ITC3,7,Liguria
2021-05-12,SAR,11136,5261,5875,7997,3139,ITG,ITG2,20,Sardegna
2021-04-21,LOM,71766,32535,39231,57151,14615,ITC,ITC4,3,Lombardia
2021-05-23,VDA,999,465,534,658,341,ITC,ITC2,2,Valle d'Aosta / Vallée d'Aoste
2021-01-11,LOM,16261,5378,10883,16261,0,ITC,ITC4,3,Lombardia
2021-02-25,EMR,9249,3499,5750,8295,954,ITH,ITH5,8,Emilia-Romagna
2021-03-07,TOS,5647,2357,3290,2104,3543,ITI,ITI1,9,Toscana
2021-06-19,PAT,3097,1695,1402,255,2842,ITH,ITH2,4,Provincia Autonoma Trento
2021-01-28,LOM,12224,3703,8521,801,11423,ITC,ITC4,3,Lombardia
2021-01-29,VDA,318,138,180,2,316,ITC,ITC2,2,Valle d'Aosta / Vallée d'Aoste
2021-04-30,PIE,31846,14329,17517,18511,13335,ITC,ITC1,1,Piemonte
2021-05-19,LAZ,47121,21631,25490,37018,10103,ITI,ITI4,12,Lazio
2021-06-19,EMR,36019,18030,17989,16672,19347,ITH,ITH5,8,Emilia-Romagna
2021-04-04,UMB,57,20,37,22,35,ITI,ITI2,10,Umbria
2021-01-29,ABR,1387,449,938,74,1313,ITF,ITF1,13,Abruzzo
2021-03-11,EMR,17453,7306,10147,11602,5851,ITH,ITH5,8,Emilia-Romagna
2021-04-22,VDA,1068,450,618,685,383,ITC,ITC2,2,Valle d'Aosta / Vallée d'Aoste
2021-06-07,UMB,6941,3425,3516,6248,693,ITI,ITI2,10,Umbria
2021-05-09,VDA,574,287,287,444,130,ITC,ITC2,2,Valle d'Aosta / Vallée d'Aoste
2021-01-04,LAZ,7485,2909,4576,7485,0,ITI,ITI4,12,Lazio
2021-02-06,EMR,7595,2404,5191,2110,5485,ITH,ITH5,8,Emilia-Romagna
2021-03-16,UMB,3538,1454,2084,1911,1627,ITI,ITI2,10,Umbria
2021-03-17,MOL,908,385,523,576,332,ITF,ITF2,14,Molise
2021-05-27,PUG,40594,19161,21433,23370,17224,ITF,ITF4,16,Puglia
2021-06-24,LAZ,63393,30219,33174,28968,34425,ITI,ITI4,12,Lazio
2021-07-04,MAR,5615,2778,2837,1436,4179,ITI,ITI3,11,Marche
2021-06-07,LAZ,62169,29047,33122,33022,29147,ITI,ITI4,12,Lazio
2021-06-25,MOL,3411,1681,1730,1514,1897,ITF,ITF2,14,Molise
2021-02-27,UMB,1658,354,1304,1642,16,ITI,ITI2,10,Umbria
2021-04-21,LIG,14247,6433,7814,8920,5327,ITC,ITC3,7,Liguria
2020-12-28,SAR,65,25,40,65,0,ITG,ITG2,20,Sardegna
2021-05-31,EMR,29728,13749,15979,18262,11466,ITH,ITH5,8,Emilia-Romagna
2021-03-14,FVG,1398,550,848,1146,252,ITH,ITH4,6,Friuli-Venezia Giulia
2021-02-04,SIC,6746,3073,3673,1452,5294,ITG,ITG1,19,Sicilia
2021-02-20,EMR,5318,2094,3224,5055,263,ITH,ITH5,8,Emilia-Romagna
2021-03-02,TOS,10599,3799,6800,7155,3444,ITI,ITI1,9,Toscana
2021-06-12,VEN,47802,24072,23730,37052,10750,ITH,ITH3,5,Veneto
2021-06-24,PAT,5913,3098,2815,3731,2182,ITH,ITH2,4,Provincia Autonoma Trento
2021-04-04,SAR,1,0,1,0,1,ITG,ITG2,20,Sardegna
2021-06-18,BAS,4451,2058,2393,2193,2258,ITF,ITF5,17,Basilicata
2021-01-04,TOS,5066,1895,3171,5066,0,ITI,ITI1,9,Toscana
2021-04-08,VDA,584,282,302,441,143,ITC,ITC2,2,Valle d'Aosta / Vallée d'Aoste
2021-05-24,LAZ,43930,20133,23797,34169,9761,ITI,ITI4,12,Lazio
2021-05-26,UMB,9645,4563,5082,8395,1250,ITI,ITI2,10,Umbria
2021-04-14,TOS,20182,8344,11838,15073,5109,ITI,ITI1,9,Toscana
2021-05-12,PAT,3303,1492,1811,2116,1187,ITH,ITH2,4,Provincia Autonoma Trento
2021-02-18,CAM,9080,3813,5267,8373,707,ITF,ITF3,15,Campania
2021-02-28,PUG,6058,1806,4252,5872,186,ITF,ITF4,16,Puglia
2021-06-03,MAR,14634,7478,7156,12378,2256,ITI,ITI3,11,Marche
2021-03-16,PAT,1391,506,885,608,783,ITH,ITH2,4,Provincia Autonoma Trento
2021-05-25,MOL,1963,887,1076,1333,630,ITF,ITF2,14,Molise
2021-06-08,PAB,4149,2118,2031,832,3317,ITH,ITH1,4,Provincia Autonoma Bolzano / Bozen
2021-01-15,EMR,7750,2404,5346,7750,0,ITH,ITH5,8,Emilia-Romagna
2021-05-14,PAT,5320,2543,2777,3934,1386,ITH,ITH2,4,Provincia Autonoma Trento
2021-02-02,ABR,1763,668,1095,222,1541,ITF,ITF1,13,Abruzzo
2021-05-13,ABR,11146,5042,6104,7187,3959,ITF,ITF1,13,Abruzzo
2021-06-13,VDA,851,399,452,373,478,ITC,ITC2,2,Valle d'Aosta / Vallée d'Aoste
2021-02-08,PIE,6919,2357,4562,666,6253,ITC,ITC1,1,Piemonte
2021-01-03,LAZ,5255,1973,3282,5255,0,ITI,ITI4,12,Lazio
2021-05-12,PUG,36549,16307,20242,24065,12484,ITF,ITF4,16,Puglia
2021-06-14,TOS,31776,16318,15458,27673,4103,ITI,ITI1,9,Toscana
2021-01-04,MOL,314,131,183,314,0,ITF,ITF2,14,Molise
2021-04-25,CAM,30732,15170,15562,25336,5396,ITF,ITF3,15,Campania
2021-01-01,SIC,818,437,381,818,0,ITG,ITG1,19,Sicilia
2021-03-31,ABR,6712,2938,3774,4643,2069,ITF,ITF1,13,Abruzzo
2021-04-13,LAZ,25771,11946,13825,18055,7716,ITI,ITI4,12,Lazio
2021-04-14,MOL,1806,767,1039,1145,661,ITF,ITF2,14,Molise
2021-04-08,FVG,7446,3217,4229,5524,1922,ITH,ITH4,6,Friuli-Venezia Giulia
2021-06-23,CAL,16822,7676,9146,7894,8928,ITF,ITF6,18,Calabria
2021-02-16,MOL,156,70,86,150,6,ITF,ITF2,14,Molise
2021-04-20,SIC,18970,8975,9995,13727,5243,ITG,ITG1,19,Sicilia
2021-02-18,MAR,2137,779,1358,1851,286,ITI,ITI3,11,Marche
2021-05-27,MOL,2834,1348,1486,1998,836,ITF,ITF2,14,Molise
2021-04-23,LIG,14671,6637,8034,8551,6120,ITC,ITC3,7,Liguria
2021-05-21,FVG,11203,5013,6190,8235,2968,ITH,ITH4,6,Friuli-Venezia Giulia
2021-06-09,EMR,42377,21558,20819,36017,6360,ITH,ITH5,8,Emilia-Romagna
2021-05-29,MAR,12860,6232,6628,8332,4528,ITI,ITI3,11,Marche
2021-01-24,BAS,842,305,537,58,784,ITF,ITF5,17,Basilicata
2021-02-10,FVG,1352,496,856,1266,86,ITH,ITH4,6,Friuli-Venezia Giulia
2021-03-01,EMR,10095,3582,6513,7837,2258,ITH,ITH5,8,Emilia-Romagna
2021-05-02,VEN,37233,17262,19971,26904,10329,ITH,ITH3,5,Veneto
2021-05-15,ABR,11426,5176,6250,6126,5300,ITF,ITF1,13,Abruzzo
2021-02-01,FVG,2097,688,1409,16,2081,ITH,ITH4,6,Friuli-Venezia Giulia
2021-03-11,LIG,6397,3088,3309,4387,2010,ITC,ITC3,7,Liguria
2021-05-28,UMB,9583,4435,5148,7288,2295,ITI,ITI2,10,Umbria
2021-01-13,LIG,2757,1013,1744,2757,0,ITC,ITC3,7,Liguria
2021-05-13,BAS,5985,2967,3018,3389,2596,ITF,ITF5,17,Basilicata
2021-06-08,VDA,712,356,356,679,33,ITC,ITC2,2,Valle d'Aosta / Vallée d'Aoste
2021-05-04,EMR,29271,13704,15567,15612,13659,ITH,ITH5,8,Emilia-Romagna
2021-06-14,VEN,42401,21436,20965,27118,15283,ITH,ITH3,5,Veneto
2021-01-08,LAZ,7730,2895,4835,7730,0,ITI,ITI4,12,Lazio
2021-01-13,CAM,8020,3666,4354,8020,0,ITF,ITF3,15,Campania
2021-04-15,UMB,7634,3493,4141,5747,1887,ITI,ITI2,10,Umbria
2021-06-16,SAR,17627,8273,9354,12326,5301,ITG,ITG2,20,Sardegna
2021-02-08,PAT,1153,319,834,342,811,ITH,ITH2,4,Provincia Autonoma Trento
2021-03-04,TOS,17846,6949,10897,14764,3082,ITI,ITI1,9,Toscana
2021-03-06,VEN,10667,4356,6311,7405,3262,ITH,ITH3,5,Veneto
2021-04-28,PAB,2464,1302,1162,2459,5,ITH,ITH1,4,Provincia Autonoma Bolzano / Bozen
2021-02-17,UMB,1618,748,870,1267,351,ITI,ITI2,10,Umbria
2021-05-21,PIE,36070,16749,19321,20438,15632,ITC,ITC1,1,Piemonte
2021-01-04,LIG,2615,855,1760,2615,0,ITC,ITC3,7,Liguria
2021-01-23,PUG,3039,1294,1745,886,2153,ITF,ITF4,16,Puglia
2021-05-29,MOL,2350,1223,1127,1960,390,ITF,ITF2,14,Molise
2021-03-13,CAL,6941,3019,3922,5959,982,ITF,ITF6,18,Calabria
2021-05-03,PUG,33296,14882,18414,22669,10627,ITF,ITF4,16,Puglia
2021-02-27,EMR,10961,3998,6963,9223,1738,ITH,ITH5,8,Emilia-Romagna
2021-03-07,PUG,4983,2000,2983,4412,571,ITF,ITF4,16,Puglia
2020-12-30,VEN,699,245,454,699,0,ITH,ITH3,5,Veneto
2021-04-25,EMR,22350,10240,12110,14840,7510,ITH,ITH5,8,Emilia-Romagna
2021-01-01,SAR,32,17,15,32,0,ITG,ITG2,20,Sardegna
2021-02-16,MAR,1290,477,813,1260,30,ITI,ITI3,11,Marche
2021-02-26,VDA,207,58,149,122,85,ITC,ITC2,2,Valle d'Aosta / Vallée d'Aoste
2021-04-13,UMB,7675,3396,4279,6007,1668,ITI,ITI2,10,Umbria
2021-05-14,FVG,10751,5354,5397,8161,2590,ITH,ITH4,6,Friuli-Venezia Giulia
2021-06-21,LIG,14454,6846,7608,8234,6220,ITC,ITC3,7,Liguria
2021-02-25,MAR,3546,1457,2089,3366,180,ITI,ITI3,11,Marche
2021-02-27,SAR,1921,647,1274,1366,555,ITG,ITG2,20,Sardegna
2021-02-03,FVG,2647,791,1856,23,2624,ITH,ITH4,6,Friuli-Venezia Giulia
2021-02-15,UMB,1367,692,675,1366,1,ITI,ITI2,10,Umbria
2021-06-21,TOS,31118,15427,15691,18377,12741,ITI,ITI1,9,Toscana
2021-02-01,PIE,8645,3055,5590,579,8066,ITC,ITC1,1,Piemonte
2021-04-18,CAM,27220,13285,13935,18320,8900,ITF,ITF3,15,Campania
2021-05-08,BAS,4835,2399,2436,3429,1406,ITF,ITF5,17,Basilicata
2021-06-05,MAR,13932,7006,6926,11873,2059,ITI,ITI3,11,Marche
2021-01-15,CAL,2802,1259,1543,2802,0,ITF,ITF6,18,Calabria
2021-04-10,VDA,404,190,214,399,5,ITC,ITC2,2,Valle d'Aosta / Vallée d'Aoste
2021-01-08,CAM,10454,4967,5487,10454,0,ITF,ITF3,15,Campania
2021-01-16,PAB,2840,1265,1575,2840,0,ITH,ITH1,4,Provincia Autonoma Bolzano / Bozen
2021-06-06,ABR,11024,5256,5768,8834,2190,ITF,ITF1,13,Abruzzo
2021-04-16,PIE,28407,13214,15193,23421,4986,ITC,ITC1,1,Piemonte
2021-05-05,CAM,51172,24857,26315,44787,6385,ITF,ITF3,15,Campania
2021-05-13,PAB,2994,1355,1639,1064,1930,ITH,ITH1,4,Provincia Autonoma Bolzano / Bozen
2021-01-11,SIC,5824,2571,3253,5824,0,ITG,ITG1,19,Sicilia
2021-01-30,VEN,8747,2672,6075,693,8054,ITH,ITH3,5,Veneto
2021-04-10,ABR,8775,4058,4717,6267,2508,ITF,ITF1,13,Abruzzo
2021-01-25,LAZ,8111,3246,4865,770,7341,ITI,ITI4,12,Lazio
2021-06-17,LOM,107747,52319,55428,53491,54256,ITC,ITC4,3,Lombardia
2021-05-05,LAZ,46781,21461,25320,30951,15830,ITI,ITI4,12,Lazio
2021-03-09,LOM,33217,12861,20356,25821,7396,ITC,ITC4,3,Lombardia
2021-05-05,LOM,87929,41922,46007,72617,15312,ITC,ITC4,3,Lombardia
2021-07-01,LOM,99688,50189,49499,50781,48907,ITC,ITC4,3,Lombardia
2021-03-13,VDA,147,88,59,147,0,ITC,ITC2,2,Valle d'Aosta / Vallée d'Aoste
2021-03-28,TOS,6212,2808,3404,5958,254,ITI,ITI1,9,Toscana
2021-05-29,PAT,2235,1166,1069,839,1396,ITH,ITH2,4,Provincia Autonoma Trento
2021-06-26,EMR,35980,18228,17752,20504,15476,ITH,ITH5,8,Emilia-Romagna
2021-02-11,FVG,1930,664,1266,1738,192,ITH,ITH4,6,Friuli-Venezia Giulia
2021-03-02,LAZ,17190,7608,9582,13255,3935,ITI,ITI4,12,Lazio
2021-03-12,MAR,4642,1973,2669,3402,1240,ITI,ITI3,11,Marche
2021-01-30,TOS,4622,1622,3000,197,4425,ITI,ITI1,9,Toscana
2021-04-02,PAT,2845,1157,1688,2170,675,ITH,ITH2,4,Provincia Autonoma Trento
2021-01-14,MAR,2010,692,1318,2010,0,ITI,ITI3,11,Marche
2021-04-09,FVG,7913,3657,4256,6667,1246,ITH,ITH4,6,Friuli-Venezia Giulia
2021-05-23,BAS,4517,2302,2215,1533,2984,ITF,ITF5,17,Basilicata
2021-06-20,MAR,10965,5445,5520,5980,4985,ITI,ITI3,11,Marche
2021-04-16,PAT,2866,1360,1506,2721,145,ITH,ITH2,4,Provincia Autonoma Trento
2021-05-10,TOS,26190,12385,13805,15572,10618,ITI,ITI1,9,Toscana
2021-01-18,LAZ,6267,2557,3710,5289,978,ITI,ITI4,12,Lazio
2021-04-25,UMB,4357,1684,2673,4275,82,ITI,ITI2,10,Umbria
2021-01-15,VDA,218,82,136,218,0,ITC,ITC2,2,Valle d'Aosta / Vallée d'Aoste
2021-02-18,PAT,1210,428,782,1147,63,ITH,ITH2,4,Provincia Autonoma Trento
2021-03-14,TOS,7174,2569,4605,3239,3935,ITI,ITI1,9,Toscana
2021-03-31,PUG,14553,6818,7735,8993,5560,ITF,ITF4,16,Puglia
2021-04-28,LAZ,32928,15027,17901,21357,11571,ITI,ITI4,12,Lazio
2021-03-07,VEN,4493,1768,2725,3932,561,ITH,ITH3,5,Veneto
2021-04-29,PAB,2631,1351,1280,1937,694,ITH,ITH1,4,Provincia Autonoma Bolzano / Bozen
2021-05-19,CAL,18319,9072,9247,11353,6966,ITF,ITF6,18,Calabria
2021-01-14,LIG,2981,1055,1926,2981,0,ITC,ITC3,7,Liguria
2021-02-02,PUG,4344,1846,2498,592,3752,ITF,ITF4,16,Puglia
2021-05-12,CAM,40885,19949,20936,31730,9155,ITF,ITF3,15,Campania
2021-01-19,PAB,853,371,482,723,130,ITH,ITH1,4,Provincia Autonoma Bolzano / Bozen
2021-03-03,MOL,672,316,356,590,82,ITF,ITF2,14,Molise
2021-03-23,CAL,5245,2460,2785,3436,1809,ITF,ITF6,18,Calabria
2021-05-03,VEN,40689,19805,20884,34226,6463,ITH,ITH3,5,Veneto
2021-06-25,PAB,4070,2246,1824,1064,3006,ITH,ITH1,4,Provincia Autonoma Bolzano / Bozen
2021-05-13,PUG,38676,17246,21430,21513,17163,ITF,ITF4,16,Puglia
2021-06-21,UMB,7491,3925,3566,5154,2337,ITI,ITI2,10,Umbria
2021-01-05,MOL,449,180,269,449,0,ITF,ITF2,14,Molise
2020-12-30,FVG,626,244,382,626,0,ITH,ITH4,6,Friuli-Venezia Giulia
2021-03-17,PUG,10345,4700,5645,4171,6174,ITF,ITF4,16,Puglia
2021-03-27,BAS,2248,860,1388,1820,428,ITF,ITF5,17,Basilicata
2021-04-21,SAR,12077,5559,6518,6543,5534,ITG,ITG2,20,Sardegna
2021-04-24,MAR,12136,5348,6788,7672,4464,ITI,ITI3,11,Marche
2021-06-05,FVG,10287,5316,4971,8739,1548,ITH,ITH4,6,Friuli-Venezia Giulia
2021-01-11,SAR,1183,505,678,1183,0,ITG,ITG2,20,Sardegna
2021-02-25,FVG,3165,1652,1513,3136,29,ITH,ITH4,6,Friuli-Venezia Giulia
2021-02-26,MAR,3665,1518,2147,3189,476,ITI,ITI3,11,Marche
2021-03-12,LIG,6216,2873,3343,3745,2471,ITC,ITC3,7,Liguria
2021-06-17,SAR,18446,8524,9922,10034,8412,ITG,ITG2,20,Sardegna
2021-03-27,LAZ,26328,10664,15664,19853,6475,ITI,ITI4,12,Lazio
2021-07-01,LIG,13191,6363,6828,7177,6014,ITC,ITC3,7,Liguria
2021-02-09,PAB,317,126,191,1,316,ITH,ITH1,4,Provincia Autonoma Bolzano / Bozen
2021-03-31,VDA,555,302,253,529,26,ITC,ITC2,2,Valle d'Aosta / Vallée d'Aoste
2021-04-17,ABR,7357,3401,3956,4304,3053,ITF,ITF1,13,Abruzzo
2021-05-19,LIG,13571,5962,7609,10451,3120,ITC,ITC3,7,Liguria
2021-06-16,FVG,12065,5858,6207,4064,8001,ITH,ITH4,6,Friuli-Venezia Giulia
2021-01-25,SAR,591,214,377,22,569,ITG,ITG2,20,Sardegna
2021-02-19,ABR,3300,1551,1749,3200,100,ITF,ITF1,13,Abruzzo
2021-03-23,LIG,9271,4220,5051,6062,3209,ITC,ITC3,7,Liguria
2021-05-23,LAZ,47086,22842,24244,39705,7381,ITI,ITI4,12,Lazio
2021-05-27,VDA,1089,497,592,586,503,ITC,ITC2,2,Valle d'Aosta / Vallée d'Aoste
2021-05-13,VDA,1139,556,583,540,599,ITC,ITC2,2,Valle d'Aosta / Vallée d'Aoste
2021-05-12,MAR,10425,4687,5738,4924,5501,ITI,ITI3,11,Marche
2021-05-28,VEN,46668,22854,23814,24849,21819,ITH,ITH3,5,Veneto
2021-01-07,BAS,641,319,322,641,0,ITF,ITF5,17,Basilicata
2021-01-06,PAT,42,13,29,42,0,ITH,ITH2,4,Provincia Autonoma Trento
2021-01-18,LOM,9202,2972,6230,8227,975,ITC,ITC4,3,Lombardia
2021-02-02,VDA,273,70,203,2,271,ITC,ITC2,2,Valle d'Aosta / Vallée d'Aoste
2021-05-09,LAZ,37541,17259,20282,26269,11272,ITI,ITI4,12,Lazio
2021-05-16,SAR,8222,3831,4391,6062,2160,ITG,ITG2,20,Sardegna
2021-06-25,VDA,977,445,532,324,653,ITC,ITC2,2,Valle d'Aosta / Vallée d'Aoste
2021-01-13,PIE,10085,3226,6859,10085,0,ITC,ITC1,1,Piemonte
2021-06-16,PIE,40335,20219,20116,24090,16245,ITC,ITC1,1,Piemonte
2021-05-10,MOL,2890,1285,1605,2517,373,ITF,ITF2,14,Molise
2021-06-29,MOL,2453,1143,1310,399,2054,ITF,ITF2,14,Molise
2021-03-23,LOM,42572,15466,27106,29712,12860,ITC,ITC4,3,Lombardia
2021-05-03,MOL,2485,1165,1320,2322,163,ITF,ITF2,14,Molise
2021-05-16,SIC,33140,16137,17003,21814,11326,ITG,ITG1,19,Sicilia
2021-02-15,CAL,1148,544,604,997,151,ITF,ITF6,18,Calabria
2021-03-06,UMB,4304,1146,3158,4166,138,ITI,ITI2,10,Umbria
2021-03-25,EMR,21481,9417,12064,14492,6989,ITH,ITH5,8,Emilia-Romagna
2021-02-19,BAS,1623,738,885,1561,62,ITF,ITF5,17,Basilicata
2021-05-21,EMR,39259,17530,21729,22235,17024,ITH,ITH5,8,Emilia-Romagna
2021-01-22,UMB,276,105,171,32,244,ITI,ITI2,10,Umbria
2021-05-02,SIC,24601,11427,13174,18000,6601,ITG,ITG1,19,Sicilia
2021-06-28,UMB,9655,4775,4880,3759,5896,ITI,ITI2,10,Umbria
2021-02-23,LIG,3806,1559,2247,3697,109,ITC,ITC3,7,Liguria
2021-05-12,UMB,6488,3025,3463,4342,2146,ITI,ITI2,10,Umbria
2021-06-22,PUG,41244,19964,21280,18767,22477,ITF,ITF4,16,Puglia
2021-06-23,ABR,10821,5206,5615,5528,5293,ITF,ITF1,13,Abruzzo
2021-04-18,EMR,17501,8395,9106,12583,4918,ITH,ITH5,8,Emilia-Romagna
2021-04-28,PAT,4251,1977,2274,4113,138,ITH,ITH2,4,Provincia Autonoma Trento
2021-04-26,PUG,26259,12028,14231,23025,3234,ITF,ITF4,16,Puglia
2021-05-05,PIE,32199,15099,17100,19179,13020,ITC,ITC1,1,Piemonte
2021-05-31,SAR,11366,5409,5957,8256,3110,ITG,ITG2,20,Sardegna
2021-02-18,VEN,5828,2455,3373,5764,64,ITH,ITH3,5,Veneto
2021-03-25,VDA,389,154,235,379,10,ITC,ITC2,2,Valle d'Aosta / Vallée d'Aoste
2021-04-12,PAB,2105,946,1159,2098,7,ITH,ITH1,4,Provincia Autonoma Bolzano / Bozen
2021-06-14,EMR,40599,20967,19632,27542,13057,ITH,ITH5,8,Emilia-Romagna
2021-01-16,FVG,1230,360,870,1230,0,ITH,ITH4,6,Friuli-Venezia Giulia
2021-03-28,LAZ,19125,7771,11354,13815,5310,ITI,ITI4,12,Lazio
2021-03-30,UMB,3976,1729,2247,2436,1540,ITI,ITI2,10,Umbria
2021-07-01,PIE,41690,20862,20828,20649,21041,ITC,ITC1,1,Piemonte
2021-02-16,TOS,9280,3340,5940,8559,721,ITI,ITI1,9,Toscana
2021-04-16,VEN,24445,10492,13953,12558,11887,ITH,ITH3,5,Veneto
2021-05-21,VDA,917,433,484,531,386,ITC,ITC2,2,Valle d'Aosta / Vallée d'Aoste
2021-04-18,SAR,5127,2225,2902,2258,2869,ITG,ITG2,20,Sardegna
2021-06-12,MAR,13407,7133,6274,12134,1273,ITI,ITI3,11,Marche
2020-12-27,UMB,84,44,40,84,0,ITI,ITI2,10,Umbria
2021-04-17,VDA,638,407,231,636,2,ITC,ITC2,2,Valle d'Aosta / Vallée d'Aoste
2021-05-02,TOS,11166,4931,6235,9203,1963,ITI,ITI1,9,Toscana
2021-07-03,FVG,10958,5851,5107,1095,9863,ITH,ITH4,6,Friuli-Venezia Giulia
2021-01-08,SAR,3258,1184,2074,3258,0,ITG,ITG2,20,Sardegna
2021-04-16,MAR,10082,4702,5380,9557,525,ITI,ITI3,11,Marche
2021-01-07,VDA,276,111,165,276,0,ITC,ITC2,2,Valle d'Aosta / Vallée d'Aoste
2021-03-25,FVG,5528,2420,3108,3392,2136,ITH,ITH4,6,Friuli-Venezia Giulia
2021-06-14,LIG,14660,7103,7557,7815,6845,ITC,ITC3,7,Liguria
2021-02-27,CAM,13948,4473,9475,12306,1642,ITF,ITF3,15,Campania
2021-03-07,PAB,114,13,101,9,105,ITH,ITH1,4,Provincia Autonoma Bolzano / Bozen
2021-04-01,PAT,2905,1231,1674,1811,1094,ITH,ITH2,4,Provincia Autonoma Trento
2021-06-04,SIC,57614,26636,30978,45814,11800,ITG,ITG1,19,Sicilia
2021-03-06,CAL,8451,4353,4098,7656,795,ITF,ITF6,18,Calabria
2021-06-09,LAZ,69951,33011,36940,36375,33576,ITI,ITI4,12,Lazio
2021-02-19,VDA,292,102,190,268,24,ITC,ITC2,2,Valle d'Aosta / Vallée d'Aoste
2021-02-22,UMB,1889,807,1082,1803,86,ITI,ITI2,10,Umbria
2021-03-16,PUG,9872,4688,5184,3512,6360,ITF,ITF4,16,Puglia
2021-04-11,LOM,32218,13943,18275,24825,7393,ITC,ITC4,3,Lombardia
2021-06-16,CAM,30393,14369,16024,19645,10748,ITF,ITF3,15,Campania
2021-01-01,LOM,24,7,17,24,0,ITC,ITC4,3,Lombardia
2021-02-25,TOS,10633,4306,6327,9635,998,ITI,ITI1,9,Toscana
2021-06-07,LOM,98519,50195,48324,85215,13304,ITC,ITC4,3,Lombardia
2021-06-24,PUG,50981,24636,26345,23153,27828,ITF,ITF4,16,Puglia
2021-04-18,VEN,17511,7252,10259,9946,7565,ITH,ITH3,5,Veneto
2021-02-27,LOM,13946,5871,8075,13305,641,ITC,ITC4,3,Lombardia
2021-04-21,PAB,3013,1468,1545,2165,848,ITH,ITH1,4,Provincia Autonoma Bolzano / Bozen
2021-04-28,PUG,19798,8876,10922,15028,4770,ITF,ITF4,16,Puglia
2021-06-27,BAS,2951,1449,1502,2335,616,ITF,ITF5,17,Basilicata
2021-03-17,ABR,4539,1873,2666,2799,1740,ITF,ITF1,13,Abruzzo
2021-03-31,MOL,2193,919,1274,1374,819,ITF,ITF2,14,Molise
2021-02-25,LIG,3457,1349,2108,3327,130,ITC,ITC3,7,Liguria
2021-06-02,SAR,9784,4689,5095,8144,1640,ITG,ITG2,20,Sardegna
2021-06-28,TOS,37613,18087,19526,8586,29027,ITI,ITI1,9,Toscana
2021-01-10,EMR,7171,2684,4487,7171,0,ITH,ITH5,8,Emilia-Romagna
2021-06-16,EMR,45194,23085,22109,25303,19891,ITH,ITH5,8,Emilia-Romagna
2021-06-24,PAB,3802,1963,1839,1613,2189,ITH,ITH1,4,Provincia Autonoma Bolzano / Bozen
2021-04-06,SIC,17747,8478,9269,13464,4283,ITG,ITG1,19,Sicilia
2021-01-20,TOS,1331,637,694,1083,248,ITI,ITI1,9,Toscana
2021-03-08,EMR,12201,5094,7107,9542,2659,ITH,ITH5,8,Emilia-Romagna
2021-03-23,PAT,2448,944,1504,1708,740,ITH,ITH2,4,Provincia Autonoma Trento
2021-01-04,MAR,1513,573,940,1513,0,ITI,ITI3,11,Marche
2021-03-30,FVG,7223,3252,3971,6300,923,ITH,ITH4,6,Friuli-Venezia Giulia
2021-04-20,SAR,10998,4994,6004,7782,3216,ITG,ITG2,20,Sardegna
2021-07-03,PIE,38387,19233,19154,14422,23965,ITC,ITC1,1,Piemonte
2020-12-30,LOM,114,42,72,114,0,ITC,ITC4,3,Lombardia
2021-01-08,VEN,9407,2835,6572,9407,0,ITH,ITH3,5,Veneto
2021-04-30,TOS,40192,17786,22406,20300,19892,ITI,ITI1,9,Toscana
2021-02-22,SIC,7891,4094,3797,7398,493,ITG,ITG1,19,Sicilia
2021-01-05,VDA,150,54,96,150,0,ITC,ITC2,2,Valle d'Aosta / Vallée d'Aoste
2020-12-27,SIC,92,55,37,92,0,ITG,ITG1,19,Sicilia
2021-06-02,SIC,35246,16289,18957,27474,7772,ITG,ITG1,19,Sicilia
2021-05-09,CAL,9620,4483,5137,6085,3535,ITF,ITF6,18,Calabria
2021-04-27,LAZ,30705,13860,16845,19857,10848,ITI,ITI4,12,Lazio
2021-04-29,BAS,4831,2385,2446,4410,421,ITF,ITF5,17,Basilicata
2021-05-02,CAM,43496,21541,21955,32137,11359,ITF,ITF3,15,Campania
2021-01-09,PAB,612,326,286,612,0,ITH,ITH1,4,Provincia Autonoma Bolzano / Bozen
2021-05-28,PAT,3720,1736,1984,1493,2227,ITH,ITH2,4,Provincia Autonoma Trento
2021-01-22,CAM,1525,776,749,673,852,ITF,ITF3,15,Campania
2021-03-01,LAZ,17115,7367,9748,13230,3885,ITI,ITI4,12,Lazio
2021-06-11,UMB,6905,3466,3439,6139,766,ITI,ITI2,10,Umbria
2021-01-14,VDA,237,69,168,237,0,ITC,ITC2,2,Valle d'Aosta / Vallée d'Aoste
2021-01-25,PAT,818,215,603,24,794,ITH,ITH2,4,Provincia Autonoma Trento
2021-03-17,BAS,1455,610,845,28,1427,ITF,ITF5,17,Basilicata
2021-04-14,MAR,10212,4562,5650,9842,370,ITI,ITI3,11,Marche
2021-01-29,CAL,2057,992,1065,228,1829,ITF,ITF6,18,Calabria
2021-01-09,PUG,4887,2250,2637,4887,0,ITF,ITF4,16,Puglia
2021-01-19,BAS,199,84,115,199,0,ITF,ITF5,17,Basilicata
2021-06-16,LOM,98621,50089,48532,50670,47951,ITC,ITC4,3,Lombardia
2021-06-25,BAS,3274,1552,1722,2444,830,ITF,ITF5,17,Basilicata
2021-03-25,PAT,2875,1105,1770,1826,1049,ITH,ITH2,4,Provincia Autonoma Trento
2021-07-04,BAS,1495,742,753,980,515,ITF,ITF5,17,Basilicata
2021-03-24,ABR,6383,2784,3599,4132,2251,ITF,ITF1,13,Abruzzo
2021-04-24,VDA,722,400,322,555,167,ITC,ITC2,2,Valle d'Aosta / Vallée d'Aoste
2020-12-30,MAR,17,5,12,17,0,ITI,ITI3,11,Marche
2021-05-24,CAL,17714,8841,8873,10017,7697,ITF,ITF6,18,Calabria
2021-06-26,CAM,61838,30165,31673,14002,47836,ITF,ITF3,15,Campania
2021-01-09,LIG,1335,481,854,1335,0,ITC,ITC3,7,Liguria
2021-02-15,VDA,264,136,128,229,35,ITC,ITC2,2,Valle d'Aosta / Vallée d'Aoste
2021-03-18,UMB,2965,1171,1794,1703,1262,ITI,ITI2,10,Umbria
2021-06-02,EMR,24081,12054,12027,19114,4967,ITH,ITH5,8,Emilia-Romagna
2021-04-19,LIG,12829,5615,7214,8999,3830,ITC,ITC3,7,Liguria
2021-05-01,PAB,2104,1067,1037,1944,160,ITH,ITH1,4,Provincia Autonoma Bolzano / Bozen
2021-05-07,CAL,16113,7592,8521,9732,6381,ITF,ITF6,18,Calabria
2021-05-08,PUG,54249,22965,31284,24525,29724,ITF,ITF4,16,Puglia
2021-06-26,UMB,9291,4720,4571,5675,3616,ITI,ITI2,10,Umbria
2021-02-18,TOS,8822,3285,5537,7926,896,ITI,ITI1,9,Toscana
2021-04-04,CAM,7967,4018,3949,6920,1047,ITF,ITF3,15,Campania
2021-01-02,MAR,456,141,315,456,0,ITI,ITI3,11,Marche
2021-02-13,CAL,1398,604,794,1033,365,ITF,ITF6,18,Calabria
2021-05-11,BAS,2654,1353,1301,1621,1033,ITF,ITF5,17,Basilicata
2021-05-29,TOS,31554,15255,16299,23393,8161,ITI,ITI1,9,Toscana
2021-06-10,VEN,51843,26785,25058,42585,9258,ITH,ITH3,5,Veneto
2021-06-12,SAR,14744,7187,7557,10044,4700,ITG,ITG2,20,Sardegna
2021-02-17,ABR,2071,948,1123,1789,282,ITF,ITF1,13,Abruzzo
2021-03-04,SAR,4365,2293,2072,3109,1256,ITG,ITG2,20,Sardegna
2021-04-02,VEN,24081,10616,13465,17753,6328,ITH,ITH3,5,Veneto
2021-04-16,SIC,28518,14326,14192,20250,8268,ITG,ITG1,19,Sicilia
2021-05-17,PIE,30920,14602,16318,17765,13155,ITC,ITC1,1,Piemonte
2021-06-12,CAM,60471,29734,30737,53258,7213,ITF,ITF3,15,Campania
2021-02-06,PIE,7995,2666,5329,400,7595,ITC,ITC1,1,Piemonte
2021-01-23,SIC,4430,2278,2152,205,4225,ITG,ITG1,19,Sicilia
2021-02-23,PIE,9234,3713,5521,8653,581,ITC,ITC1,1,Piemonte
2021-03-04,CAM,14707,5396,9311,8813,5894,ITF,ITF3,15,Campania
2021-03-12,PAB,1664,734,930,1251,413,ITH,ITH1,4,Provincia Autonoma Bolzano / Bozen
2021-03-21,SAR,4030,1809,2221,2590,1440,ITG,ITG2,20,Sardegna
2021-06-11,ABR,11556,5753,5803,8797,2759,ITF,ITF1,13,Abruzzo
2021-01-06,SIC,6240,3284,2956,6240,0,ITG,ITG1,19,Sicilia
2021-03-29,PAB,1171,499,672,412,759,ITH,ITH1,4,Provincia Autonoma Bolzano / Bozen
2021-05-31,PIE,29103,14056,15047,20524,8579,ITC,ITC1,1,Piemonte
2021-06-17,PIE,41004,20590,20414,24707,16297,ITC,ITC1,1,Piemonte
2021-01-18,PAT,644,154,490,589,55,ITH,ITH2,4,Provincia Autonoma Trento
2021-06-12,LOM,88525,47652,40873,85451,3074,ITC,ITC4,3,Lombardia
2021-03-09,PIE,14064,5515,8549,11721,2343,ITC,ITC1,1,Piemonte
2021-06-29,LOM,102342,50760,51582,54812,47530,ITC,ITC4,3,Lombardia
2021-03-21,LOM,23512,8494,15018,18318,5194,ITC,ITC4,3,Lombardia
2021-05-11,ABR,10751,5113,5638,5906,4845,ITF,ITF1,13,Abruzzo
2021-04-02,SIC,13881,6541,7340,9148,4733,ITG,ITG1,19,Sicilia
2021-02-10,SIC,4355,1776,2579,3974,381,ITG,ITG1,19,Sicilia
2021-03-23,TOS,9400,4376,5024,7125,2275,ITI,ITI1,9,Toscana
2021-06-24,MOL,3306,1542,1764,468,2838,ITF,ITF2,14,Molise
2021-03-07,MAR,5180,2107,3073,4426,754,ITI,ITI3,11,Marche
2021-03-13,EMR,16137,6362,9775,10824,5313,ITH,ITH5,8,Emilia-Romagna
2021-05-21,SIC,48559,23018,25541,26971,21588,ITG,ITG1,19,Sicilia
2021-03-02,MOL,667,383,284,509,158,ITF,ITF2,14,Molise
2021-06-09,VEN,42394,21753,20641,34982,7412,ITH,ITH3,5,Veneto
2021-06-11,CAL,17323,8509,8814,14737,2586,ITF,ITF6,18,Calabria
2021-02-13,LOM,6419,2441,3978,4942,1477,ITC,ITC4,3,Lombardia
2021-04-20,UMB,5444,2360,3084,3497,1947,ITI,ITI2,10,Umbria
2021-06-10,MOL,2571,1182,1389,1270,1301,ITF,ITF2,14,Molise
2021-01-08,CAL,2167,1034,1133,2167,0,ITF,ITF6,18,Calabria
2021-04-05,BAS,724,233,491,422,302,ITF,ITF5,17,Basilicata
2021-01-27,UMB,840,330,510,13,827,ITI,ITI2,10,Umbria
2021-03-27,EMR,21661,9059,12602,14753,6908,ITH,ITH5,8,Emilia-Romagna
2021-05-07,CAM,59763,29204,30559,43817,15946,ITF,ITF3,15,Campania
2021-03-18,CAL,4420,2065,2355,2356,2064,ITF,ITF6,18,Calabria
2020-12-30,TOS,327,104,223,327,0,ITI,ITI1,9,Toscana
2021-01-10,UMB,1065,274,791,1065,0,ITI,ITI2,10,Umbria
2021-01-27,CAM,7738,3820,3918,162,7576,ITF,ITF3,15,Campania
2021-04-13,EMR,23721,11129,12592,19379,4342,ITH,ITH5,8,Emilia-Romagna
2021-06-04,FVG,12037,6182,5855,10652,1385,ITH,ITH4,6,Friuli-Venezia Giulia
2021-05-21,UMB,8970,3668,5302,4142,4828,ITI,ITI2,10,Umbria
2021-01-03,EMR,2763,943,1820,2763,0,ITH,ITH5,8,Emilia-Romagna
2021-03-22,BAS,1188,536,652,640,548,ITF,ITF5,17,Basilicata
2021-05-04,UMB,5535,2544,2991,2412,3123,ITI,ITI2,10,Umbria
2021-04-01,LAZ,29628,14035,15593,22487,7141,ITI,ITI4,12,Lazio
2021-01-13,SAR,573,178,395,573,0,ITG,ITG2,20,Sardegna
2021-06-28,VEN,46649,23636,23013,18226,28423,ITH,ITH3,5,Veneto
2021-04-01,UMB,4372,1837,2535,2363,2009,ITI,ITI2,10,Umbria
2021-05-24,LIG,11829,5563,6266,9344,2485,ITC,ITC3,7,Liguria
2021-06-21,FVG,9050,4415,4635,1826,7224,ITH,ITH4,6,Friuli-Venezia Giulia
2021-01-21,PAB,953,442,511,139,814,ITH,ITH1,4,Provincia Autonoma Bolzano / Bozen
2021-05-25,VDA,1115,530,585,541,574,ITC,ITC2,2,Valle d'Aosta / Vallée d'Aoste
2021-03-13,FVG,2942,1124,1818,1670,1272,ITH,ITH4,6,Friuli-Venezia Giulia
2021-01-25,VEN,6468,2075,4393,159,6309,ITH,ITH3,5,Veneto
2021-02-14,VDA,48,16,32,1,47,ITC,ITC2,2,Valle d'Aosta / Vallée d'Aoste
2021-04-05,ABR,2692,1147,1545,1813,879,ITF,ITF1,13,Abruzzo
2021-05-07,LIG,13589,6037,7552,5797,7792,ITC,ITC3,7,Liguria
2021-01-01,PIE,1038,395,643,1038,0,ITC,ITC1,1,Piemonte
2021-05-08,VDA,904,540,364,526,378,ITC,ITC2,2,Valle d'Aosta / Vallée d'Aoste
2021-01-13,LOM,26432,8072,18360,26432,0,ITC,ITC4,3,Lombardia
2021-02-13,LIG,1080,508,572,800,280,ITC,ITC3,7,Liguria
2021-06-12,PUG,33862,16881,16981,25047,8815,ITF,ITF4,16,Puglia
2021-03-03,BAS,1747,817,930,1188,559,ITF,ITF5,17,Basilicata
2021-04-02,MOL,1455,709,746,678,777,ITF,ITF2,14,Molise
2021-05-02,PAT,3514,1955,1559,3477,37,ITH,ITH2,4,Provincia Autonoma Trento
2021-06-07,LIG,15683,7655,8028,8671,7012,ITC,ITC3,7,Liguria
2021-06-23,LAZ,61936,29129,32807,28722,33214,ITI,ITI4,12,Lazio
2021-01-16,MAR,2036,733,1303,2036,0,ITI,ITI3,11,Marche
2021-02-27,CAL,4002,2060,1942,3620,382,ITF,ITF6,18,Calabria
2021-05-25,BAS,4195,2112,2083,874,3321,ITF,ITF5,17,Basilicata
2021-04-01,SIC,14229,6609,7620,9565,4664,ITG,ITG1,19,Sicilia
2021-03-18,FVG,3372,1421,1951,1691,1681,ITH,ITH4,6,Friuli-Venezia Giulia
2021-03-26,PUG,11999,5838,6161,7354,4645,ITF,ITF4,16,Puglia
2021-05-28,SIC,51224,22957,28267,24734,26490,ITG,ITG1,19,Sicilia
2021-06-16,VEN,47175,23270,23905,25964,21211,ITH,ITH3,5,Veneto
2021-03-09,PUG,13604,6076,7528,11595,2009,ITF,ITF4,16,Puglia
2021-04-06,EMR,24747,11174,13573,20005,4742,ITH,ITH5,8,Emilia-Romagna
2021-01-01,VEN,1528,471,1057,1528,0,ITH,ITH3,5,Veneto
2021-01-13,PAT,421,123,298,421,0,ITH,ITH2,4,Provincia Autonoma Trento
2020-12-27,EMR,972,373,599,972,0,ITH,ITH5,8,Emilia-Romagna
2021-02-18,LIG,2768,1126,1642,2434,334,ITC,ITC3,7,Liguria
2021-03-06,LAZ,18359,7084,11275,14102,4257,ITI,ITI4,12,Lazio
2021-03-25,VEN,25952,11055,14897,19853,6099,ITH,ITH3,5,Veneto
2021-06-09,PIE,38559,20325,18234,35848,2711,ITC,ITC1,1,Piemonte
2021-02-03,CAM,8903,4003,4900,878,8025,ITF,ITF3,15,Campania
2021-04-11,VEN,20998,8869,12129,14702,6296,ITH,ITH3,5,Veneto
2021-06-20,BAS,4004,1879,2125,1968,2036,ITF,ITF5,17,Basilicata
2021-01-11,MAR,1176,411,765,1176,0,ITI,ITI3,11,Marche
2021-02-22,CAL,2053,1042,1011,1495,558,ITF,ITF6,18,Calabria
2021-03-18,PIE,11759,4805,6954,4029,7730,ITC,ITC1,1,Piemonte
2021-04-14,PUG,31932,15070,16862,28625,3307,ITF,ITF4,16,Puglia
2021-05-07,TOS,32117,14688,17429,11977,20140,ITI,ITI1,9,Toscana
2021-06-28,FVG,9722,4891,4831,2058,7664,ITH,ITH4,6,Friuli-Venezia Giulia
2021-03-28,PUG,3540,1654,1886,1214,2326,ITF,ITF4,16,Puglia
2021-03-29,ABR,5709,2599,3110,3070,2639,ITF,ITF1,13,Abruzzo
2021-03-30,LOM,39622,15589,24033,24842,14780,ITC,ITC4,3,Lombardia
2021-04-21,MAR,10782,4967,5815,9588,1194,ITI,ITI3,11,Marche
2021-06-02,CAL,12084,5798,6286,8818,3266,ITF,ITF6,18,Calabria
2021-03-20,FVG,3401,1409,1992,1310,2091,ITH,ITH4,6,Friuli-Venezia Giulia
2021-07-01,PAB,4534,2248,2286,1373,3161,ITH,ITH1,4,Provincia Autonoma Bolzano / Bozen
2021-05-14,LIG,13107,5838,7269,8780,4327,ITC,ITC3,7,Liguria
2021-01-20,SAR,210,77,133,208,2,ITG,ITG2,20,Sardegna
2021-01-28,MAR,2086,725,1361,165,1921,ITI,ITI3,11,Marche
2021-05-18,VDA,970,484,486,353,617,ITC,ITC2,2,Valle d'Aosta / Vallée d'Aoste
2021-06-18,UMB,4759,2349,2410,1607,3152,ITI,ITI2,10,Umbria
2021-01-06,LOM,7060,2493,4567,7060,0,ITC,ITC4,3,Lombardia
2021-05-31,LIG,14639,7328,7311,9125,5514,ITC,ITC3,7,Liguria
2021-06-19,PUG,33934,16985,16949,22196,11738,ITF,ITF4,16,Puglia
2021-02-07,VDA,292,120,172,190,102,ITC,ITC2,2,Valle d'Aosta / Vallée d'Aoste
2021-04-13,VEN,14031,6324,7707,8545,5486,ITH,ITH3,5,Veneto
2021-06-03,ABR,13180,6278,6902,9404,3776,ITF,ITF1,13,Abruzzo
2021-01-13,FVG,2650,834,1816,2650,0,ITH,ITH4,6,Friuli-Venezia Giulia
2021-02-13,TOS,7786,2361,5425,7559,227,ITI,ITI1,9,Toscana
2021-03-09,LIG,5930,2753,3177,4499,1431,ITC,ITC3,7,Liguria
2021-04-06,FVG,6668,3126,3542,5518,1150,ITH,ITH4,6,Friuli-Venezia Giulia
2021-03-12,ABR,6014,1987,4027,4432,1582,ITF,ITF1,13,Abruzzo
2021-04-04,MAR,3824,1792,2032,2655,1169,ITI,ITI3,11,Marche
2021-05-16,CAL,13781,6726,7055,9972,3809,ITF,ITF6,18,Calabria
2020-12-27,FVG,262,149,113,262,0,ITH,ITH4,6,Friuli-Venezia Giulia
2021-03-26,MOL,2575,1045,1530,1933,642,ITF,ITF2,14,Molise
2021-02-20,LIG,1335,637,698,1334,1,ITC,ITC3,7,Liguria
2021-05-01,VDA,940,563,377,456,484,ITC,ITC2,2,Valle d'Aosta / Vallée d'Aoste
2021-06-20,ABR,8318,4180,4138,5390,2928,ITF,ITF1,13,Abruzzo
2021-03-03,PIE,12120,4644,7476,11301,819,ITC,ITC1,1,Piemonte
2021-03-29,SAR,4725,1829,2896,4136,589,ITG,ITG2,20,Sardegna
2021-05-13,UMB,5914,2657,3257,3831,2083,ITI,ITI2,10,Umbria
2021-03-14,ABR,1873,731,1142,1207,666,ITF,ITF1,13,Abruzzo
2021-04-14,VDA,941,430,511,717,224,ITC,ITC2,2,Valle d'Aosta / Vallée d'Aoste
2021-05-18,CAM,52179,23229,28950,32525,19654,ITF,ITF3,15,Campania
2021-04-15,SAR,11847,5541,6306,6889,4958,ITG,ITG2,20,Sardegna
2021-01-03,VEN,5157,1562,3595,5157,0,ITH,ITH3,5,Veneto
2021-02-19,UMB,743,293,450,526,217,ITI,ITI2,10,Umbria
2021-06-21,PUG,40843,19891,20952,21400,19443,ITF,ITF4,16,Puglia
2021-01-05,SAR,1327,446,881,1327,0,ITG,ITG2,20,Sardegna
2021-01-08,TOS,5947,1643,4304,5947,0,ITI,ITI1,9,Toscana
2021-03-20,PIE,11922,4899,7023,6024,5898,ITC,ITC1,1,Piemonte
2021-06-09,MAR,14043,7304,6739,12174,1869,ITI,ITI3,11,Marche
2021-03-04,PAB,1715,1005,710,1486,229,ITH,ITH1,4,Provincia Autonoma Bolzano / Bozen
2021-01-22,SAR,83,47,36,55,28,ITG,ITG2,20,Sardegna
2021-02-12,PAT,1013,341,672,590,423,ITH,ITH2,4,Provincia Autonoma Trento
2021-01-17,CAL,897,431,466,802,95,ITF,ITF6,18,Calabria
2021-05-16,LIG,3705,1862,1843,2145,1560,ITC,ITC3,7,Liguria
2021-05-18,LOM,88193,42154,46039,32630,55563,ITC,ITC4,3,Lombardia
2021-02-19,SIC,4906,2647,2259,4343,563,ITG,ITG1,19,Sicilia
2021-06-04,LOM,104412,54210,50202,94788,9624,ITC,ITC4,3,Lombardia
2021-02-22,LIG,3343,1476,1867,3201,142,ITC,ITC3,7,Liguria
2021-02-24,LOM,14720,5957,8763,13766,954,ITC,ITC4,3,Lombardia
2021-02-25,ABR,3052,1340,1712,2524,528,ITF,ITF1,13,Abruzzo
2021-03-01,PAT,1237,454,783,942,295,ITH,ITH2,4,Provincia Autonoma Trento
2021-03-08,SIC,13392,5865,7527,10779,2613,ITG,ITG1,19,Sicilia
2021-06-05,ABR,14578,6840,7738,10531,4047,ITF,ITF1,13,Abruzzo
2021-06-07,MAR,13162,6500,6662,10712,2450,ITI,ITI3,11,Marche
2021-01-31,LAZ,4460,1854,2606,477,3983,ITI,ITI4,12,Lazio
2021-02-05,CAM,7260,3463,3797,2132,5128,ITF,ITF3,15,Campania
2021-03-20,PAT,874,403,471,671,203,ITH,ITH2,4,Provincia Autonoma Trento
2021-03-24,CAL,7810,3572,4238,4534,3276,ITF,ITF6,18,Calabria
2021-03-03,PAT,1659,622,1037,1141,518,ITH,ITH2,4,Provincia Autonoma Trento
2021-03-14,BAS,1010,477,533,541,469,ITF,ITF5,17,Basilicata
2021-01-02,VDA,6,5,1,6,0,ITC,ITC2,2,Valle d'Aosta / Vallée d'Aoste
2021-05-11,LAZ,48282,22171,26111,31743,16539,ITI,ITI4,12,Lazio
2021-06-13,EMR,27299,14259,13040,23032,4267,ITH,ITH5,8,Emilia-Romagna
2021-03-26,VDA,498,204,294,491,7,ITC,ITC2,2,Valle d'Aosta / Vallée d'Aoste
2021-05-16,LOM,68699,32505,36194,36496,32203,ITC,ITC4,3,Lombardia
2021-05-30,SIC,35769,16169,19600,17721,18048,ITG,ITG1,19,Sicilia
2021-03-05,EMR,17850,5839,12011,14396,3454,ITH,ITH5,8,Emilia-Romagna
2021-02-05,LOM,25706,7456,18250,2428,23278,ITC,ITC4,3,Lombardia
2021-02-27,MAR,3384,1450,1934,3175,209,ITI,ITI3,11,Marche
2021-04-10,CAL,11621,5261,6360,6767,4854,ITF,ITF6,18,Calabria
2021-05-22,MAR,11937,5719,6218,7489,4448,ITI,ITI3,11,Marche
2021-03-04,PIE,14535,5770,8765,11587,2948,ITC,ITC1,1,Piemonte
2021-03-08,CAL,5431,2914,2517,4365,1066,ITF,ITF6,18,Calabria
2021-03-30,SAR,8778,3591,5187,6502,2276,ITG,ITG2,20,Sardegna
2021-04-27,UMB,5663,2401,3262,3085,2578,ITI,ITI2,10,Umbria
2021-02-26,BAS,2150,904,1246,2070,80,ITF,ITF5,17,Basilicata
2021-02-03,UMB,724,174,550,67,657,ITI,ITI2,10,Umbria
2021-03-10,VDA,438,183,255,225,213,ITC,ITC2,2,Valle d'Aosta / Vallée d'Aoste
2021-03-20,LAZ,19151,7600,11551,13266,5885,ITI,ITI4,12,Lazio
2021-05-07,PAT,5997,3085,2912,5156,841,ITH,ITH2,4,Provincia Autonoma Trento
2021-05-14,SIC,52043,24397,27646,36366,15677,ITG,ITG1,19,Sicilia
2021-02-16,PAB,530,205,325,530,0,ITH,ITH1,4,Provincia Autonoma Bolzano / Bozen
2021-02-23,PUG,9364,4421,4943,8876,488,ITF,ITF4,16,Puglia
2021-04-20,PAT,2879,1377,1502,2843,36,ITH,ITH2,4,Provincia Autonoma Trento
2021-05-02,LOM,83504,38337,45167,61040,22464,ITC,ITC4,3,Lombardia
2021-01-06,SAR,1615,549,1066,1615,0,ITG,ITG2,20,Sardegna
2021-02-11,MAR,1987,657,1330,1598,389,ITI,ITI3,11,Marche
2021-03-25,CAL,7435,3493,3942,4576,2859,ITF,ITF6,18,Calabria
2021-01-28,PAB,871,308,563,9,862,ITH,ITH1,4,Provincia Autonoma Bolzano / Bozen
2021-02-02,MOL,539,176,363,216,323,ITF,ITF2,14,Molise
2021-02-21,VDA,18,3,15,0,18,ITC,ITC2,2,Valle d'Aosta / Vallée d'Aoste
2021-05-09,PAT,2324,1210,1114,1980,344,ITH,ITH2,4,Provincia Autonoma Trento
2021-05-20,BAS,5854,2963,2891,2889,2965,ITF,ITF5,17,Basilicata
2021-06-30,LAZ,62462,29345,33117,30178,32284,ITI,ITI4,12,Lazio
2021-01-16,MOL,420,166,254,420,0,ITF,ITF2,14,Molise
2021-04-13,CAM,26606,12685,13921,21073,5533,ITF,ITF3,15,Campania
2021-05-05,MAR,11678,5316,6362,5249,6429,ITI,ITI3,11,Marche
2021-06-16,CAL,17896,8250,9646,11804,6092,ITF,ITF6,18,Calabria
2021-01-03,CAM,3836,2009,1827,3836,0,ITF,ITF3,15,Campania
2021-02-15,PAT,534,188,346,420,114,ITH,ITH2,4,Provincia Autonoma Trento
2021-04-26,MOL,1157,521,636,826,331,ITF,ITF2,14,Molise
2021-06-06,BAS,4502,2070,2432,3723,779,ITF,ITF5,17,Basilicata
2021-06-01,VDA,871,469,402,518,353,ITC,ITC2,2,Valle d'Aosta / Vallée d'Aoste
2021-04-08,LAZ,26734,12243,14491,19037,7697,ITI,ITI4,12,Lazio
2021-05-26,PAT,3917,1843,2074,1225,2692,ITH,ITH2,4,Provincia Autonoma Trento
2021-04-09,MOL,2324,1251,1073,2133,191,ITF,ITF2,14,Molise
2021-04-13,LOM,47644,21267,26377,33567,14077,ITC,ITC4,3,Lombardia
2021-06-07,TOS,34816,17056,17760,31213,3603,ITI,ITI1,9,Toscana
2021-06-23,SAR,20525,9659,10866,6276,14249,ITG,ITG2,20,Sardegna
2021-01-15,SIC,5201,2282,2919,5201,0,ITG,ITG1,19,Sicilia
2021-04-20,FVG,7114,3062,4052,3209,3905,ITH,ITH4,6,Friuli-Venezia Giulia
2021-05-28,EMR,41171,18929,22242,17847,23324,ITH,ITH5,8,Emilia-Romagna
2021-04-25,SIC,21352,10185,11167,16375,4977,ITG,ITG1,19,Sicilia
2021-05-21,TOS,28884,13455,15429,17473,11411,ITI,ITI1,9,Toscana
2021-04-30,LOM,117249,54793,62456,89759,27490,ITC,ITC4,3,Lombardia
2021-02-01,SIC,5904,2625,3279,294,5610,ITG,ITG1,19,Sicilia
2021-01-20,LOM,5666,1377,4289,5552,114,ITC,ITC4,3,Lombardia
2021-01-18,MOL,114,48,66,114,0,ITF,ITF2,14,Molise
2021-04-27,VEN,28135,12757,15378,21221,6914,ITH,ITH3,5,Veneto
2021-03-22,SIC,16587,7838,8749,11224,5363,ITG,ITG1,19,Sicilia
2021-04-22,EMR,29050,13451,15599,14972,14078,ITH,ITH5,8,Emilia-Romagna
2021-06-19,ABR,10309,5079,5230,6481,3828,ITF,ITF1,13,Abruzzo
2021-07-02,LAZ,47529,22752,24777,6621,40908,ITI,ITI4,12,Lazio
2021-01-17,VEN,1933,781,1152,1584,349,ITH,ITH3,5,Veneto
2021-02-05,UMB,780,234,546,18,762,ITI,ITI2,10,Umbria
2021-01-12,EMR,9476,3124,6352,9476,0,ITH,ITH5,8,Emilia-Romagna
2021-06-30,SIC,31937,14742,17195,11286,20651,ITG,ITG1,19,Sicilia
2020-12-29,SIC,243,152,91,243,0,ITG,ITG1,19,Sicilia
2021-01-10,FVG,2940,918,2022,2940,0,ITH,ITH4,6,Friuli-Venezia Giulia
2021-03-28,ABR,2415,1015,1400,2043,372,ITF,ITF1,13,Abruzzo
2021-06-25,PIE,45253,22538,22715,20823,24430,ITC,ITC1,1,Piemonte
2021-04-11,MOL,1196,591,605,1182,14,ITF,ITF2,14,Molise
2021-01-18,PUG,1845,771,1074,1496,349,ITF,ITF4,16,Puglia
2021-04-14,BAS,2042,1000,1042,1368,674,ITF,ITF5,17,Basilicata
2021-04-05,FVG,2895,1438,1457,2880,15,ITH,ITH4,6,Friuli-Venezia Giulia
2021-07-03,MOL,2490,1250,1240,353,2137,ITF,ITF2,14,Molise
2021-04-03,PIE,19435,8160,11275,10888,8547,ITC,ITC1,1,Piemonte
2021-01-21,BAS,30,10,20,30,0,ITF,ITF5,17,Basilicata
2021-02-03,VEN,5945,1667,4278,480,5465,ITH,ITH3,5,Veneto
2021-01-10,PIE,5214,2275,2939,5214,0,ITC,ITC1,1,Piemonte
2021-06-13,SIC,33490,16642,16848,29995,3495,ITG,ITG1,19,Sicilia
2021-01-04,BAS,607,271,336,607,0,ITF,ITF5,17,Basilicata
2021-01-22,LOM,3142,868,2274,3073,69,ITC,ITC4,3,Lombardia
2021-06-16,LIG,15721,7561,8160,8727,6994,ITC,ITC3,7,Liguria
2021-01-12,FVG,2260,713,1547,2260,0,ITH,ITH4,6,Friuli-Venezia Giulia
2021-04-25,PAB,3073,1497,1576,2401,672,ITH,ITH1,4,Provincia Autonoma Bolzano / Bozen
2021-01-29,FVG,2412,813,1599,264,2148,ITH,ITH4,6,Friuli-Venezia Giulia
2021-02-06,PUG,4549,1931,2618,1592,2957,ITF,ITF4,16,Puglia
2021-03-01,TOS,4474,1734,2740,833,3641,ITI,ITI1,9,Toscana
2021-04-29,VEN,50265,23380,26885,37082,13183,ITH,ITH3,5,Veneto
2021-01-20,PUG,1548,542,1006,1540,8,ITF,ITF4,16,Puglia
2021-03-08,LIG,5623,2458,3165,3934,1689,ITC,ITC3,7,Liguria
2021-04-30,PUG,34919,15641,19278,22949,11970,ITF,ITF4,16,Puglia
2021-04-22,FVG,6781,3084,3697,3093,3688,ITH,ITH4,6,Friuli-Venezia Giulia
2021-07-04,UMB,1856,937,919,1282,574,ITI,ITI2,10,Umbria
2021-02-05,VEN,8377,2534,5843,1417,6960,ITH,ITH3,5,Veneto
2021-04-14,ABR,6593,2949,3644,4473,2120,ITF,ITF1,13,Abruzzo
2021-05-07,MAR,12839,5806,7033,3660,9179,ITI,ITI3,11,Marche
2021-06-18,CAL,18438,8571,9867,10953,7485,ITF,ITF6,18,Calabria
2021-06-27,EMR,27934,14065,13869,15262,12672,ITH,ITH5,8,Emilia-Romagna
2021-04-12,UMB,7085,3081,4004,5368,1717,ITI,ITI2,10,Umbria
2021-02-22,VEN,7014,3041,3973,6627,387,ITH,ITH3,5,Veneto
2021-03-25,LIG,9766,4231,5535,6374,3392,ITC,ITC3,7,Liguria
2021-04-13,PUG,28725,13625,15100,25324,3401,ITF,ITF4,16,Puglia
2021-02-13,MAR,1093,462,631,1011,82,ITI,ITI3,11,Marche
2021-01-19,UMB,102,23,79,102,0,ITI,ITI2,10,Umbria
2021-02-23,VDA,216,123,93,216,0,ITC,ITC2,2,Valle d'Aosta / Vallée d'Aoste
2021-05-05,EMR,30091,13984,16107,18841,11250,ITH,ITH5,8,Emilia-Romagna
2021-02-03,ABR,2062,717,1345,419,1643,ITF,ITF1,13,Abruzzo
2021-07-03,LAZ,47022,21973,25049,4693,42329,ITI,ITI4,12,Lazio
2021-01-27,LOM,8036,2675,5361,808,7228,ITC,ITC4,3,Lombardia
2021-02-17,CAL,1866,824,1042,1655,211,ITF,ITF6,18,Calabria
2021-05-29,PUG,30406,14328,16078,21024,9382,ITF,ITF4,16,Puglia
2021-07-03,LOM,97864,49365,48499,42450,55414,ITC,ITC4,3,Lombardia
2021-02-10,CAM,6905,3413,3492,6728,177,ITF,ITF3,15,Campania
2021-03-19,MOL,1184,482,702,757,427,ITF,ITF2,14,Molise
2021-05-02,PIE,25097,11276,13821,14352,10745,ITC,ITC1,1,Piemonte
2021-03-25,LOM,42819,16013,26806,30136,12683,ITC,ITC4,3,Lombardia
2021-04-02,PUG,12843,6000,6843,8319,4524,ITF,ITF4,16,Puglia
2021-05-28,CAL,20981,10193,10788,11522,9459,ITF,ITF6,18,Calabria
2021-01-21,MOL,6,2,4,6,0,ITF,ITF2,14,Molise
2021-04-08,CAM,28391,13749,14642,22548,5843,ITF,ITF3,15,Campania
2021-05-21,LOM,93819,45231,48588,29135,64684,ITC,ITC4,3,Lombardia
2021-01-23,MAR,557,190,367,123,434,ITI,ITI3,11,Marche
2021-02-20,PAT,407,245,162,123,284,ITH,ITH2,4,Provincia Autonoma Trento
2021-06-01,BAS,6134,2925,3209,3059,3075,ITF,ITF5,17,Basilicata
2021-06-04,CAM,74233,35667,38566,65174,9059,ITF,ITF3,15,Campania
2021-06-29,MAR,13183,6510,6673,4970,8213,ITI,ITI3,11,Marche
2021-04-15,CAL,7721,3784,3937,6005,1716,ITF,ITF6,18,Calabria
2021-05-03,MAR,10330,4658,5672,4921,5409,ITI,ITI3,11,Marche
2021-02-27,FVG,3530,1200,2330,3529,1,ITH,ITH4,6,Friuli-Venezia Giulia
2021-02-28,ABR,1702,508,1194,1700,2,ITF,ITF1,13,Abruzzo
2021-05-07,SIC,36550,17257,19293,24938,11612,ITG,ITG1,19,Sicilia
2021-06-02,TOS,27568,13605,13963,22062,5506,ITI,ITI1,9,Toscana
2021-01-02,ABR,552,220,332,552,0,ITF,ITF1,13,Abruzzo
2021-03-11,SIC,15337,6620,8717,12967,2370,ITG,ITG1,19,Sicilia
2021-04-06,TOS,22222,9821,12401,18507,3715,ITI,ITI1,9,Toscana
2021-04-25,FVG,2364,989,1375,2353,11,ITH,ITH4,6,Friuli-Venezia Giulia
2021-05-23,EMR,25480,11859,13621,13888,11592,ITH,ITH5,8,Emilia-Romagna
2021-06-08,ABR,12687,6523,6164,10490,2197,ITF,ITF1,13,Abruzzo
2021-02-08,TOS,4097,1360,2737,3638,459,ITI,ITI1,9,Toscana
2021-04-01,CAL,8672,3946,4726,4194,4478,ITF,ITF6,18,Calabria
2021-06-30,UMB,10433,5276,5157,3755,6678,ITI,ITI2,10,Umbria
2021-01-27,SIC,7282,3709,3573,177,7105,ITG,ITG1,19,Sicilia
2021-04-26,ABR,8561,4065,4496,7347,1214,ITF,ITF1,13,Abruzzo
2021-05-19,TOS,27945,13567,14378,18902,9043,ITI,ITI1,9,Toscana
2021-05-21,CAM,63706,29603,34103,43181,20525,ITF,ITF3,15,Campania
2021-01-30,LIG,1661,567,1094,24,1637,ITC,ITC3,7,Liguria
2021-03-23,VEN,22212,10239,11973,17500,4712,ITH,ITH3,5,Veneto
2021-05-15,PAB,7005,3691,3314,6711,294,ITH,ITH1,4,Provincia Autonoma Bolzano / Bozen
2021-02-03,LAZ,6488,2488,4000,964,5524,ITI,ITI4,12,Lazio
2021-02-04,PAB,1958,593,1365,8,1950,ITH,ITH1,4,Provincia Autonoma Bolzano / Bozen
2021-05-19,VEN,32919,15072,17847,17005,15914,ITH,ITH3,5,Veneto
2021-01-13,SIC,5175,2437,2738,5175,0,ITG,ITG1,19,Sicilia
2021-01-15,FVG,2021,605,1416,2021,0,ITH,ITH4,6,Friuli-Venezia Giulia
2021-06-01,ABR,10999,4882,6117,6632,4367,ITF,ITF1,13,Abruzzo
2021-03-28,LIG,1141,511,630,390,751,ITC,ITC3,7,Liguria
2021-05-07,SAR,14472,6632,7840,9949,4523,ITG,ITG2,20,Sardegna
2021-04-13,TOS,8487,3506,4981,6030,2457,ITI,ITI1,9,Toscana
2021-01-20,LAZ,4809,1945,2864,3266,1543,ITI,ITI4,12,Lazio
2021-01-27,SAR,1413,497,916,79,1334,ITG,ITG2,20,Sardegna
2021-03-28,MAR,4125,1739,2386,2434,1691,ITI,ITI3,11,Marche
2021-07-03,SAR,15743,7516,8227,3185,12558,ITG,ITG2,20,Sardegna
2021-01-08,PAT,1451,314,1137,1451,0,ITH,ITH2,4,Provincia Autonoma Trento
2021-01-31,VDA,291,91,200,58,233,ITC,ITC2,2,Valle d'Aosta / Vallée d'Aoste
2021-06-14,PAT,5741,2968,2773,2117,3624,ITH,ITH2,4,Provincia Autonoma Trento
2021-01-30,MAR,1905,668,1237,27,1878,ITI,ITI3,11,Marche
2021-02-27,PIE,12691,4851,7840,12346,345,ITC,ITC1,1,Piemonte
2021-03-25,SAR,9116,3973,5143,7809,1307,ITG,ITG2,20,Sardegna
2021-06-08,BAS,4578,2187,2391,4220,358,ITF,ITF5,17,Basilicata
2021-04-18,PAT,1855,845,1010,1846,9,ITH,ITH2,4,Provincia Autonoma Trento
2021-04-16,PUG,35996,16916,19080,32714,3282,ITF,ITF4,16,Puglia
2021-04-25,PIE,20233,9305,10928,17732,2501,ITC,ITC1,1,Piemonte
2021-05-14,LAZ,51479,23519,27960,33163,18316,ITI,ITI4,12,Lazio
2021-05-21,SAR,22639,11205,11434,16543,6096,ITG,ITG2,20,Sardegna
2021-02-08,VEN,5003,1559,3444,1929,3074,ITH,ITH3,5,Veneto
2021-04-02,PAB,2077,837,1240,720,1357,ITH,ITH1,4,Provincia Autonoma Bolzano / Bozen
2021-01-15,PIE,9114,3012,6102,9114,0,ITC,ITC1,1,Piemonte
2021-02-18,PUG,4378,1846,2532,3773,605,ITF,ITF4,16,Puglia
2021-03-18,LAZ,14225,6078,8147,7834,6391,ITI,ITI4,12,Lazio
2021-05-07,LOM,92284,43694,48590,69904,22380,ITC,ITC4,3,Lombardia
2021-06-21,PIE,38230,19075,19155,17562,20668,ITC,ITC1,1,Piemonte
2021-03-06,PAT,786,277,509,635,151,ITH,ITH2,4,Provincia Autonoma Trento
2021-04-06,VEN,28955,13327,15628,23913,5042,ITH,ITH3,5,Veneto
2021-05-29,PAB,7134,3768,3366,3994,3140,ITH,ITH1,4,Provincia Autonoma Bolzano / Bozen
2021-01-28,MOL,613,217,396,17,596,ITF,ITF2,14,Molise
2021-03-13,PIE,13047,4723,8324,11602,1445,ITC,ITC1,1,Piemonte
2021-04-01,CAM,24680,12010,12670,20547,4133,ITF,ITF3,15,Campania
2021-03-18,LOM,27390,10954,16436,16153,11237,ITC,ITC4,3,Lombardia
2021-04-08,CAL,9286,4381,4905,5769,3517,ITF,ITF6,18,Calabria
2021-04-09,PUG,22050,9504,12546,17427,4623,ITF,ITF4,16,Puglia
2021-05-28,CAM,73016,35288,37728,26902,46114,ITF,ITF3,15,Campania
2021-02-10,CAL,2512,1080,1432,883,1629,ITF,ITF6,18,Calabria
2021-02-11,PUG,3697,1401,2296,2419,1278,ITF,ITF4,16,Puglia
2021-05-14,LOM,85932,41382,44550,55633,30299,ITC,ITC4,3,Lombardia
2021-03-12,MOL,1459,637,822,1423,36,ITF,ITF2,14,Molise
2021-04-11,PAT,2340,1135,1205,2249,91,ITH,ITH2,4,Provincia Autonoma Trento
2021-04-12,BAS,2172,1052,1120,1683,489,ITF,ITF5,17,Basilicata
2021-05-10,MAR,9448,4336,5112,4897,4551,ITI,ITI3,11,Marche
2021-05-22,PUG,34597,15844,18753,24215,10382,ITF,ITF4,16,Puglia
2021-01-14,MOL,646,239,407,646,0,ITF,ITF2,14,Molise
2021-03-14,MAR,2499,1032,1467,1907,592,ITI,ITI3,11,Marche
2021-06-04,CAL,17323,8055,9268,12831,4492,ITF,ITF6,18,Calabria
2021-01-20,SIC,957,508,449,691,266,ITG,ITG1,19,Sicilia
2020-12-31,MAR,391,183,208,391,0,ITI,ITI3,11,Marche
2021-02-11,CAL,2339,1044,1295,1084,1255,ITF,ITF6,18,Calabria
2021-05-09,BAS,4683,2339,2344,2989,1694,ITF,ITF5,17,Basilicata
2021-06-08,MOL,2885,1593,1292,2189,696,ITF,ITF2,14,Molise
2021-03-16,SIC,9559,4278,5281,3623,5936,ITG,ITG1,19,Sicilia
2021-06-19,FVG,8412,4383,4029,1296,7116,ITH,ITH4,6,Friuli-Venezia Giulia
2021-01-05,PAB,830,286,544,830,0,ITH,ITH1,4,Provincia Autonoma Bolzano / Bozen
2021-02-04,PAT,976,304,672,422,554,ITH,ITH2,4,Provincia Autonoma Trento
2021-02-15,BAS,622,232,390,580,42,ITF,ITF5,17,Basilicata
2021-05-08,LIG,7526,3333,4193,2314,5212,ITC,ITC3,7,Liguria
2021-01-09,VEN,7928,2539,5389,7928,0,ITH,ITH3,5,Veneto
2021-01-29,BAS,617,231,386,63,554,ITF,ITF5,17,Basilicata
2021-05-26,CAM,52668,25833,26835,21572,31096,ITF,ITF3,15,Campania
2021-01-23,PAB,197,117,80,0,197,ITH,ITH1,4,Provincia Autonoma Bolzano / Bozen
2021-01-25,LIG,2725,889,1836,476,2249,ITC,ITC3,7,Liguria
2021-04-03,UMB,2097,712,1385,1045,1052,ITI,ITI2,10,Umbria
2021-03-18,VEN,12612,5138,7474,7384,5228,ITH,ITH3,5,Veneto
2021-05-05,LIG,13709,6133,7576,5291,8418,ITC,ITC3,7,Liguria
2021-06-14,SAR,13735,6634,7101,10126,3609,ITG,ITG2,20,Sardegna
2021-03-06,SAR,2638,1079,1559,858,1780,ITG,ITG2,20,Sardegna
2021-02-27,SIC,12235,5501,6734,11031,1204,ITG,ITG1,19,Sicilia
2021-03-11,FVG,3476,1517,1959,1725,1751,ITH,ITH4,6,Friuli-Venezia Giulia
2021-05-27,ABR,13309,6093,7216,8488,4821,ITF,ITF1,13,Abruzzo
2021-05-03,PAB,1830,847,983,417,1413,ITH,ITH1,4,Provincia Autonoma Bolzano / Bozen
2021-06-26,VEN,47499,24239,23260,13655,33844,ITH,ITH3,5,Veneto
2021-03-05,BAS,1855,857,998,1109,746,ITF,ITF5,17,Basilicata
2021-06-02,PIE,26531,12998,13533,22062,4469,ITC,ITC1,1,Piemonte
2021-06-21,LAZ,61236,28386,32850,28861,32375,ITI,ITI4,12,Lazio
2021-06-28,SAR,14981,7036,7945,3116,11865,ITG,ITG2,20,Sardegna
2021-02-23,PAB,769,324,445,763,6,ITH,ITH1,4,Provincia Autonoma Bolzano / Bozen
2021-02-04,MAR,2384,842,1542,112,2272,ITI,ITI3,11,Marche
2021-02-22,PIE,8483,3472,5011,7893,590,ITC,ITC1,1,Piemonte
2021-06-13,BAS,3009,1437,1572,2701,308,ITF,ITF5,17,Basilicata
2021-04-13,PAT,2556,1059,1497,2049,507,ITH,ITH2,4,Provincia Autonoma Trento
2021-01-20,PAT,292,73,219,280,12,ITH,ITH2,4,Provincia Autonoma Trento
2021-05-17,PAB,3139,1516,1623,2445,694,ITH,ITH1,4,Provincia Autonoma Bolzano / Bozen
2021-03-02,PUG,16388,6091,10297,15086,1302,ITF,ITF4,16,Puglia
2021-04-06,SAR,7464,3125,4339,5035,2429,ITG,ITG2,20,Sardegna
2021-04-25,LOM,51497,23613,27884,46754,4743,ITC,ITC4,3,Lombardia
2021-03-13,LAZ,21783,8708,13075,15889,5894,ITI,ITI4,12,Lazio
2021-03-17,VDA,433,185,248,273,160,ITC,ITC2,2,Valle d'Aosta / Vallée d'Aoste
2021-04-30,PAT,4929,2403,2526,4778,151,ITH,ITH2,4,Provincia Autonoma Trento
2020-12-27,SAR,65,34,31,65,0,ITG,ITG2,20,Sardegna
2021-03-11,PIE,13821,5118,8703,10724,3097,ITC,ITC1,1,Piemonte
2021-06-03,PAB,4722,2566,2156,3775,947,ITH,ITH1,4,Provincia Autonoma Bolzano / Bozen
2021-06-10,PUG,46707,22937,23770,29750,16957,ITF,ITF4,16,Puglia
2021-03-03,VDA,255,118,137,187,68,ITC,ITC2,2,Valle d'Aosta / Vallée d'Aoste
2021-04-06,CAM,24511,11562,12949,19987,4524,ITF,ITF3,15,Campania
2021-05-19,PAT,5101,2458,2643,3846,1255,ITH,ITH2,4,Provincia Autonoma Trento
2021-06-28,LOM,102654,52363,50291,71925,30729,ITC,ITC4,3,Lombardia
2021-04-04,PUG,5967,2963,3004,5962,5,ITF,ITF4,16,Puglia
2020-12-27,CAM,720,422,298,720,0,ITF,ITF3,15,Campania
2021-03-19,ABR,5793,2584,3209,2773,3020,ITF,ITF1,13,Abruzzo
2021-05-23,CAL,11388,5552,5836,7038,4350,ITF,ITF6,18,Calabria
2021-02-08,SIC,3906,1687,2219,2129,1777,ITG,ITG1,19,Sicilia
2021-01-18,MAR,696,237,459,547,149,ITI,ITI3,11,Marche
2021-03-01,CAL,2728,1548,1180,2273,455,ITF,ITF6,18,Calabria
2021-03-25,PIE,17071,7209,9862,8432,8639,ITC,ITC1,1,Piemonte
2021-05-27,BAS,3602,1855,1747,1073,2529,ITF,ITF5,17,Basilicata
2021-01-08,UMB,1187,344,843,1187,0,ITI,ITI2,10,Umbria
2021-01-09,MOL,450,152,298,450,0,ITF,ITF2,14,Molise
2021-04-20,CAM,32034,15499,16535,20722,11312,ITF,ITF3,15,Campania
2021-03-21,PUG,2694,1227,1467,590,2104,ITF,ITF4,16,Puglia
2021-04-06,LOM,43063,17585,25478,25128,17935,ITC,ITC4,3,Lombardia
2021-04-28,MAR,10888,4956,5932,6157,4731,ITI,ITI3,11,Marche
2021-06-09,CAL,17489,8211,9278,15255,2234,ITF,ITF6,18,Calabria
2021-03-05,ABR,5348,1958,3390,4651,697,ITF,ITF1,13,Abruzzo
2021-04-19,MOL,1827,842,985,1049,778,ITF,ITF2,14,Molise
2021-02-20,TOS,4640,1789,2851,4127,513,ITI,ITI1,9,Toscana
2021-04-13,FVG,7367,3290,4077,5764,1603,ITH,ITH4,6,Friuli-Venezia Giulia
2021-06-29,PUG,44820,21447,23373,15231,29589,ITF,ITF4,16,Puglia
2021-01-03,FVG,312,122,190,312,0,ITH,ITH4,6,Friuli-Venezia Giulia
2021-05-31,TOS,30280,14604,15676,19457,10823,ITI,ITI1,9,Toscana
2021-06-28,CAM,44913,21914,22999,19532,25381,ITF,ITF3,15,Campania
2021-06-27,ABR,8193,4212,3981,4977,3216,ITF,ITF1,13,Abruzzo
2021-03-20,CAM,13986,6526,7460,10247,3739,ITF,ITF3,15,Campania
2021-06-04,EMR,45501,22914,22587,37383,8118,ITH,ITH5,8,Emilia-Romagna
2021-01-22,SIC,1278,636,642,262,1016,ITG,ITG1,19,Sicilia
2021-05-14,TOS,33315,15404,17911,20652,12663,ITI,ITI1,9,Toscana
2021-05-07,VEN,48525,23252,25273,39859,8666,ITH,ITH3,5,Veneto
2021-03-16,LIG,6083,2731,3352,2350,3733,ITC,ITC3,7,Liguria
2021-05-23,UMB,5067,1854,3213,651,4416,ITI,ITI2,10,Umbria
2021-01-27,VEN,7141,2064,5077,241,6900,ITH,ITH3,5,Veneto
2021-02-08,LAZ,9739,4152,5587,4507,5232,ITI,ITI4,12,Lazio
2021-04-25,SAR,4497,2269,2228,3718,779,ITG,ITG2,20,Sardegna
2021-01-08,SIC,8111,3782,4329,8111,0,ITG,ITG1,19,Sicilia
2021-01-20,FVG,748,320,428,13,735,ITH,ITH4,6,Friuli-Venezia Giulia
2021-04-07,ABR,7221,3333,3888,4437,2784,ITF,ITF1,13,Abruzzo
2021-01-15,SAR,1563,573,990,1563,0,ITG,ITG2,20,Sardegna
2021-06-22,PAB,2451,1409,1042,335,2116,ITH,ITH1,4,Provincia Autonoma Bolzano / Bozen
2021-04-18,SIC,19705,9848,9857,15344,4361,ITG,ITG1,19,Sicilia
2021-03-14,PAB,758,336,422,25,733,ITH,ITH1,4,Provincia Autonoma Bolzano / Bozen
2021-02-01,SAR,1524,605,919,225,1299,ITG,ITG2,20,Sardegna
2021-04-14,PAB,3593,1645,1948,3502,91,ITH,ITH1,4,Provincia Autonoma Bolzano / Bozen
2021-01-26,VDA,139,48,91,0,139,ITC,ITC2,2,Valle d'Aosta / Vallée d'Aoste
2021-04-24,BAS,4542,2197,2345,3529,1013,ITF,ITF5,17,Basilicata
2021-05-02,LAZ,32636,14339,18297,23273,9363,ITI,ITI4,12,Lazio
2021-02-10,EMR,4023,1385,2638,2767,1256,ITH,ITH5,8,Emilia-Romagna
2021-01-07,ABR,1605,553,1052,1605,0,ITF,ITF1,13,Abruzzo
2021-05-02,UMB,3780,1866,1914,1326,2454,ITI,ITI2,10,Umbria
2021-04-08,EMR,31213,14333,16880,25910,5303,ITH,ITH5,8,Emilia-Romagna
2021-03-20,SIC,18574,8967,9607,13436,5138,ITG,ITG1,19,Sicilia
2021-02-08,CAM,5113,2449,2664,4310,803,ITF,ITF3,15,Campania
2021-03-20,UMB,2319,845,1474,2294,25,ITI,ITI2,10,Umbria
2021-06-28,SIC,31161,14474,16687,14571,16590,ITG,ITG1,19,Sicilia
2021-02-06,TOS,4527,1550,2977,1294,3233,ITI,ITI1,9,Toscana
2021-02-02,PAB,1745,506,1239,8,1737,ITH,ITH1,4,Provincia Autonoma Bolzano / Bozen
2021-06-23,FVG,11934,5776,6158,2051,9883,ITH,ITH4,6,Friuli-Venezia Giulia
2021-05-16,LAZ,50929,24522,26407,37443,13486,ITI,ITI4,12,Lazio
2021-02-01,LIG,2558,922,1636,90,2468,ITC,ITC3,7,Liguria
2021-05-20,VDA,807,363,444,367,440,ITC,ITC2,2,Valle d'Aosta / Vallée d'Aoste
2021-04-27,FVG,8101,3718,4383,3626,4475,ITH,ITH4,6,Friuli-Venezia Giulia
2021-05-12,LIG,12030,5448,6582,6682,5348,ITC,ITC3,7,Liguria
2021-01-06,PIE,3116,1111,2005,3116,0,ITC,ITC1,1,Piemonte
2021-05-26,LIG,16654,8409,8245,12281,4373,ITC,ITC3,7,Liguria
2021-07-02,VDA,865,383,482,305,560,ITC,ITC2,2,Valle d'Aosta / Vallée d'Aoste
2021-07-01,MAR,14526,7283,7243,4779,9747,ITI,ITI3,11,Marche
2021-03-24,VDA,515,230,285,258,257,ITC,ITC2,2,Valle d'Aosta / Vallée d'Aoste
2021-03-30,LIG,12211,5426,6785,8823,3388,ITC,ITC3,7,Liguria
2021-05-17,MOL,2228,1092,1136,1732,496,ITF,ITF2,14,Molise
2021-06-16,PAT,6207,3343,2864,2044,4163,ITH,ITH2,4,Provincia Autonoma Trento
2021-03-21,MOL,1246,542,704,479,767,ITF,ITF2,14,Molise
2021-05-21,VEN,44745,22014,22731,20997,23748,ITH,ITH3,5,Veneto
2021-01-25,LOM,7014,2368,4646,473,6541,ITC,ITC4,3,Lombardia
2021-05-06,VDA,1063,509,554,679,384,ITC,ITC2,2,Valle d'Aosta / Vallée d'Aoste
2021-05-31,PUG,37673,18121,19552,23580,14093,ITF,ITF4,16,Puglia
2021-06-28,LAZ,58654,28023,30631,27818,30836,ITI,ITI4,12,Lazio
2021-02-01,LOM,16066,5322,10744,309,15757,ITC,ITC4,3,Lombardia
2021-02-12,BAS,775,332,443,744,31,ITF,ITF5,17,Basilicata
2021-03-14,MOL,596,240,356,17,579,ITF,ITF2,14,Molise
2020-12-27,CAL,312,170,142,312,0,ITF,ITF6,18,Calabria
2021-03-18,EMR,13675,5806,7869,5675,8000,ITH,ITH5,8,Emilia-Romagna
2021-06-22,MOL,2959,1368,1591,685,2274,ITF,ITF2,14,Molise
2021-06-23,PIE,39591,19638,19953,16795,22796,ITC,ITC1,1,Piemonte
2021-05-14,EMR,37242,17164,20078,27644,9598,ITH,ITH5,8,Emilia-Romagna
2021-02-03,EMR,9338,2989,6349,965,8373,ITH,ITH5,8,Emilia-Romagna
2021-04-10,BAS,1033,378,655,950,83,ITF,ITF5,17,Basilicata
2021-04-01,EMR,23947,10770,13177,19401,4546,ITH,ITH5,8,Emilia-Romagna
2021-03-13,UMB,1735,524,1211,1486,249,ITI,ITI2,10,Umbria
2021-06-21,SIC,39627,18361,21266,18218,21409,ITG,ITG1,19,Sicilia
2021-01-15,UMB,695,213,482,695,0,ITI,ITI2,10,Umbria
2021-02-01,CAM,3984,1813,2171,110,3874,ITF,ITF3,15,Campania
2021-02-26,ABR,3924,1680,2244,2955,969,ITF,ITF1,13,Abruzzo
2021-02-17,EMR,6538,2764,3774,5766,772,ITH,ITH5,8,Emilia-Romagna
2021-04-06,CAL,8068,3658,4410,4438,3630,ITF,ITF6,18,Calabria
2021-01-29,UMB,1230,348,882,79,1151,ITI,ITI2,10,Umbria
2021-03-30,CAM,22050,10575,11475,19092,2958,ITF,ITF3,15,Campania
2021-05-09,SIC,28076,13136,14940,19807,8269,ITG,ITG1,19,Sicilia
2021-02-08,CAL,1856,737,1119,663,1193,ITF,ITF6,18,Calabria
2021-05-09,UMB,5753,2752,3001,5362,391,ITI,ITI2,10,Umbria
2021-02-16,VDA,326,53,273,320,6,ITC,ITC2,2,Valle d'Aosta / Vallée d'Aoste
2021-05-04,FVG,9535,4297,5238,6181,3354,ITH,ITH4,6,Friuli-Venezia Giulia
2021-06-01,EMR,27138,13087,14051,17246,9892,ITH,ITH5,8,Emilia-Romagna
2021-02-15,MAR,967,412,555,954,13,ITI,ITI3,11,Marche
2021-03-15,PAT,1411,545,866,947,464,ITH,ITH2,4,Provincia Autonoma Trento
2021-06-24,BAS,4122,1950,2172,2219,1903,ITF,ITF5,17,Basilicata
2021-01-24,FVG,305,119,186,1,304,ITH,ITH4,6,Friuli-Venezia Giulia
2021-06-11,TOS,29681,15439,14242,25059,4622,ITI,ITI1,9,Toscana
2021-06-30,FVG,12718,6486,6232,1451,11267,ITH,ITH4,6,Friuli-Venezia Giulia
2021-01-17,PAT,251,195,56,251,0,ITH,ITH2,4,Provincia Autonoma Trento
2021-04-28,BAS,4704,2158,2546,4263,441,ITF,ITF5,17,Basilicata
2021-05-26,MAR,11846,5933,5913,8663,3183,ITI,ITI3,11,Marche
2021-06-23,PAT,6510,3450,3060,4640,1870,ITH,ITH2,4,Provincia Autonoma Trento
2021-02-12,LAZ,6848,2849,3999,6432,416,ITI,ITI4,12,Lazio
2021-04-15,TOS,24401,10195,14206,15831,8570,ITI,ITI1,9,Toscana
2021-02-17,TOS,8176,3170,5006,7424,752,ITI,ITI1,9,Toscana
2021-03-08,FVG,4120,1642,2478,2034,2086,ITH,ITH4,6,Friuli-Venezia Giulia
2021-04-25,PUG,11309,5237,6072,10151,1158,ITF,ITF4,16,Puglia
2021-05-11,PAT,3700,1750,1950,2850,850,ITH,ITH2,4,Provincia Autonoma Trento
2021-02-27,PUG,14222,4818,9404,12997,1225,ITF,ITF4,16,Puglia
2021-04-06,LIG,13246,5902,7344,10985,2261,ITC,ITC3,7,Liguria
2021-04-24,CAL,19258,9585,9673,15809,3449,ITF,ITF6,18,Calabria
2021-04-17,CAM,36182,17510,18672,24670,11512,ITF,ITF3,15,Campania
2021-01-01,PUG,148,61,87,148,0,ITF,ITF4,16,Puglia
2021-02-08,LIG,1977,741,1236,306,1671,ITC,ITC3,7,Liguria
2021-02-26,CAL,3079,1641,1438,2626,453,ITF,ITF6,18,Calabria
2021-05-31,PAB,2987,1464,1523,2120,867,ITH,ITH1,4,Provincia Autonoma Bolzano / Bozen
2021-06-07,PUG,44065,21518,22547,30867,13198,ITF,ITF4,16,Puglia
2021-02-17,VEN,6022,2772,3250,5928,94,ITH,ITH3,5,Veneto
2021-03-28,MOL,1626,747,879,524,1102,ITF,ITF2,14,Molise
2021-06-13,CAM,41845,20397,21448,37118,4727,ITF,ITF3,15,Campania
2021-03-22,FVG,3658,1445,2213,1704,1954,ITH,ITH4,6,Friuli-Venezia Giulia
2021-04-11,PUG,16463,7252,9211,14805,1658,ITF,ITF4,16,Puglia
2021-01-30,MOL,461,158,303,12,449,ITF,ITF2,14,Molise
2021-03-02,BAS,797,384,413,661,136,ITF,ITF5,17,Basilicata
2021-03-30,MAR,7470,3073,4397,4647,2823,ITI,ITI3,11,Marche
2021-04-27,PAT,3913,1881,2032,3844,69,ITH,ITH2,4,Provincia Autonoma Trento
2020-12-27,LIG,135,56,79,135,0,ITC,ITC3,7,Liguria
2021-02-05,SAR,1897,749,1148,433,1464,ITG,ITG2,20,Sardegna
2021-06-20,CAL,6499,3076,3423,3689,2810,ITF,ITF6,18,Calabria
2021-02-01,MAR,1362,479,883,98,1264,ITI,ITI3,11,Marche
2021-04-01,VEN,25320,11153,14167,18910,6410,ITH,ITH3,5,Veneto
2021-06-10,BAS,4340,2099,2241,3899,441,ITF,ITF5,17,Basilicata
2021-02-05,SIC,6739,2979,3760,2127,4612,ITG,ITG1,19,Sicilia
2021-05-09,SAR,6129,2874,3255,5203,926,ITG,ITG2,20,Sardegna
2021-01-04,PAB,508,201,307,508,0,ITH,ITH1,4,Provincia Autonoma Bolzano / Bozen
2021-01-11,PUG,3754,1588,2166,3754,0,ITF,ITF4,16,Puglia
2021-02-12,VDA,263,96,167,217,46,ITC,ITC2,2,Valle d'Aosta / Vallée d'Aoste
2021-06-02,PAT,2838,1359,1479,944,1894,ITH,ITH2,4,Provincia Autonoma Trento
2021-06-14,LOM,94257,47895,46362,49745,44512,ITC,ITC4,3,Lombardia
2021-03-26,MAR,6334,2607,3727,3525,2809,ITI,ITI3,11,Marche
2021-04-13,PIE,25952,11619,14333,22493,3459,ITC,ITC1,1,Piemonte
2021-04-21,PUG,23093,10663,12430,19360,3733,ITF,ITF4,16,Puglia
2021-05-26,SAR,15544,8193,7351,9896,5648,ITG,ITG2,20,Sardegna
2021-02-13,VEN,3266,1473,1793,3246,20,ITH,ITH3,5,Veneto
2021-01-20,PIE,6617,2089,4528,5899,718,ITC,ITC1,1,Piemonte
2021-02-15,SAR,958,349,609,927,31,ITG,ITG2,20,Sardegna
2021-01-22,LAZ,4006,1636,2370,491,3515,ITI,ITI4,12,Lazio
2021-03-11,PAT,2299,852,1447,1474,825,ITH,ITH2,4,Provincia Autonoma Trento
2021-01-20,EMR,1325,270,1055,1324,1,ITH,ITH5,8,Emilia-Romagna
2021-05-24,PUG,36066,17015,19051,25079,10987,ITF,ITF4,16,Puglia
2021-06-17,MAR,14946,7436,7510,8852,6094,ITI,ITI3,11,Marche
2021-02-15,CAM,5471,2516,2955,5297,174,ITF,ITF3,15,Campania
2021-01-12,VDA,302,72,230,302,0,ITC,ITC2,2,Valle d'Aosta / Vallée d'Aoste
2021-02-16,PUG,3382,1454,1928,2736,646,ITF,ITF4,16,Puglia
2021-05-08,ABR,10291,4870,5421,6459,3832,ITF,ITF1,13,Abruzzo
2021-01-10,CAL,934,527,407,934,0,ITF,ITF6,18,Calabria
2021-01-30,PUG,5531,2514,3017,410,5121,ITF,ITF4,16,Puglia
2021-02-03,PIE,10202,3304,6898,611,9591,ITC,ITC1,1,Piemonte
2021-02-27,LAZ,11449,4285,7164,10471,978,ITI,ITI4,12,Lazio
2021-05-26,LOM,93643,44639,49004,43611,50032,ITC,ITC4,3,Lombardia
2021-06-09,CAM,52429,25744,26685,41527,10902,ITF,ITF3,15,Campania
2021-02-15,LOM,8949,3137,5812,8532,417,ITC,ITC4,3,Lombardia
2021-03-09,MAR,5431,2293,3138,4550,881,ITI,ITI3,11,Marche
2021-04-20,CAL,7845,3956,3889,6120,1725,ITF,ITF6,18,Calabria
2021-05-10,PUG,37705,16658,21047,19763,17942,ITF,ITF4,16,Puglia
2021-02-28,MOL,832,334,498,790,42,ITF,ITF2,14,Molise
2021-03-01,CAM,12129,4247,7882,8017,4112,ITF,ITF3,15,Campania
2021-01-01,TOS,2369,787,1582,2369,0,ITI,ITI1,9,Toscana
2021-02-22,FVG,2485,1193,1292,2067,418,ITH,ITH4,6,Friuli-Venezia Giulia
2021-04-24,ABR,8726,3976,4750,7196,1530,ITF,ITF1,13,Abruzzo
2021-04-11,TOS,3645,1680,1965,3490,155,ITI,ITI1,9,Toscana
2021-03-30,SIC,14539,6755,7784,9776,4763,ITG,ITG1,19,Sicilia
2021-05-09,CAM,43200,20285,22915,32105,11095,ITF,ITF3,15,Campania
2021-01-11,LIG,2653,990,1663,2653,0,ITC,ITC3,7,Liguria
2021-04-15,EMR,29343,13979,15364,19668,9675,ITH,ITH5,8,Emilia-Romagna
2021-06-02,FVG,9406,4951,4455,9126,280,ITH,ITH4,6,Friuli-Venezia Giulia
2021-01-14,ABR,530,189,341,530,0,ITF,ITF1,13,Abruzzo
2021-03-13,SIC,12209,5387,6822,7717,4492,ITG,ITG1,19,Sicilia
2021-07-03,TOS,29168,14675,14493,12222,16946,ITI,ITI1,9,Toscana
2021-02-27,MOL,1366,568,798,1347,19,ITF,ITF2,14,Molise
2021-03-19,BAS,2296,995,1301,266,2030,ITF,ITF5,17,Basilicata
2021-03-06,TOS,7110,2852,4258,2914,4196,ITI,ITI1,9,Toscana
2021-03-17,UMB,3328,1313,2015,1856,1472,ITI,ITI2,10,Umbria
2021-05-24,VDA,1136,516,620,689,447,ITC,ITC2,2,Valle d'Aosta / Vallée d'Aoste
2021-06-07,MOL,1952,858,1094,1133,819,ITF,ITF2,14,Molise
2021-06-18,EMR,42097,21056,21041,16329,25768,ITH,ITH5,8,Emilia-Romagna
2021-03-10,EMR,18797,7741,11056,13152,5645,ITH,ITH5,8,Emilia-Romagna
2021-05-10,VDA,782,381,401,547,235,ITC,ITC2,2,Valle d'Aosta / Vallée d'Aoste
2021-05-20,LAZ,51510,24760,26750,37783,13727,ITI,ITI4,12,Lazio
2021-02-13,MOL,132,80,52,132,0,ITF,ITF2,14,Molise
2021-04-13,MAR,9837,4259,5578,9604,233,ITI,ITI3,11,Marche
2021-01-07,UMB,1300,387,913,1300,0,ITI,ITI2,10,Umbria
2021-01-10,CAM,8165,3736,4429,8165,0,ITF,ITF3,15,Campania
2021-02-07,FVG,1563,482,1081,385,1178,ITH,ITH4,6,Friuli-Venezia Giulia
2021-04-17,SIC,26017,13149,12868,18951,7066,ITG,ITG1,19,Sicilia
2021-01-03,PAT,493,160,333,493,0,ITH,ITH2,4,Provincia Autonoma Trento
2021-05-24,MOL,1964,853,1111,1298,666,ITF,ITF2,14,Molise
2021-03-20,SAR,5197,2076,3121,2919,2278,ITG,ITG2,20,Sardegna
2021-02-16,BAS,907,377,530,809,98,ITF,ITF5,17,Basilicata
2021-05-07,MOL,2643,1228,1415,2046,597,ITF,ITF2,14,Molise
2021-02-06,PAB,2626,1171,1455,19,2607,ITH,ITH1,4,Provincia Autonoma Bolzano / Bozen
2021-02-13,PUG,3727,1456,2271,3031,696,ITF,ITF4,16,Puglia
2021-05-18,FVG,10786,5395,5391,8710,2076,ITH,ITH4,6,Friuli-Venezia Giulia
2021-01-10,LIG,648,262,386,648,0,ITC,ITC3,7,Liguria
2021-02-12,CAL,1710,668,1042,947,763,ITF,ITF6,18,Calabria
2021-03-03,VEN,12096,4646,7450,8597,3499,ITH,ITH3,5,Veneto
2021-03-17,SIC,14983,7398,7585,9196,5787,ITG,ITG1,19,Sicilia
2021-03-20,LOM,32585,12161,20424,22735,9850,ITC,ITC4,3,Lombardia
2021-04-20,LIG,14226,6513,7713,9877,4349,ITC,ITC3,7,Liguria
2021-06-20,LAZ,49225,22419,26806,24333,24892,ITI,ITI4,12,Lazio
2021-04-03,CAM,21115,10315,10800,18734,2381,ITF,ITF3,15,Campania
2021-06-21,PAB,3137,1596,1541,270,2867,ITH,ITH1,4,Provincia Autonoma Bolzano / Bozen
2021-06-25,SIC,39190,18380,20810,17162,22028,ITG,ITG1,19,Sicilia
2021-06-01,FVG,10090,5106,4984,7969,2121,ITH,ITH4,6,Friuli-Venezia Giulia
2021-06-11,VEN,46925,24406,22519,35779,11146,ITH,ITH3,5,Veneto
2021-05-18,PIE,32115,14821,17294,19453,12662,ITC,ITC1,1,Piemonte
2021-06-06,LAZ,57914,27914,30000,35416,22498,ITI,ITI4,12,Lazio
2021-06-13,SAR,9495,4671,4824,6235,3260,ITG,ITG2,20,Sardegna
2020-12-27,LOM,718,414,304,718,0,ITC,ITC4,3,Lombardia
2021-05-18,EMR,29094,13246,15848,18571,10523,ITH,ITH5,8,Emilia-Romagna
2021-06-16,MAR,13521,6793,6728,9156,4365,ITI,ITI3,11,Marche
2021-02-16,ABR,1917,842,1075,1905,12,ITF,ITF1,13,Abruzzo
2021-02-03,TOS,4221,1452,2769,241,3980,ITI,ITI1,9,Toscana
2021-02-07,EMR,4785,1536,3249,1724,3061,ITH,ITH5,8,Emilia-Romagna
2021-03-02,ABR,3965,1675,2290,3281,684,ITF,ITF1,13,Abruzzo
2021-06-25,VEN,50866,25753,25113,15189,35677,ITH,ITH3,5,Veneto
2021-06-25,UMB,10076,5218,4858,5373,4703,ITI,ITI2,10,Umbria
2021-02-26,LAZ,13119,5728,7391,11724,1395,ITI,ITI4,12,Lazio
2021-02-24,EMR,9351,3566,5785,8467,884,ITH,ITH5,8,Emilia-Romagna
2021-04-21,VDA,868,410,458,620,248,ITC,ITC2,2,Valle d'Aosta / Vallée d'Aoste
2021-04-17,SAR,10088,4504,5584,5490,4598,ITG,ITG2,20,Sardegna
2021-02-18,MOL,319,74,245,306,13,ITF,ITF2,14,Molise
2021-03-31,BAS,3094,1258,1836,2312,782,ITF,ITF5,17,Basilicata
2021-05-13,SIC,47268,22161,25107,30731,16537,ITG,ITG1,19,Sicilia
2021-02-12,FVG,1193,428,765,1146,47,ITH,ITH4,6,Friuli-Venezia Giulia
2021-03-22,EMR,17650,7815,9835,10786,6864,ITH,ITH5,8,Emilia-Romagna
2021-06-17,VDA,775,422,353,626,149,ITC,ITC2,2,Valle d'Aosta / Vallée d'Aoste
2021-04-01,TOS,27022,11209,15813,16393,10629,ITI,ITI1,9,Toscana
2021-05-26,PAB,4939,2492,2447,2965,1974,ITH,ITH1,4,Provincia Autonoma Bolzano / Bozen
2021-02-22,LOM,11896,4808,7088,11591,305,ITC,ITC4,3,Lombardia
2021-04-24,LAZ,33420,15076,18344,20646,12774,ITI,ITI4,12,Lazio
2021-04-29,CAM,41327,20036,21291,24846,16481,ITF,ITF3,15,Campania
2021-06-11,PAT,7193,3423,3770,1574,5619,ITH,ITH2,4,Provincia Autonoma Trento
2021-06-22,BAS,4362,2069,2293,2260,2102,ITF,ITF5,17,Basilicata
2021-03-15,TOS,8698,3645,5053,4255,4443,ITI,ITI1,9,Toscana
2021-01-19,CAM,1095,474,621,1092,3,ITF,ITF3,15,Campania
2021-06-05,BAS,4796,2206,2590,3853,943,ITF,ITF5,17,Basilicata
2021-06-23,TOS,31438,15218,16220,20118,11320,ITI,ITI1,9,Toscana
2021-01-31,SIC,4032,1927,2105,112,3920,ITG,ITG1,19,Sicilia
2021-03-08,VEN,13630,6271,7359,9561,4069,ITH,ITH3,5,Veneto
2021-03-09,MOL,1329,579,750,1177,152,ITF,ITF2,14,Molise
2021-03-03,EMR,15856,5253,10603,13371,2485,ITH,ITH5,8,Emilia-Romagna
2021-05-11,SIC,32290,15355,16935,19814,12476,ITG,ITG1,19,Sicilia
2021-06-13,PAT,3686,2033,1653,295,3391,ITH,ITH2,4,Provincia Autonoma Trento
2021-02-20,MOL,1018,441,577,998,20,ITF,ITF2,14,Molise
2021-02-17,SIC,5215,3203,2012,4547,668,ITG,ITG1,19,Sicilia
2021-05-17,ABR,11034,5037,5997,6180,4854,ITF,ITF1,13,Abruzzo
2021-05-30,LAZ,41179,17621,23558,33826,7353,ITI,ITI4,12,Lazio
2021-05-13,LAZ,50117,22517,27600,32335,17782,ITI,ITI4,12,Lazio
2021-05-31,MOL,2356,1144,1212,1938,418,ITF,ITF2,14,Molise
2021-05-06,PIE,33483,15796,17687,19928,13555,ITC,ITC1,1,Piemonte
2021-02-23,BAS,1901,771,1130,1763,138,ITF,ITF5,17,Basilicata
2021-05-23,PIE,28710,13136,15574,15759,12951,ITC,ITC1,1,Piemonte
2021-05-14,MOL,2644,1215,1429,1926,718,ITF,ITF2,14,Molise
2020-12-27,PAT,103,40,63,103,0,ITH,ITH2,4,Provincia Autonoma Trento
2021-02-12,PIE,6891,2215,4676,3930,2961,ITC,ITC1,1,Piemonte
2021-06-03,BAS,4918,2255,2663,3737,1181,ITF,ITF5,17,Basilicata
2021-05-25,FVG,12899,6377,6522,9587,3312,ITH,ITH4,6,Friuli-Venezia Giulia
2021-03-12,BAS,1907,981,926,806,1101,ITF,ITF5,17,Basilicata
2021-04-24,SIC,31137,14697,16440,23505,7632,ITG,ITG1,19,Sicilia
2021-03-01,PIE,12043,4846,7197,11234,809,ITC,ITC1,1,Piemonte
2021-06-14,PAB,2904,1576,1328,547,2357,ITH,ITH1,4,Provincia Autonoma Bolzano / Bozen
2021-03-13,LOM,27174,9769,17405,21081,6093,ITC,ITC4,3,Lombardia
2021-01-03,SAR,90,36,54,90,0,ITG,ITG2,20,Sardegna
2021-01-10,TOS,3001,1104,1897,3001,0,ITI,ITI1,9,Toscana
2021-06-18,VEN,52854,26375,26479,24422,28432,ITH,ITH3,5,Veneto
2021-02-05,CAL,3808,1717,2091,488,3320,ITF,ITF6,18,Calabria
2021-06-02,MOL,2805,1355,1450,2706,99,ITF,ITF2,14,Molise
2021-04-20,TOS,18160,8110,10050,12585,5575,ITI,ITI1,9,Toscana
2021-06-11,FVG,10598,5772,4826,9769,829,ITH,ITH4,6,Friuli-Venezia Giulia
2021-05-17,BAS,5540,2732,2808,3408,2132,ITF,ITF5,17,Basilicata
2021-03-03,FVG,3645,1633,2012,2371,1274,ITH,ITH4,6,Friuli-Venezia Giulia
2021-03-11,PUG,14807,6569,8238,11635,3172,ITF,ITF4,16,Puglia
2021-04-03,TOS,15014,6647,8367,13888,1126,ITI,ITI1,9,Toscana
2021-04-27,LIG,14778,6682,8096,7193,7585,ITC,ITC3,7,Liguria
2021-02-23,ABR,2781,1274,1507,2770,11,ITF,ITF1,13,Abruzzo
2021-03-18,MAR,3395,1477,1918,162,3233,ITI,ITI3,11,Marche
2021-04-29,CAL,12448,6047,6401,8701,3747,ITF,ITF6,18,Calabria
2021-01-21,VDA,33,12,21,33,0,ITC,ITC2,2,Valle d'Aosta / Vallée d'Aoste
2021-02-03,LIG,2315,790,1525,54,2261,ITC,ITC3,7,Liguria
2021-06-02,PUG,26951,13182,13769,22138,4813,ITF,ITF4,16,Puglia
2021-06-26,MAR,13414,6810,6604,5744,7670,ITI,ITI3,11,Marche
2021-02-06,ABR,1610,743,867,602,1008,ITF,ITF1,13,Abruzzo
2021-04-12,CAL,7036,3420,3616,5394,1642,ITF,ITF6,18,Calabria
2021-06-01,UMB,4380,2089,2291,4225,155,ITI,ITI2,10,Umbria
2021-01-04,VDA,142,59,83,142,0,ITC,ITC2,2,Valle d'Aosta / Vallée d'Aoste
2021-05-25,EMR,25063,11191,13872,11715,13348,ITH,ITH5,8,Emilia-Romagna
2021-05-25,PIE,31149,14454,16695,16007,15142,ITC,ITC1,1,Piemonte
2021-01-19,CAL,1116,491,625,1105,11,ITF,ITF6,18,Calabria
2021-03-10,UMB,4031,1943,2088,2775,1256,ITI,ITI2,10,Umbria
2021-06-11,PIE,43480,23007,20473,40660,2820,ITC,ITC1,1,Piemonte
2021-01-27,TOS,4835,1573,3262,206,4629,ITI,ITI1,9,Toscana
2021-02-14,EMR,1403,378,1025,1283,120,ITH,ITH5,8,Emilia-Romagna
2021-03-27,VEN,32069,14011,18058,26270,5799,ITH,ITH3,5,Veneto
2021-05-23,MAR,9208,4282,4926,7537,1671,ITI,ITI3,11,Marche
2021-07-04,CAL,3016,1437,1579,907,2109,ITF,ITF6,18,Calabria
2021-01-21,CAM,2092,1115,977,676,1416,ITF,ITF3,15,Campania
2021-03-28,VDA,522,212,310,521,1,ITC,ITC2,2,Valle d'Aosta / Vallée d'Aoste
2021-01-16,UMB,217,71,146,217,0,ITI,ITI2,10,Umbria
2021-03-13,PUG,10468,4134,6334,8660,1808,ITF,ITF4,16,Puglia
2021-06-03,VEN,54295,27926,26369,42345,11950,ITH,ITH3,5,Veneto
2021-05-06,MAR,12655,5822,6833,5584,7071,ITI,ITI3,11,Marche
2021-06-17,CAL,15440,7039,8401,9320,6120,ITF,ITF6,18,Calabria
2021-02-15,PAB,72,42,30,26,46,ITH,ITH1,4,Provincia Autonoma Bolzano / Bozen
2021-03-11,VDA,197,76,121,66,131,ITC,ITC2,2,Valle d'Aosta / Vallée d'Aoste
2021-04-29,LIG,15577,6978,8599,6738,8839,ITC,ITC3,7,Liguria
2021-05-01,LOM,95975,43672,52303,66765,29210,ITC,ITC4,3,Lombardia
2021-05-27,FVG,12815,6133,6682,7587,5228,ITH,ITH4,6,Friuli-Venezia Giulia
2021-06-29,LAZ,59210,28154,31056,28188,31022,ITI,ITI4,12,Lazio
2021-01-21,LOM,5464,1597,3867,4774,690,ITC,ITC4,3,Lombardia
2021-02-12,MAR,1582,618,964,1430,152,ITI,ITI3,11,Marche
2021-03-26,CAL,8079,3835,4244,4960,3119,ITF,ITF6,18,Calabria
2021-02-02,UMB,942,272,670,32,910,ITI,ITI2,10,Umbria
2021-02-24,PUG,10039,4705,5334,9448,591,ITF,ITF4,16,Puglia
2021-04-12,LIG,12385,5475,6910,10366,2019,ITC,ITC3,7,Liguria
2021-02-08,ABR,1194,395,799,486,708,ITF,ITF1,13,Abruzzo
2021-06-02,VDA,1215,688,527,814,401,ITC,ITC2,2,Valle d'Aosta / Vallée d'Aoste
2021-06-04,PUG,52415,25363,27052,34763,17652,ITF,ITF4,16,Puglia
2021-01-19,LIG,1371,438,933,1281,90,ITC,ITC3,7,Liguria
2021-03-17,TOS,11421,4587,6834,6892,4529,ITI,ITI1,9,Toscana
2021-05-11,PAB,2844,1335,1509,1321,1523,ITH,ITH1,4,Provincia Autonoma Bolzano / Bozen
2021-05-18,PUG,28864,13428,15436,16089,12775,ITF,ITF4,16,Puglia
2021-05-19,ABR,10691,5108,5583,7653,3038,ITF,ITF1,13,Abruzzo
2021-06-19,VDA,1288,667,621,669,619,ITC,ITC2,2,Valle d'Aosta / Vallée d'Aoste
2021-02-07,LOM,7312,2825,4487,338,6974,ITC,ITC4,3,Lombardia
2021-04-14,CAM,27649,13338,14311,19079,8570,ITF,ITF3,15,Campania
2021-06-25,TOS,33534,16757,16777,12368,21166,ITI,ITI1,9,Toscana
2021-06-20,VEN,40434,19673,20761,18930,21504,ITH,ITH3,5,Veneto
2021-06-22,SAR,19329,8985,10344,7269,12060,ITG,ITG2,20,Sardegna
2021-02-05,LIG,2681,987,1694,305,2376,ITC,ITC3,7,Liguria
2021-05-01,CAM,46337,22659,23678,30233,16104,ITF,ITF3,15,Campania
2021-06-08,TOS,32520,16659,15861,32078,442,ITI,ITI1,9,Toscana
2021-02-26,TOS,10080,3834,6246,8874,1206,ITI,ITI1,9,Toscana
2021-05-27,EMR,42227,18737,23490,14054,28173,ITH,ITH5,8,Emilia-Romagna
2021-02-10,MAR,1439,452,987,1080,359,ITI,ITI3,11,Marche
2021-01-14,LAZ,5488,2145,3343,5488,0,ITI,ITI4,12,Lazio
2021-02-16,EMR,5772,2446,3326,5241,531,ITH,ITH5,8,Emilia-Romagna
2021-04-26,SIC,21684,10262,11422,13604,8080,ITG,ITG1,19,Sicilia
2021-06-06,TOS,28294,13647,14647,22934,5360,ITI,ITI1,9,Toscana
2021-03-31,SAR,10274,4164,6110,7826,2448,ITG,ITG2,20,Sardegna
2021-01-19,LOM,8053,2329,5724,7585,468,ITC,ITC4,3,Lombardia
2021-02-02,SIC,5271,2472,2799,627,4644,ITG,ITG1,19,Sicilia
2021-02-08,BAS,558,193,365,151,407,ITF,ITF5,17,Basilicata
2021-01-29,PAB,1497,510,987,24,1473,ITH,ITH1,4,Provincia Autonoma Bolzano / Bozen
2021-04-07,LAZ,25848,12043,13805,18535,7313,ITI,ITI4,12,Lazio
2021-04-12,CAM,23306,10920,12386,20271,3035,ITF,ITF3,15,Campania
2021-05-25,PAT,4770,2269,2501,1868,2902,ITH,ITH2,4,Provincia Autonoma Trento
2021-05-08,PAT,3162,1726,1436,2740,422,ITH,ITH2,4,Provincia Autonoma Trento
2021-05-19,BAS,2870,1498,1372,1194,1676,ITF,ITF5,17,Basilicata
2021-01-02,CAM,3672,1962,1710,3672,0,ITF,ITF3,15,Campania
2021-03-09,VDA,206,96,110,174,32,ITC,ITC2,2,Valle d'Aosta / Vallée d'Aoste
2021-04-22,PAB,2924,1501,1423,1982,942,ITH,ITH1,4,Provincia Autonoma Bolzano / Bozen
2021-04-26,UMB,5380,2332,3048,3129,2251,ITI,ITI2,10,Umbria
2021-02-25,BAS,1788,737,1051,1742,46,ITF,ITF5,17,Basilicata
2021-02-20,VDA,251,210,41,241,10,ITC,ITC2,2,Valle d'Aosta / Vallée d'Aoste
2020-12-28,LAZ,959,412,547,959,0,ITI,ITI4,12,Lazio
2021-02-14,PAT,246,186,60,11,235,ITH,ITH2,4,Provincia Autonoma Trento
2021-04-09,UMB,6731,3125,3606,6522,209,ITI,ITI2,10,Umbria
2021-05-09,PAB,4241,2410,1831,3089,1152,ITH,ITH1,4,Provincia Autonoma Bolzano / Bozen
2021-04-29,PUG,26159,12102,14057,19497,6662,ITF,ITF4,16,Puglia
2021-04-30,ABR,12406,5816,6590,6685,5721,ITF,ITF1,13,Abruzzo
2021-01-16,LAZ,5645,2281,3364,5645,0,ITI,ITI4,12,Lazio
2021-06-17,CAM,57542,27564,29978,30791,26751,ITF,ITF3,15,Campania
2021-04-19,PIE,22560,10773,11787,18196,4364,ITC,ITC1,1,Piemonte
2021-01-14,SIC,5251,2483,2768,5251,0,ITG,ITG1,19,Sicilia
2021-04-13,ABR,5855,2739,3116,4655,1200,ITF,ITF1,13,Abruzzo
2021-04-26,LAZ,29235,13458,15777,20031,9204,ITI,ITI4,12,Lazio
2021-01-09,PIE,6184,2185,3999,6184,0,ITC,ITC1,1,Piemonte
2021-02-02,LAZ,5911,2213,3698,639,5272,ITI,ITI4,12,Lazio
2021-07-04,CAM,22962,11135,11827,1977,20985,ITF,ITF3,15,Campania
2021-01-20,ABR,447,156,291,445,2,ITF,ITF1,13,Abruzzo
2021-02-19,VEN,7322,3140,4182,7118,204,ITH,ITH3,5,Veneto
2021-03-26,CAM,19861,9321,10540,16046,3815,ITF,ITF3,15,Campania
2021-02-03,MOL,731,249,482,338,393,ITF,ITF2,14,Molise
2021-01-28,FVG,2239,794,1445,354,1885,ITH,ITH4,6,Friuli-Venezia Giulia
2021-01-26,PIE,6333,1880,4453,735,5598,ITC,ITC1,1,Piemonte
2021-06-11,MAR,13755,7034,6721,11434,2321,ITI,ITI3,11,Marche
2021-02-06,BAS,905,369,536,146,759,ITF,ITF5,17,Basilicata
2021-04-27,MOL,1594,768,826,465,1129,ITF,ITF2,14,Molise
2021-05-27,PAT,4293,1991,2302,1252,3041,ITH,ITH2,4,Provincia Autonoma Trento
2021-03-24,LIG,9178,4031,5147,5891,3287,ITC,ITC3,7,Liguria
2021-05-10,EMR,33840,16124,17716,26595,7245,ITH,ITH5,8,Emilia-Romagna
2021-05-08,FVG,10270,4643,5627,5488,4782,ITH,ITH4,6,Friuli-Venezia Giulia
2021-07-02,LIG,12709,6233,6476,6332,6377,ITC,ITC3,7,Liguria
2020-12-31,LIG,990,353,637,990,0,ITC,ITC3,7,Liguria
2021-04-30,BAS,5284,2373,2911,4122,1162,ITF,ITF5,17,Basilicata
2021-02-21,VEN,4638,1211,3427,4633,5,ITH,ITH3,5,Veneto
2021-04-28,UMB,5378,2326,3052,2983,2395,ITI,ITI2,10,Umbria
2021-03-06,PAB,3973,2081,1892,3762,211,ITH,ITH1,4,Provincia Autonoma Bolzano / Bozen
2021-04-10,LIG,7884,3558,4326,6970,914,ITC,ITC3,7,Liguria
2021-02-04,UMB,733,226,507,25,708,ITI,ITI2,10,Umbria
2021-05-15,VEN,36198,17491,18707,26209,9989,ITH,ITH3,5,Veneto
2021-01-17,LIG,866,301,565,866,0,ITC,ITC3,7,Liguria
2021-02-14,FVG,1,0,1,0,1,ITH,ITH4,6,Friuli-Venezia Giulia
2021-05-02,ABR,10458,5110,5348,5230,5228,ITF,ITF1,13,Abruzzo
2021-05-25,MAR,11649,5747,5902,8717,2932,ITI,ITI3,11,Marche
2021-05-28,PAB,5683,2896,2787,3793,1890,ITH,ITH1,4,Provincia Autonoma Bolzano / Bozen
2021-01-20,BAS,84,22,62,84,0,ITF,ITF5,17,Basilicata
2021-05-15,UMB,4988,1881,3107,1825,3163,ITI,ITI2,10,Umbria
2021-05-16,MOL,1247,571,676,1065,182,ITF,ITF2,14,Molise
2021-02-17,PAB,156,51,105,139,17,ITH,ITH1,4,Provincia Autonoma Bolzano / Bozen
2021-04-21,EMR,23957,10962,12995,14211,9746,ITH,ITH5,8,Emilia-Romagna
2021-06-01,VEN,26920,13542,13378,16405,10515,ITH,ITH3,5,Veneto
2021-02-22,PUG,9629,4536,5093,9297,332,ITF,ITF4,16,Puglia
2021-05-08,PIE,34294,16273,18021,18653,15641,ITC,ITC1,1,Piemonte
2021-06-03,SAR,16391,7641,8750,10704,5687,ITG,ITG2,20,Sardegna
2021-01-02,CAL,166,94,72,166,0,ITF,ITF6,18,Calabria
2021-01-28,PIE,5591,1809,3782,384,5207,ITC,ITC1,1,Piemonte
2021-05-08,EMR,32343,15094,17249,20921,11422,ITH,ITH5,8,Emilia-Romagna
2021-05-20,LOM,94412,45624,48788,31860,62552,ITC,ITC4,3,Lombardia
2021-03-01,MAR,3756,1508,2248,3508,248,ITI,ITI3,11,Marche
2021-05-10,FVG,7940,3529,4411,6398,1542,ITH,ITH4,6,Friuli-Venezia Giulia
2021-06-20,SAR,6276,2795,3481,3656,2620,ITG,ITG2,20,Sardegna
2021-01-28,EMR,10255,3339,6916,348,9907,ITH,ITH5,8,Emilia-Romagna
2021-04-18,FVG,6038,2800,3238,5631,407,ITH,ITH4,6,Friuli-Venezia Giulia
2021-04-19,ABR,6226,2858,3368,3854,2372,ITF,ITF1,13,Abruzzo
2021-01-08,FVG,2321,746,1575,2321,0,ITH,ITH4,6,Friuli-Venezia Giulia
2021-02-21,ABR,1218,550,668,1217,1,ITF,ITF1,13,Abruzzo
2021-05-26,TOS,35582,17100,18482,20384,15198,ITI,ITI1,9,Toscana
2021-06-14,FVG,10031,4841,5190,5230,4801,ITH,ITH4,6,Friuli-Venezia Giulia
2021-05-11,UMB,6223,2828,3395,4029,2194,ITI,ITI2,10,Umbria
2021-05-14,CAM,61035,27581,33454,36332,24703,ITF,ITF3,15,Campania
2021-03-30,TOS,17019,7643,9376,13456,3563,ITI,ITI1,9,Toscana
2021-05-21,CAL,21327,10859,10468,13972,7355,ITF,ITF6,18,Calabria
2021-02-20,FVG,2068,933,1135,1924,144,ITH,ITH4,6,Friuli-Venezia Giulia
2021-03-18,SIC,15287,7666,7621,9788,5499,ITG,ITG1,19,Sicilia
2021-06-15,ABR,11105,5475,5630,8686,2419,ITF,ITF1,13,Abruzzo
2021-01-22,FVG,90,30,60,0,90,ITH,ITH4,6,Friuli-Venezia Giulia
2021-02-01,VEN,8561,2502,6059,160,8401,ITH,ITH3,5,Veneto
2021-03-26,PAB,1657,733,924,523,1134,ITH,ITH1,4,Provincia Autonoma Bolzano / Bozen
2021-04-12,ABR,6207,2944,3263,5033,1174,ITF,ITF1,13,Abruzzo
2021-02-06,LIG,1892,768,1124,145,1747,ITC,ITC3,7,Liguria
2021-03-06,FVG,3500,1196,2304,3175,325,ITH,ITH4,6,Friuli-Venezia Giulia
2021-03-18,SAR,7257,3071,4186,5652,1605,ITG,ITG2,20,Sardegna
2021-02-15,VEN,4389,1824,2565,4149,240,ITH,ITH3,5,Veneto
2021-02-27,PAT,1030,457,573,609,421,ITH,ITH2,4,Provincia Autonoma Trento
2021-04-09,PAB,2937,1301,1636,2207,730,ITH,ITH1,4,Provincia Autonoma Bolzano / Bozen
2021-04-19,BAS,4166,1913,2253,2528,1638,ITF,ITF5,17,Basilicata
2021-05-14,SAR,14587,6876,7711,10939,3648,ITG,ITG2,20,Sardegna
2021-01-01,PAT,214,50,164,214,0,ITH,ITH2,4,Provincia Autonoma Trento
2021-06-07,PAT,5789,2880,2909,2806,2983,ITH,ITH2,4,Provincia Autonoma Trento
2021-02-03,SAR,1119,419,700,426,693,ITG,ITG2,20,Sardegna
2021-03-21,MAR,4504,1873,2631,1629,2875,ITI,ITI3,11,Marche
2021-04-18,PIE,22973,10822,12151,20217,2756,ITC,ITC1,1,Piemonte
2021-03-30,VEN,35958,15293,20665,30717,5241,ITH,ITH3,5,Veneto
2021-05-22,PAB,6821,3553,3268,4655,2166,ITH,ITH1,4,Provincia Autonoma Bolzano / Bozen
2021-01-08,PIE,5533,1762,3771,5533,0,ITC,ITC1,1,Piemonte
2021-02-25,PUG,11969,5062,6907,10796,1173,ITF,ITF4,16,Puglia
2021-03-25,LAZ,29006,13365,15641,22399,6607,ITI,ITI4,12,Lazio
2021-04-01,SAR,10165,4072,6093,7150,3015,ITG,ITG2,20,Sardegna
2021-06-14,PIE,37916,19536,18380,30826,7090,ITC,ITC1,1,Piemonte
2021-02-11,PAB,1094,432,662,239,855,ITH,ITH1,4,Provincia Autonoma Bolzano / Bozen
2021-03-22,VDA,560,205,355,333,227,ITC,ITC2,2,Valle d'Aosta / Vallée d'Aoste
2021-04-25,PAT,1971,940,1031,1964,7,ITH,ITH2,4,Provincia Autonoma Trento
2021-01-27,LAZ,6116,2389,3727,999,5117,ITI,ITI4,12,Lazio
2021-02-06,MAR,2463,902,1561,522,1941,ITI,ITI3,11,Marche
2021-03-06,PIE,13994,5211,8783,11205,2789,ITC,ITC1,1,Piemonte
2021-06-05,PUG,42132,20644,21488,29537,12595,ITF,ITF4,16,Puglia
2021-06-15,BAS,3208,1406,1802,2233,975,ITF,ITF5,17,Basilicata
2021-06-26,LOM,101562,53214,48348,76179,25383,ITC,ITC4,3,Lombardia
2021-06-11,LIG,17352,8845,8507,11291,6061,ITC,ITC3,7,Liguria
2021-04-15,LIG,11832,5230,6602,9981,1851,ITC,ITC3,7,Liguria
2021-01-22,PIE,3867,1249,2618,2526,1341,ITC,ITC1,1,Piemonte
2021-01-05,CAL,1517,708,809,1517,0,ITF,ITF6,18,Calabria
2021-02-07,SIC,2322,982,1340,674,1648,ITG,ITG1,19,Sicilia
2021-04-10,VEN,27458,11973,15485,18987,8471,ITH,ITH3,5,Veneto
2021-02-10,LOM,14400,4506,9894,7578,6822,ITC,ITC4,3,Lombardia
2021-02-24,CAM,11784,4149,7635,11096,688,ITF,ITF3,15,Campania
2021-05-18,SIC,36085,17358,18727,23573,12512,ITG,ITG1,19,Sicilia
2021-06-06,VEN,37310,19105,18205,32583,4727,ITH,ITH3,5,Veneto
2020-12-27,TOS,620,267,353,620,0,ITI,ITI1,9,Toscana
2021-06-01,LAZ,48774,23537,25237,30289,18485,ITI,ITI4,12,Lazio
2021-04-05,LAZ,19846,9065,10781,13665,6181,ITI,ITI4,12,Lazio
2021-01-16,ABR,934,430,504,934,0,ITF,ITF1,13,Abruzzo
2021-02-12,EMR,5313,1673,3640,3910,1403,ITH,ITH5,8,Emilia-Romagna
2021-06-05,VDA,925,476,449,737,188,ITC,ITC2,2,Valle d'Aosta / Vallée d'Aoste
2021-04-10,EMR,20921,9300,11621,16777,4144,ITH,ITH5,8,Emilia-Romagna
2021-02-11,VDA,231,107,124,222,9,ITC,ITC2,2,Valle d'Aosta / Vallée d'Aoste
2021-03-29,UMB,3629,1600,2029,2210,1419,ITI,ITI2,10,Umbria
2021-04-17,EMR,27298,13072,14226,17953,9345,ITH,ITH5,8,Emilia-Romagna
2021-01-31,UMB,1058,276,782,25,1033,ITI,ITI2,10,Umbria
2021-04-09,VDA,237,111,126,204,33,ITC,ITC2,2,Valle d'Aosta / Vallée d'Aoste
2021-01-07,EMR,10274,3406,6868,10274,0,ITH,ITH5,8,Emilia-Romagna
2021-05-21,MAR,13714,6507,7207,7437,6277,ITI,ITI3,11,Marche
2021-01-03,TOS,3336,1052,2284,3336,0,ITI,ITI1,9,Toscana
2021-05-25,LAZ,47421,22234,25187,35759,11662,ITI,ITI4,12,Lazio
2021-05-22,VDA,940,494,446,540,400,ITC,ITC2,2,Valle d'Aosta / Vallée d'Aoste
2021-05-25,UMB,8812,4300,4512,7750,1062,ITI,ITI2,10,Umbria
2021-05-26,MOL,1548,697,851,794,754,ITF,ITF2,14,Molise
2021-06-25,PAT,7466,3999,3467,4106,3360,ITH,ITH2,4,Provincia Autonoma Trento
2021-01-05,CAM,7237,3637,3600,7237,0,ITF,ITF3,15,Campania
2021-02-28,BAS,804,343,461,775,29,ITF,ITF5,17,Basilicata
2021-03-30,MOL,2003,857,1146,1491,512,ITF,ITF2,14,Molise
2020-12-27,VEN,880,395,485,880,0,ITH,ITH3,5,Veneto
2021-01-12,CAL,2074,1025,1049,2074,0,ITF,ITF6,18,Calabria
2021-02-18,PAB,1839,457,1382,1832,7,ITH,ITH1,4,Provincia Autonoma Bolzano / Bozen
2021-01-02,BAS,950,381,569,950,0,ITF,ITF5,17,Basilicata
2021-01-06,PUG,3952,1674,2278,3952,0,ITF,ITF4,16,Puglia
2021-02-01,MOL,562,201,361,14,548,ITF,ITF2,14,Molise
2021-01-16,BAS,722,304,418,722,0,ITF,ITF5,17,Basilicata
2021-05-12,MOL,2852,1294,1558,2756,96,ITF,ITF2,14,Molise
2021-04-08,LIG,13746,6161,7585,11701,2045,ITC,ITC3,7,Liguria
2021-05-06,FVG,11889,5523,6366,7922,3967,ITH,ITH4,6,Friuli-Venezia Giulia
2021-02-10,SAR,1959,765,1194,1441,518,ITG,ITG2,20,Sardegna
2021-04-26,BAS,4466,2165,2301,4245,221,ITF,ITF5,17,Basilicata
2021-07-02,FVG,10279,5303,4976,1964,8315,ITH,ITH4,6,Friuli-Venezia Giulia
2021-06-04,LIG,14736,7236,7500,9249,5487,ITC,ITC3,7,Liguria
2021-02-17,CAM,7389,3211,4178,6329,1060,ITF,ITF3,15,Campania
2021-05-25,SIC,33366,15293,18073,14099,19267,ITG,ITG1,19,Sicilia
2021-05-30,VEN,22541,11266,11275,15849,6692,ITH,ITH3,5,Veneto
2021-02-03,LOM,25646,7917,17729,1081,24565,ITC,ITC4,3,Lombardia
2021-03-08,PIE,14020,5359,8661,11306,2714,ITC,ITC1,1,Piemonte
2021-04-03,SAR,4669,1806,2863,2702,1967,ITG,ITG2,20,Sardegna
2021-01-18,ABR,125,51,74,46,79,ITF,ITF1,13,Abruzzo
2021-06-24,ABR,10682,5318,5364,5687,4995,ITF,ITF1,13,Abruzzo
2021-05-04,PIE,28587,13146,15441,16410,12177,ITC,ITC1,1,Piemonte
2021-05-30,SAR,9730,4839,4891,7372,2358,ITG,ITG2,20,Sardegna
2021-04-28,ABR,9513,4587,4926,7490,2023,ITF,ITF1,13,Abruzzo
2021-01-24,PIE,3153,959,2194,434,2719,ITC,ITC1,1,Piemonte
2021-02-19,SAR,1499,473,1026,1443,56,ITG,ITG2,20,Sardegna
2021-06-06,CAL,13383,6438,6945,11687,1696,ITF,ITF6,18,Calabria
2021-06-30,PIE,41037,20055,20982,19165,21872,ITC,ITC1,1,Piemonte
2021-01-01,PAB,6,5,1,6,0,ITH,ITH1,4,Provincia Autonoma Bolzano / Bozen
2021-04-15,VEN,20906,8634,12272,10083,10823,ITH,ITH3,5,Veneto
2021-05-12,ABR,9630,4600,5030,6050,3580,ITF,ITF1,13,Abruzzo
2021-05-30,CAM,52107,25417,26690,38795,13312,ITF,ITF3,15,Campania
2021-06-07,PAB,2901,1506,1395,2582,319,ITH,ITH1,4,Provincia Autonoma Bolzano / Bozen
2021-03-22,PIE,11523,4890,6633,3917,7606,ITC,ITC1,1,Piemonte
2021-04-03,SIC,16411,7815,8596,13577,2834,ITG,ITG1,19,Sicilia
2021-01-05,VEN,7330,2183,5147,7330,0,ITH,ITH3,5,Veneto
2021-02-19,CAM,9571,3559,6012,8921,650,ITF,ITF3,15,Campania
2021-02-27,PAB,2458,759,1699,2448,10,ITH,ITH1,4,Provincia Autonoma Bolzano / Bozen
2021-03-16,ABR,3484,1452,2032,1830,1654,ITF,ITF1,13,Abruzzo
2020-12-31,LAZ,5293,2121,3172,5293,0,ITI,ITI4,12,Lazio
2021-04-03,LOM,36241,14860,21381,26150,10091,ITC,ITC4,3,Lombardia
2021-05-28,TOS,30074,13911,16163,17630,12444,ITI,ITI1,9,Toscana
2021-04-10,LAZ,23926,10409,13517,16736,7190,ITI,ITI4,12,Lazio
2021-05-30,LOM,74370,35589,38781,34414,39956,ITC,ITC4,3,Lombardia
2021-05-04,PAT,4511,2448,2063,4417,94,ITH,ITH2,4,Provincia Autonoma Trento
2021-01-17,FVG,1716,523,1193,1716,0,ITH,ITH4,6,Friuli-Venezia Giulia
2021-02-05,LAZ,7309,2979,4330,1210,6099,ITI,ITI4,12,Lazio
2021-04-07,VDA,910,474,436,681,229,ITC,ITC2,2,Valle d'Aosta / Vallée d'Aoste
2021-04-12,EMR,19245,9007,10238,14798,4447,ITH,ITH5,8,Emilia-Romagna
2021-04-22,TOS,35694,15292,20402,18209,17485,ITI,ITI1,9,Toscana
2021-03-08,PAT,1411,434,977,1057,354,ITH,ITH2,4,Provincia Autonoma Trento
2021-04-06,MAR,8875,3693,5182,8065,810,ITI,ITI3,11,Marche
2021-02-24,TOS,10371,4467,5904,10174,197,ITI,ITI1,9,Toscana
2021-03-15,FVG,3951,1809,2142,1630,2321,ITH,ITH4,6,Friuli-Venezia Giulia
2021-06-08,EMR,44724,22896,21828,37268,7456,ITH,ITH5,8,Emilia-Romagna
2021-03-22,PAT,2306,973,1333,1431,875,ITH,ITH2,4,Provincia Autonoma Trento
2021-06-04,TOS,28250,13377,14873,20495,7755,ITI,ITI1,9,Toscana
2021-01-24,PAT,548,276,272,224,324,ITH,ITH2,4,Provincia Autonoma Trento
2021-05-20,UMB,9830,4585,5245,6180,3650,ITI,ITI2,10,Umbria
2021-06-30,PAT,6653,3420,3233,2658,3995,ITH,ITH2,4,Provincia Autonoma Trento
2021-02-09,VDA,251,84,167,68,183,ITC,ITC2,2,Valle d'Aosta / Vallée d'Aoste
2021-03-06,PUG,16147,6126,10021,14055,2092,ITF,ITF4,16,Puglia
2021-04-03,LAZ,24783,11183,13600,18083,6700,ITI,ITI4,12,Lazio
2021-04-08,TOS,29684,12558,17126,23297,6387,ITI,ITI1,9,Toscana
2020-12-31,CAM,1489,810,679,1489,0,ITF,ITF3,15,Campania
2021-02-10,VEN,4751,1588,3163,3697,1054,ITH,ITH3,5,Veneto
2021-03-23,MAR,5790,2530,3260,2262,3528,ITI,ITI3,11,Marche
2021-06-06,CAM,62321,30978,31343,61674,647,ITF,ITF3,15,Campania
2021-01-07,CAL,2197,1072,1125,2197,0,ITF,ITF6,18,Calabria
2021-01-08,PUG,5649,2370,3279,5649,0,ITF,ITF4,16,Puglia
2021-02-13,PAB,318,79,239,312,6,ITH,ITH1,4,Provincia Autonoma Bolzano / Bozen
2021-06-13,CAL,6595,3244,3351,5564,1031,ITF,ITF6,18,Calabria
2021-06-14,PUG,41653,20384,21269,29315,12338,ITF,ITF4,16,Puglia
2021-02-06,MOL,429,179,250,29,400,ITF,ITF2,14,Molise
2021-02-26,CAM,13334,4227,9107,11999,1335,ITF,ITF3,15,Campania
2021-04-08,VEN,32364,14367,17997,24489,7875,ITH,ITH3,5,Veneto
2021-04-11,PAB,2722,1293,1429,2545,177,ITH,ITH1,4,Provincia Autonoma Bolzano / Bozen
2021-04-17,CAL,10824,5073,5751,9047,1777,ITF,ITF6,18,Calabria
2021-04-18,PUG,22598,10808,11790,21535,1063,ITF,ITF4,16,Puglia
2021-02-08,MAR,833,258,575,371,462,ITI,ITI3,11,Marche
2021-04-24,CAM,36362,17526,18836,25114,11248,ITF,ITF3,15,Campania
2021-06-17,BAS,4421,2034,2387,2103,2318,ITF,ITF5,17,Basilicata
2021-02-20,PUG,2970,1079,1891,2713,257,ITF,ITF4,16,Puglia
2021-03-27,SAR,5736,2192,3544,5314,422,ITG,ITG2,20,Sardegna
2021-05-01,CAL,16661,7942,8719,12461,4200,ITF,ITF6,18,Calabria
2021-05-11,FVG,9031,4333,4698,7229,1802,ITH,ITH4,6,Friuli-Venezia Giulia
2021-04-21,BAS,3922,1835,2087,2272,1650,ITF,ITF5,17,Basilicata
2021-05-19,MAR,11478,5276,6202,8561,2917,ITI,ITI3,11,Marche
2021-01-31,FVG,2717,838,1879,385,2332,ITH,ITH4,6,Friuli-Venezia Giulia
2021-02-15,LIG,2262,839,1423,1865,397,ITC,ITC3,7,Liguria
2021-03-05,CAL,6236,3619,2617,5662,574,ITF,ITF6,18,Calabria
2021-05-23,SAR,9967,4807,5160,7722,2245,ITG,ITG2,20,Sardegna
2021-05-24,PAB,1444,762,682,1111,333,ITH,ITH1,4,Provincia Autonoma Bolzano / Bozen
2021-05-05,ABR,11640,5574,6066,6434,5206,ITF,ITF1,13,Abruzzo
2021-02-12,SAR,2237,933,1304,2178,59,ITG,ITG2,20,Sardegna
2021-03-27,SIC,15606,7356,8250,10754,4852,ITG,ITG1,19,Sicilia
2021-04-27,PIE,22608,10214,12394,17461,5147,ITC,ITC1,1,Piemonte
2021-03-09,ABR,5176,1804,3372,4238,938,ITF,ITF1,13,Abruzzo
2021-01-03,LIG,734,230,504,734,0,ITC,ITC3,7,Liguria
2021-01-17,PIE,3520,1169,2351,2872,648,ITC,ITC1,1,Piemonte
2021-01-29,SIC,9171,4253,4918,425,8746,ITG,ITG1,19,Sicilia
2021-04-10,SAR,10496,4750,5746,8559,1937,ITG,ITG2,20,Sardegna
2021-02-20,PAB,1802,540,1262,1784,18,ITH,ITH1,4,Provincia Autonoma Bolzano / Bozen
2021-06-04,VEN,49465,25743,23722,41368,8097,ITH,ITH3,5,Veneto
2021-02-12,SIC,4586,1811,2775,4320,266,ITG,ITG1,19,Sicilia
2021-03-15,PIE,10682,4184,6498,5062,5620,ITC,ITC1,1,Piemonte
2021-02-24,VEN,8616,3679,4937,8128,488,ITH,ITH3,5,Veneto
2021-04-10,CAM,28354,13493,14861,23440,4914,ITF,ITF3,15,Campania
2021-04-18,PAB,3110,1607,1503,2100,1010,ITH,ITH1,4,Provincia Autonoma Bolzano / Bozen
2021-07-01,ABR,12520,6148,6372,5744,6776,ITF,ITF1,13,Abruzzo
2021-05-11,PIE,32078,15458,16620,18866,13212,ITC,ITC1,1,Piemonte
2021-05-23,SIC,34091,16595,17496,20074,14017,ITG,ITG1,19,Sicilia
2021-01-31,PIE,4113,1753,2360,112,4001,ITC,ITC1,1,Piemonte
2021-05-23,LOM,60762,28927,31835,26807,33955,ITC,ITC4,3,Lombardia
2021-01-01,LIG,144,55,89,144,0,ITC,ITC3,7,Liguria
2021-04-05,EMR,14848,6802,8046,11956,2892,ITH,ITH5,8,Emilia-Romagna
2021-05-16,VEN,28411,14005,14406,21333,7078,ITH,ITH3,5,Veneto
2021-01-04,ABR,1403,576,827,1403,0,ITF,ITF1,13,Abruzzo
2021-01-27,MAR,2119,780,1339,121,1998,ITI,ITI3,11,Marche
2021-03-10,CAL,6732,3420,3312,5399,1333,ITF,ITF6,18,Calabria
2021-04-29,UMB,5209,2245,2964,2889,2320,ITI,ITI2,10,Umbria
2021-05-18,SAR,14752,7378,7374,9552,5200,ITG,ITG2,20,Sardegna
2021-01-13,PAB,1691,557,1134,1691,0,ITH,ITH1,4,Provincia Autonoma Bolzano / Bozen
2021-03-24,UMB,4103,1792,2311,2780,1323,ITI,ITI2,10,Umbria
2021-01-23,ABR,264,115,149,57,207,ITF,ITF1,13,Abruzzo
2021-04-22,PIE,27695,12753,14942,20986,6709,ITC,ITC1,1,Piemonte
2021-07-02,UMB,8591,4246,4345,3117,5474,ITI,ITI2,10,Umbria
2021-01-12,PIE,10090,3415,6675,10090,0,ITC,ITC1,1,Piemonte
2021-01-30,PAB,498,245,253,4,494,ITH,ITH1,4,Provincia Autonoma Bolzano / Bozen
2021-03-29,CAM,19402,9576,9826,17856,1546,ITF,ITF3,15,Campania
2021-05-03,ABR,11115,5242,5873,7285,3830,ITF,ITF1,13,Abruzzo
2021-06-03,VDA,1306,667,639,896,410,ITC,ITC2,2,Valle d'Aosta / Vallée d'Aoste
2021-01-29,PIE,5945,1887,4058,455,5490,ITC,ITC1,1,Piemonte
2021-02-24,SAR,2414,1295,1119,2224,190,ITG,ITG2,20,Sardegna
2021-04-20,MAR,10701,4998,5703,9281,1420,ITI,ITI3,11,Marche
2021-06-01,CAL,12850,5959,6891,7934,4916,ITF,ITF6,18,Calabria
2021-04-10,UMB,7389,3477,3912,7305,84,ITI,ITI2,10,Umbria
2021-05-02,PUG,21313,9658,11655,14047,7266,ITF,ITF4,16,Puglia
2021-04-23,PAB,4543,2151,2392,3252,1291,ITH,ITH1,4,Provincia Autonoma Bolzano / Bozen
2021-05-17,VDA,809,417,392,375,434,ITC,ITC2,2,Valle d'Aosta / Vallée d'Aoste
2021-01-17,UMB,54,17,37,54,0,ITI,ITI2,10,Umbria
2021-03-27,LIG,3932,1549,2383,2537,1395,ITC,ITC3,7,Liguria
2021-05-23,TOS,28381,13646,14735,25819,2562,ITI,ITI1,9,Toscana
2021-01-25,MAR,1596,558,1038,94,1502,ITI,ITI3,11,Marche
2020-12-31,UMB,322,127,195,322,0,ITI,ITI2,10,Umbria
2021-04-10,SIC,20422,9969,10453,11458,8964,ITG,ITG1,19,Sicilia
2021-01-10,PAT,85,20,65,85,0,ITH,ITH2,4,Provincia Autonoma Trento
2021-04-13,LIG,13077,5867,7210,11053,2024,ITC,ITC3,7,Liguria
2021-04-15,LOM,49448,21858,27590,35624,13824,ITC,ITC4,3,Lombardia
2021-01-17,SIC,1305,592,713,1245,60,ITG,ITG1,19,Sicilia
2021-04-16,ABR,7537,3487,4050,5620,1917,ITF,ITF1,13,Abruzzo
2021-06-20,CAM,46788,22345,24443,13812,32976,ITF,ITF3,15,Campania
2021-01-05,LOM,7853,2576,5277,7853,0,ITC,ITC4,3,Lombardia
2021-03-22,LAZ,23182,10409,12773,16508,6674,ITI,ITI4,12,Lazio
2021-03-27,CAM,21513,10242,11271,17648,3865,ITF,ITF3,15,Campania
2021-07-02,SIC,30108,14016,16092,9868,20240,ITG,ITG1,19,Sicilia
2021-01-23,BAS,721,305,416,33,688,ITF,ITF5,17,Basilicata
2021-05-13,CAL,15927,7659,8268,11221,4706,ITF,ITF6,18,Calabria
2021-05-03,BAS,4512,2043,2469,3684,828,ITF,ITF5,17,Basilicata
2021-04-24,EMR,28632,13241,15391,14403,14229,ITH,ITH5,8,Emilia-Romagna
2020-12-29,LAZ,488,176,312,488,0,ITI,ITI4,12,Lazio
2021-01-08,MAR,1581,592,989,1581,0,ITI,ITI3,11,Marche
2021-01-11,PAB,1574,513,1061,1574,0,ITH,ITH1,4,Provincia Autonoma Bolzano / Bozen
2021-02-19,CAL,1509,682,827,1248,261,ITF,ITF6,18,Calabria
2021-05-15,VDA,1065,614,451,380,685,ITC,ITC2,2,Valle d'Aosta / Vallée d'Aoste
2021-06-06,SAR,10030,4998,5032,6379,3651,ITG,ITG2,20,Sardegna
2021-01-29,PAT,1358,334,1024,55,1303,ITH,ITH2,4,Provincia Autonoma Trento
2021-02-09,BAS,491,213,278,316,175,ITF,ITF5,17,Basilicata
2021-02-04,VDA,294,86,208,8,286,ITC,ITC2,2,Valle d'Aosta / Vallée d'Aoste
2021-03-27,LOM,32437,12376,20061,23729,8708,ITC,ITC4,3,Lombardia
2021-04-18,MAR,8824,4132,4692,7903,921,ITI,ITI3,11,Marche
2021-05-11,EMR,35778,16792,18986,28524,7254,ITH,ITH5,8,Emilia-Romagna
2021-05-30,CAL,10955,5263,5692,6801,4154,ITF,ITF6,18,Calabria
2021-04-28,VDA,1218,632,586,715,503,ITC,ITC2,2,Valle d'Aosta / Vallée d'Aoste
2021-06-01,CAM,41957,20831,21126,31491,10466,ITF,ITF3,15,Campania
2021-01-31,EMR,7698,2763,4935,241,7457,ITH,ITH5,8,Emilia-Romagna
2021-02-10,TOS,4263,1281,2982,3740,523,ITI,ITI1,9,Toscana
2021-04-03,FVG,4012,1990,2022,2681,1331,ITH,ITH4,6,Friuli-Venezia Giulia
2021-01-03,LOM,854,316,538,854,0,ITC,ITC4,3,Lombardia
2021-04-06,PAB,2250,1118,1132,2147,103,ITH,ITH1,4,Provincia Autonoma Bolzano / Bozen
2021-06-18,CAM,63733,30303,33430,33463,30270,ITF,ITF3,15,Campania
2021-03-10,CAM,15610,7719,7891,8775,6835,ITF,ITF3,15,Campania
2021-04-22,PAT,3152,1470,1682,3107,45,ITH,ITH2,4,Provincia Autonoma Trento
2021-06-15,UMB,5966,3010,2956,3906,2060,ITI,ITI2,10,Umbria
2021-05-04,TOS,18313,8215,10098,12862,5451,ITI,ITI1,9,Toscana
2021-06-13,LAZ,52561,23274,29287,27737,24824,ITI,ITI4,12,Lazio
2021-03-07,LAZ,14133,5466,8667,10540,3593,ITI,ITI4,12,Lazio
2021-06-10,FVG,10704,5610,5094,9671,1033,ITH,ITH4,6,Friuli-Venezia Giulia
2021-06-15,LAZ,65383,31510,33873,33453,31930,ITI,ITI4,12,Lazio
2021-06-18,PUG,46826,23055,23771,29050,17776,ITF,ITF4,16,Puglia
2021-02-28,PIE,10816,4060,6756,10576,240,ITC,ITC1,1,Piemonte
2021-05-15,CAM,62653,29040,33613,43941,18712,ITF,ITF3,15,Campania
2021-03-17,PIE,12518,5055,7463,5224,7294,ITC,ITC1,1,Piemonte
2021-06-21,BAS,4243,2038,2205,2152,2091,ITF,ITF5,17,Basilicata
2020-12-31,VEN,3220,1042,2178,3220,0,ITH,ITH3,5,Veneto
2021-03-11,ABR,5494,2220,3274,4356,1138,ITF,ITF1,13,Abruzzo
2021-03-24,LAZ,27648,12901,14747,21411,6237,ITI,ITI4,12,Lazio
2021-03-25,MOL,1806,730,1076,1309,497,ITF,ITF2,14,Molise
2021-03-19,FVG,3252,1350,1902,1316,1936,ITH,ITH4,6,Friuli-Venezia Giulia
2021-03-08,MOL,1379,522,857,1239,140,ITF,ITF2,14,Molise
2021-07-04,VEN,13205,6769,6436,5005,8200,ITH,ITH3,5,Veneto
2021-03-05,SIC,15666,6770,8896,11431,4235,ITG,ITG1,19,Sicilia
2021-06-02,ABR,9764,4743,5021,6953,2811,ITF,ITF1,13,Abruzzo
2021-06-29,EMR,36044,17725,18319,17377,18667,ITH,ITH5,8,Emilia-Romagna
2021-04-07,PAT,2622,1017,1605,1680,942,ITH,ITH2,4,Provincia Autonoma Trento
2021-06-16,MOL,2002,1013,989,1147,855,ITF,ITF2,14,Molise
2021-03-21,EMR,11956,5296,6660,7351,4605,ITH,ITH5,8,Emilia-Romagna
2021-05-13,LIG,13296,6081,7215,9049,4247,ITC,ITC3,7,Liguria
2021-02-16,SIC,4200,2207,1993,3735,465,ITG,ITG1,19,Sicilia
2021-05-29,LAZ,51958,23353,28605,40985,10973,ITI,ITI4,12,Lazio
2021-06-27,FVG,7263,3625,3638,3457,3806,ITH,ITH4,6,Friuli-Venezia Giulia
2021-04-12,VEN,14902,6333,8569,6686,8216,ITH,ITH3,5,Veneto
2021-02-19,LIG,3218,1306,1912,3042,176,ITC,ITC3,7,Liguria
2021-06-19,BAS,4460,2175,2285,2387,2073,ITF,ITF5,17,Basilicata
2021-01-02,VEN,5744,1767,3977,5744,0,ITH,ITH3,5,Veneto
2021-04-13,MOL,1632,718,914,1045,587,ITF,ITF2,14,Molise
2021-06-17,UMB,6941,3516,3425,4886,2055,ITI,ITI2,10,Umbria
2021-05-30,LIG,3302,1613,1689,1363,1939,ITC,ITC3,7,Liguria
2021-03-13,ABR,4124,1420,2704,3081,1043,ITF,ITF1,13,Abruzzo
2021-03-28,BAS,2142,743,1399,2125,17,ITF,ITF5,17,Basilicata
2021-05-17,CAL,14893,7443,7450,10178,4715,ITF,ITF6,18,Calabria
2021-06-10,PIE,40231,21022,19209,37676,2555,ITC,ITC1,1,Piemonte
2021-03-26,UMB,4588,1712,2876,4416,172,ITI,ITI2,10,Umbria
2021-03-27,MOL,2743,1273,1470,1310,1433,ITF,ITF2,14,Molise
2021-02-12,TOS,7618,2694,4924,7405,213,ITI,ITI1,9,Toscana
2021-04-08,PAB,2767,1347,1420,2563,204,ITH,ITH1,4,Provincia Autonoma Bolzano / Bozen
2021-06-10,EMR,44070,22647,21423,38721,5349,ITH,ITH5,8,Emilia-Romagna
2021-06-21,ABR,10888,5308,5580,4916,5972,ITF,ITF1,13,Abruzzo
2021-06-22,LOM,108675,56758,51917,79473,29202,ITC,ITC4,3,Lombardia
2021-03-11,BAS,1794,928,866,835,959,ITF,ITF5,17,Basilicata
2021-01-02,UMB,304,111,193,304,0,ITI,ITI2,10,Umbria
2021-03-02,EMR,12658,4272,8386,10581,2077,ITH,ITH5,8,Emilia-Romagna
2021-06-29,FVG,11043,5640,5403,1214,9829,ITH,ITH4,6,Friuli-Venezia Giulia
2021-01-03,PUG,2006,942,1064,2006,0,ITF,ITF4,16,Puglia
2021-04-14,SAR,8259,3905,4354,7021,1238,ITG,ITG2,20,Sardegna
2021-06-27,PIE,37408,18552,18856,15678,21730,ITC,ITC1,1,Piemonte
2021-01-10,MAR,1745,701,1044,1745,0,ITI,ITI3,11,Marche
2021-02-21,CAL,622,295,327,545,77,ITF,ITF6,18,Calabria
2021-06-18,MOL,2754,1246,1508,1307,1447,ITF,ITF2,14,Molise
2021-03-19,EMR,15925,6972,8953,7956,7969,ITH,ITH5,8,Emilia-Romagna
2021-03-19,PIE,11032,4521,6511,4426,6606,ITC,ITC1,1,Piemonte
2021-03-27,PUG,12153,5709,6444,6984,5169,ITF,ITF4,16,Puglia
2021-04-05,PIE,14748,6234,8514,12192,2556,ITC,ITC1,1,Piemonte
2021-05-01,SAR,9917,4766,5151,5459,4458,ITG,ITG2,20,Sardegna
2021-01-19,VEN,1310,473,837,1160,150,ITH,ITH3,5,Veneto
2021-01-21,SAR,126,60,66,94,32,ITG,ITG2,20,Sardegna
2021-02-06,VDA,289,104,185,92,197,ITC,ITC2,2,Valle d'Aosta / Vallée d'Aoste
2021-03-12,CAM,14573,7409,7164,8490,6083,ITF,ITF3,15,Campania
2021-06-01,LIG,16159,8116,8043,10793,5366,ITC,ITC3,7,Liguria
2021-06-03,LOM,97056,49674,47382,86193,10863,ITC,ITC4,3,Lombardia
2021-06-17,SIC,41227,19193,22034,20167,21060,ITG,ITG1,19,Sicilia
2021-02-07,SAR,1118,395,723,228,890,ITG,ITG2,20,Sardegna
2021-04-28,CAL,12524,6059,6465,9662,2862,ITF,ITF6,18,Calabria
2021-03-07,UMB,845,180,665,838,7,ITI,ITI2,10,Umbria
2021-01-05,PUG,5108,2251,2857,5108,0,ITF,ITF4,16,Puglia
2020-12-27,PAB,144,65,79,144,0,ITH,ITH1,4,Provincia Autonoma Bolzano / Bozen
2021-02-04,CAL,3593,1708,1885,653,2940,ITF,ITF6,18,Calabria
2021-04-30,VDA,831,355,476,485,346,ITC,ITC2,2,Valle d'Aosta / Vallée d'Aoste
2021-05-10,LAZ,44437,20305,24132,31022,13415,ITI,ITI4,12,Lazio
2021-06-18,LIG,15062,7318,7744,7929,7133,ITC,ITC3,7,Liguria
2021-06-20,LOM,87854,43770,44084,54195,33659,ITC,ITC4,3,Lombardia
2021-06-27,PAT,1282,685,597,342,940,ITH,ITH2,4,Provincia Autonoma Trento
2021-04-15,PUG,32551,15188,17363,29005,3546,ITF,ITF4,16,Puglia
2021-01-20,VDA,23,8,15,23,0,ITC,ITC2,2,Valle d'Aosta / Vallée d'Aoste
2021-03-12,LOM,35269,12967,22302,25065,10204,ITC,ITC4,3,Lombardia
2021-04-03,MAR,7572,3204,4368,6905,667,ITI,ITI3,11,Marche
2021-04-07,FVG,7823,3620,4203,7041,782,ITH,ITH4,6,Friuli-Venezia Giulia
2021-05-15,CAL,27238,13027,14211,20386,6852,ITF,ITF6,18,Calabria
2021-03-29,LOM,40045,15542,24503,25208,14837,ITC,ITC4,3,Lombardia
2020-12-31,SIC,887,473,414,887,0,ITG,ITG1,19,Sicilia
2021-01-26,TOS,5393,1792,3601,220,5173,ITI,ITI1,9,Toscana
2021-03-30,ABR,5126,2261,2865,3304,1822,ITF,ITF1,13,Abruzzo
2021-06-30,PAB,3021,1542,1479,418,2603,ITH,ITH1,4,Provincia Autonoma Bolzano / Bozen
2021-06-29,PIE,40394,20195,20199,19796,20598,ITC,ITC1,1,Piemonte
2021-03-10,LIG,5900,2862,3038,3994,1906,ITC,ITC3,7,Liguria
2021-05-06,TOS,31322,13614,17708,14161,17161,ITI,ITI1,9,Toscana
2021-06-03,CAM,72559,35188,37371,61891,10668,ITF,ITF3,15,Campania
2021-01-06,ABR,1831,664,1167,1831,0,ITF,ITF1,13,Abruzzo
2021-06-25,MAR,14145,7071,7074,6548,7597,ITI,ITI3,11,Marche
2021-02-23,CAM,11003,3388,7615,10477,526,ITF,ITF3,15,Campania
2021-04-19,TOS,9096,4509,4587,8064,1032,ITI,ITI1,9,Toscana
2021-05-01,VEN,38842,18231,20611,29899,8943,ITH,ITH3,5,Veneto
2021-05-03,SAR,8187,3820,4367,6590,1597,ITG,ITG2,20,Sardegna
2021-02-02,CAL,2350,1151,1199,177,2173,ITF,ITF6,18,Calabria
2021-05-30,MOL,1862,928,934,1577,285,ITF,ITF2,14,Molise
2021-03-07,SIC,9259,3454,5805,8176,1083,ITG,ITG1,19,Sicilia
2021-04-07,EMR,26116,11890,14226,20105,6011,ITH,ITH5,8,Emilia-Romagna
2021-04-17,TOS,20532,9206,11326,18398,2134,ITI,ITI1,9,Toscana
2021-05-20,SAR,16307,7853,8454,11413,4894,ITG,ITG2,20,Sardegna
2021-01-12,PAT,507,158,349,507,0,ITH,ITH2,4,Provincia Autonoma Trento
2021-01-16,CAL,2400,1124,1276,2400,0,ITF,ITF6,18,Calabria
2021-06-11,PAB,5746,2947,2799,2276,3470,ITH,ITH1,4,Provincia Autonoma Bolzano / Bozen
2021-06-15,SIC,45134,21272,23862,27813,17321,ITG,ITG1,19,Sicilia
2021-02-09,SAR,2287,837,1450,1290,997,ITG,ITG2,20,Sardegna
2021-01-14,EMR,8129,2593,5536,8129,0,ITH,ITH5,8,Emilia-Romagna
2021-03-24,SIC,20877,9803,11074,15216,5661,ITG,ITG1,19,Sicilia
2021-02-26,SAR,2801,1109,1692,2495,306,ITG,ITG2,20,Sardegna
2021-03-20,PAB,1758,849,909,1133,625,ITH,ITH1,4,Provincia Autonoma Bolzano / Bozen
2021-05-27,LAZ,58110,26966,31144,44422,13688,ITI,ITI4,12,Lazio
2021-05-29,UMB,7851,3607,4244,6285,1566,ITI,ITI2,10,Umbria
2021-03-30,BAS,2743,1158,1585,2398,345,ITF,ITF5,17,Basilicata
2021-01-18,VDA,213,74,139,213,0,ITC,ITC2,2,Valle d'Aosta / Vallée d'Aoste
2021-02-21,CAM,5836,2241,3595,5611,225,ITF,ITF3,15,Campania
2021-03-19,PAT,2423,915,1508,1571,852,ITH,ITH2,4,Provincia Autonoma Trento
2021-01-06,BAS,294,129,165,294,0,ITF,ITF5,17,Basilicata
2021-01-24,TOS,3349,1073,2276,201,3148,ITI,ITI1,9,Toscana
2021-03-05,LAZ,19567,8668,10899,14834,4733,ITI,ITI4,12,Lazio
2021-02-16,LAZ,8360,4035,4325,7753,607,ITI,ITI4,12,Lazio
2021-07-03,PAT,1250,669,581,84,1166,ITH,ITH2,4,Provincia Autonoma Trento
2021-01-13,VEN,5985,1606,4379,5985,0,ITH,ITH3,5,Veneto
2021-02-22,LAZ,11458,4990,6468,10956,502,ITI,ITI4,12,Lazio
2021-04-25,TOS,11059,5248,5811,8919,2140,ITI,ITI1,9,Toscana
2021-07-01,PUG,45480,21286,24194,11217,34263,ITF,ITF4,16,Puglia
2021-03-30,PIE,16917,7056,9861,9044,7873,ITC,ITC1,1,Piemonte
2021-02-09,ABR,909,312,597,500,409,ITF,ITF1,13,Abruzzo
2021-06-02,LAZ,43232,21481,21751,31733,11499,ITI,ITI4,12,Lazio
2021-02-23,MOL,582,223,359,363,219,ITF,ITF2,14,Molise
2021-03-06,CAM,16371,6814,9557,10702,5669,ITF,ITF3,15,Campania
2021-05-04,CAL,16426,7572,8854,11726,4700,ITF,ITF6,18,Calabria
2021-06-11,LAZ,69065,32397,36668,36910,32155,ITI,ITI4,12,Lazio
2021-06-03,MOL,3291,1566,1725,2737,554,ITF,ITF2,14,Molise
2021-03-01,SIC,12693,6014,6679,11038,1655,ITG,ITG1,19,Sicilia
2021-04-07,MOL,1688,847,841,1413,275,ITF,ITF2,14,Molise
2021-03-04,LIG,4738,2118,2620,3891,847,ITC,ITC3,7,Liguria
2021-03-06,LOM,21338,9098,12240,16825,4513,ITC,ITC4,3,Lombardia
2021-04-01,FVG,6391,3052,3339,5376,1015,ITH,ITH4,6,Friuli-Venezia Giulia
2021-04-09,MAR,9566,4190,5376,9366,200,ITI,ITI3,11,Marche
2021-04-20,EMR,22621,10405,12216,14268,8353,ITH,ITH5,8,Emilia-Romagna
2021-05-28,FVG,10535,5045,5490,6424,4111,ITH,ITH4,6,Friuli-Venezia Giulia
2021-06-12,LIG,10114,4909,5205,7362,2752,ITC,ITC3,7,Liguria
2021-04-08,UMB,5858,2509,3349,4069,1789,ITI,ITI2,10,Umbria
2021-03-30,PAT,2388,973,1415,1751,637,ITH,ITH2,4,Provincia Autonoma Trento
2021-07-04,ABR,3698,1849,1849,1298,2400,ITF,ITF1,13,Abruzzo
2021-03-24,BAS,1897,724,1173,1499,398,ITF,ITF5,17,Basilicata
2021-04-19,VDA,751,325,426,542,209,ITC,ITC2,2,Valle d'Aosta / Vallée d'Aoste
2021-04-30,LIG,14416,6439,7977,5848,8568,ITC,ITC3,7,Liguria
2021-06-23,EMR,37340,18677,18663,18533,18807,ITH,ITH5,8,Emilia-Romagna
2021-06-09,SIC,49352,23487,25865,42225,7127,ITG,ITG1,19,Sicilia
2021-01-13,TOS,4062,1398,2664,4062,0,ITI,ITI1,9,Toscana
2021-04-25,VEN,18316,8150,10166,13481,4835,ITH,ITH3,5,Veneto
2021-06-17,PAB,1736,967,769,658,1078,ITH,ITH1,4,Provincia Autonoma Bolzano / Bozen
2021-04-01,PIE,19348,8083,11265,11228,8120,ITC,ITC1,1,Piemonte
2021-06-04,UMB,8904,4401,4503,7710,1194,ITI,ITI2,10,Umbria
2021-06-05,MOL,2964,1503,1461,2810,154,ITF,ITF2,14,Molise
2021-04-23,TOS,25645,11414,14231,9344,16301,ITI,ITI1,9,Toscana
2021-06-21,VEN,43776,21903,21873,20853,22923,ITH,ITH3,5,Veneto
2021-03-14,PUG,3327,1433,1894,2511,816,ITF,ITF4,16,Puglia
2021-05-28,PIE,35031,16594,18437,19054,15977,ITC,ITC1,1,Piemonte
2021-01-06,VEN,8134,2386,5748,8134,0,ITH,ITH3,5,Veneto
2021-01-22,CAL,659,275,384,657,2,ITF,ITF6,18,Calabria
2021-01-16,PUG,2506,1033,1473,2506,0,ITF,ITF4,16,Puglia
2021-06-09,LOM,102771,51783,50988,88309,14462,ITC,ITC4,3,Lombardia
2021-05-02,CAL,12513,5841,6672,10667,1846,ITF,ITF6,18,Calabria
2021-07-02,BAS,3569,1757,1812,2398,1171,ITF,ITF5,17,Basilicata
2021-01-08,EMR,10866,3580,7286,10866,0,ITH,ITH5,8,Emilia-Romagna
2021-01-25,PIE,6215,1938,4277,983,5232,ITC,ITC1,1,Piemonte
2021-02-20,SAR,2041,855,1186,1707,334,ITG,ITG2,20,Sardegna
2021-01-02,PAB,91,48,43,91,0,ITH,ITH1,4,Provincia Autonoma Bolzano / Bozen
2021-03-06,EMR,20901,5935,14966,18170,2731,ITH,ITH5,8,Emilia-Romagna
2021-01-06,MAR,2204,801,1403,2204,0,ITI,ITI3,11,Marche
2021-03-06,LIG,3304,1842,1462,2599,705,ITC,ITC3,7,Liguria
2021-03-08,LOM,29747,11187,18560,22668,7079,ITC,ITC4,3,Lombardia
2021-03-29,CAL,5740,2468,3272,3980,1760,ITF,ITF6,18,Calabria
2021-06-23,VEN,48294,23946,24348,15101,33193,ITH,ITH3,5,Veneto
2021-01-31,CAL,1112,555,557,153,959,ITF,ITF6,18,Calabria
2021-05-04,LOM,86815,41075,45740,72422,14393,ITC,ITC4,3,Lombardia
2021-05-06,LAZ,48739,22695,26044,31192,17547,ITI,ITI4,12,Lazio
2021-06-26,PAB,4501,2308,2193,1429,3072,ITH,ITH1,4,Provincia Autonoma Bolzano / Bozen
2021-01-22,LIG,1819,604,1215,1333,486,ITC,ITC3,7,Liguria
2021-01-24,LOM,1199,457,742,536,663,ITC,ITC4,3,Lombardia
2021-02-19,FVG,3252,1290,1962,2825,427,ITH,ITH4,6,Friuli-Venezia Giulia
2021-03-04,MAR,6511,2883,3628,5118,1393,ITI,ITI3,11,Marche
2021-05-02,LIG,3978,1836,2142,511,3467,ITC,ITC3,7,Liguria
2021-03-13,MAR,5766,2656,3110,1805,3961,ITI,ITI3,11,Marche
2021-06-13,UMB,6763,3556,3207,6533,230,ITI,ITI2,10,Umbria
2021-01-16,VDA,237,80,157,237,0,ITC,ITC2,2,Valle d'Aosta / Vallée d'Aoste
2021-04-29,SAR,11127,5111,6016,6769,4358,ITG,ITG2,20,Sardegna
2021-06-22,VDA,1189,666,523,541,648,ITC,ITC2,2,Valle d'Aosta / Vallée d'Aoste
2021-03-08,CAM,14685,6846,7839,9910,4775,ITF,ITF3,15,Campania
2021-06-21,MAR,12448,6105,6343,5574,6874,ITI,ITI3,11,Marche
2021-02-11,ABR,816,262,554,773,43,ITF,ITF1,13,Abruzzo
2021-03-14,VDA,392,200,192,392,0,ITC,ITC2,2,Valle d'Aosta / Vallée d'Aoste
2021-06-25,SAR,16481,7796,8685,3941,12540,ITG,ITG2,20,Sardegna
2021-03-15,VEN,16666,7327,9339,11458,5208,ITH,ITH3,5,Veneto
2021-05-01,UMB,5370,2638,2732,2140,3230,ITI,ITI2,10,Umbria
2021-05-04,CAM,48478,23345,25133,39577,8901,ITF,ITF3,15,Campania
2021-06-06,PAT,2228,1061,1167,445,1783,ITH,ITH2,4,Provincia Autonoma Trento
2021-03-18,PAB,1302,531,771,226,1076,ITH,ITH1,4,Provincia Autonoma Bolzano / Bozen
2021-03-20,TOS,6586,2977,3609,5450,1136,ITI,ITI1,9,Toscana
2021-05-11,CAL,15057,7283,7774,10285,4772,ITF,ITF6,18,Calabria
2021-05-20,EMR,40267,18311,21956,18897,21370,ITH,ITH5,8,Emilia-Romagna
2021-05-30,PIE,27702,13187,14515,18378,9324,ITC,ITC1,1,Piemonte
2021-01-24,CAM,4122,2119,2003,377,3745,ITF,ITF3,15,Campania
2021-03-05,UMB,4619,1402,3217,3963,656,ITI,ITI2,10,Umbria
2021-05-09,MAR,8863,4020,4843,3636,5227,ITI,ITI3,11,Marche
2021-01-22,TOS,2866,1064,1802,528,2338,ITI,ITI1,9,Toscana
2021-02-19,PIE,5535,2175,3360,5034,501,ITC,ITC1,1,Piemonte
2021-04-26,VDA,715,327,388,545,170,ITC,ITC2,2,Valle d'Aosta / Vallée d'Aoste
2021-05-14,PAB,5134,2320,2814,3097,2037,ITH,ITH1,4,Provincia Autonoma Bolzano / Bozen
2021-05-21,PUG,38971,18503,20468,28951,10020,ITF,ITF4,16,Puglia
2021-03-04,MOL,850,417,433,526,324,ITF,ITF2,14,Molise
2021-03-16,PAB,1290,532,758,124,1166,ITH,ITH1,4,Provincia Autonoma Bolzano / Bozen
2021-05-13,CAM,55449,24828,30621,39445,16004,ITF,ITF3,15,Campania
2021-01-19,SIC,1498,662,836,1276,222,ITG,ITG1,19,Sicilia
2021-06-12,MOL,3401,1748,1653,3291,110,ITF,ITF2,14,Molise
2021-05-02,EMR,25578,11651,13927,13588,11990,ITH,ITH5,8,Emilia-Romagna
2021-05-12,TOS,34199,15574,18625,14169,20030,ITI,ITI1,9,Toscana
2021-05-08,MOL,2974,1455,1519,1730,1244,ITF,ITF2,14,Molise
2021-01-22,EMR,1829,477,1352,1088,741,ITH,ITH5,8,Emilia-Romagna
2021-03-01,UMB,1504,774,730,1390,114,ITI,ITI2,10,Umbria
2021-01-18,TOS,1119,636,483,1021,98,ITI,ITI1,9,Toscana
2021-04-20,VEN,22431,9496,12935,8432,13999,ITH,ITH3,5,Veneto
2021-04-21,MOL,1864,789,1075,969,895,ITF,ITF2,14,Molise
2021-06-19,MAR,14458,7283,7175,7787,6671,ITI,ITI3,11,Marche
2021-02-08,EMR,5231,1534,3697,2318,2913,ITH,ITH5,8,Emilia-Romagna
2021-02-14,BAS,151,48,103,151,0,ITF,ITF5,17,Basilicata
2021-06-09,UMB,8061,3907,4154,7340,721,ITI,ITI2,10,Umbria
2021-05-16,EMR,25845,12168,13677,18733,7112,ITH,ITH5,8,Emilia-Romagna
2021-06-23,UMB,11184,5713,5471,7789,3395,ITI,ITI2,10,Umbria
2021-01-27,CAL,1467,739,728,396,1071,ITF,ITF6,18,Calabria
2021-01-28,PUG,5474,2277,3197,471,5003,ITF,ITF4,16,Puglia
2021-01-12,ABR,1805,667,1138,1805,0,ITF,ITF1,13,Abruzzo
2021-03-18,CAM,12175,5380,6795,5986,6189,ITF,ITF3,15,Campania
2021-04-15,LAZ,31939,14310,17629,21126,10813,ITI,ITI4,12,Lazio
2021-01-31,BAS,77,24,53,0,77,ITF,ITF5,17,Basilicata
2021-02-22,EMR,7482,3091,4391,7210,272,ITH,ITH5,8,Emilia-Romagna
2021-03-15,UMB,4594,1938,2656,2828,1766,ITI,ITI2,10,Umbria
2021-06-23,SIC,43750,20352,23398,17566,26184,ITG,ITG1,19,Sicilia
2021-02-01,TOS,5509,1958,3551,521,4988,ITI,ITI1,9,Toscana
2021-05-25,ABR,11418,5324,6094,8281,3137,ITF,ITF1,13,Abruzzo
2021-06-26,LIG,7057,3286,3771,4446,2611,ITC,ITC3,7,Liguria
2021-02-10,LAZ,8191,3402,4789,4849,3342,ITI,ITI4,12,Lazio
2021-02-10,UMB,714,348,366,699,15,ITI,ITI2,10,Umbria
2021-03-13,PAT,834,383,451,786,48,ITH,ITH2,4,Provincia Autonoma Trento
2021-05-09,VEN,35035,16115,18920,24979,10056,ITH,ITH3,5,Veneto
2021-05-21,LAZ,51809,24861,26948,37860,13949,ITI,ITI4,12,Lazio
2021-05-31,MAR,11780,5942,5838,8851,2929,ITI,ITI3,11,Marche
2021-04-05,VDA,464,223,241,458,6,ITC,ITC2,2,Valle d'Aosta / Vallée d'Aoste
2021-06-04,LAZ,61425,29937,31488,43741,17684,ITI,ITI4,12,Lazio
2021-05-02,FVG,6898,3248,3650,3939,2959,ITH,ITH4,6,Friuli-Venezia Giulia
2021-02-20,PIE,3834,1254,2580,3660,174,ITC,ITC1,1,Piemonte
2021-05-17,MAR,11864,5572,6292,7689,4175,ITI,ITI3,11,Marche
2021-06-27,VDA,1250,607,643,322,928,ITC,ITC2,2,Valle d'Aosta / Vallée d'Aoste
2021-01-12,BAS,217,88,129,217,0,ITF,ITF5,17,Basilicata
2021-02-11,MOL,293,133,160,257,36,ITF,ITF2,14,Molise
2021-06-05,PAB,6068,3022,3046,4973,1095,ITH,ITH1,4,Provincia Autonoma Bolzano / Bozen
2021-03-04,LOM,29323,12111,17212,20258,9065,ITC,ITC4,3,Lombardia
2021-04-04,LIG,756,366,390,507,249,ITC,ITC3,7,Liguria
2021-04-23,PUG,29491,13707,15784,24235,5256,ITF,ITF4,16,Puglia
2021-01-31,ABR,1521,493,1028,288,1233,ITF,ITF1,13,Abruzzo
2021-05-04,LAZ,39870,18344,21526,26350,13520,ITI,ITI4,12,Lazio
2021-05-22,MOL,1316,712,604,1232,84,ITF,ITF2,14,Molise
2021-06-21,PAT,6131,3309,2822,3733,2398,ITH,ITH2,4,Provincia Autonoma Trento
2021-04-18,LIG,2613,1164,1449,2145,468,ITC,ITC3,7,Liguria
2021-05-16,FVG,9987,4779,5208,8588,1399,ITH,ITH4,6,Friuli-Venezia Giulia
2021-05-26,VEN,31077,15189,15888,14618,16459,ITH,ITH3,5,Veneto
2021-05-28,SAR,17949,8692,9257,13673,4276,ITG,ITG2,20,Sardegna
2021-05-10,ABR,10103,4780,5323,5454,4649,ITF,ITF1,13,Abruzzo
2021-02-17,SAR,1407,577,830,1333,74,ITG,ITG2,20,Sardegna
2021-04-30,PAB,3342,1594,1748,1566,1776,ITH,ITH1,4,Provincia Autonoma Bolzano / Bozen
2021-04-29,PIE,48476,21979,26497,35858,12618,ITC,ITC1,1,Piemonte
2021-05-25,SAR,15144,7706,7438,8668,6476,ITG,ITG2,20,Sardegna
2021-01-08,LIG,2927,999,1928,2927,0,ITC,ITC3,7,Liguria
2021-01-20,PAB,617,252,365,409,208,ITH,ITH1,4,Provincia Autonoma Bolzano / Bozen
2021-01-24,SIC,4316,2256,2060,134,4182,ITG,ITG1,19,Sicilia
2021-04-23,ABR,7382,3388,3994,5080,2302,ITF,ITF1,13,Abruzzo
2021-04-30,MAR,14091,6169,7922,5548,8543,ITI,ITI3,11,Marche
2021-01-06,PAB,59,18,41,59,0,ITH,ITH1,4,Provincia Autonoma Bolzano / Bozen
2021-02-14,CAL,468,214,254,438,30,ITF,ITF6,18,Calabria
2021-06-11,SAR,14771,7016,7755,9239,5532,ITG,ITG2,20,Sardegna
2021-06-30,LOM,101589,50283,51306,53636,47953,ITC,ITC4,3,Lombardia
2021-01-30,ABR,1511,568,943,69,1442,ITF,ITF1,13,Abruzzo
2021-03-01,VEN,9395,3716,5679,7573,1822,ITH,ITH3,5,Veneto
2021-04-05,CAM,11638,5542,6096,9214,2424,ITF,ITF3,15,Campania
2021-03-03,SAR,4120,2282,1838,2821,1299,ITG,ITG2,20,Sardegna
2021-03-22,LOM,40336,14302,26034,29779,10557,ITC,ITC4,3,Lombardia
2021-05-16,PIE,28145,12780,15365,15080,13065,ITC,ITC1,1,Piemonte
2021-05-25,CAL,16367,8000,8367,10289,6078,ITF,ITF6,18,Calabria
2021-04-08,LOM,52355,21761,30594,35896,16459,ITC,ITC4,3,Lombardia
2021-02-05,PIE,9604,3139,6465,659,8945,ITC,ITC1,1,Piemonte
2020-12-29,LOM,106,45,61,106,0,ITC,ITC4,3,Lombardia
2021-02-24,LAZ,12049,5209,6840,11055,994,ITI,ITI4,12,Lazio
2021-01-24,UMB,258,106,152,1,257,ITI,ITI2,10,Umbria
2021-05-04,SIC,26815,12468,14347,17524,9291,ITG,ITG1,19,Sicilia
2021-04-22,LOM,73895,33384,40511,57569,16326,ITC,ITC4,3,Lombardia
2021-03-17,CAM,11590,5100,6490,5009,6581,ITF,ITF3,15,Campania
2021-04-29,PAT,4642,2241,2401,4434,208,ITH,ITH2,4,Provincia Autonoma Trento
2021-05-10,BAS,4804,2382,2422,2762,2042,ITF,ITF5,17,Basilicata
2021-03-03,LOM,26971,11515,15456,19689,7282,ITC,ITC4,3,Lombardia
2021-04-27,TOS,10354,4916,5438,3867,6487,ITI,ITI1,9,Toscana
2021-06-18,FVG,10491,5122,5369,3232,7259,ITH,ITH4,6,Friuli-Venezia Giulia
2021-03-18,PUG,9476,4292,5184,3330,6146,ITF,ITF4,16,Puglia
2021-04-11,MAR,7117,3115,4002,6831,286,ITI,ITI3,11,Marche
2021-01-22,PAT,1673,434,1239,331,1342,ITH,ITH2,4,Provincia Autonoma Trento
2021-01-26,CAL,1835,873,962,277,1558,ITF,ITF6,18,Calabria
2021-03-10,FVG,3586,1698,1888,1792,1794,ITH,ITH4,6,Friuli-Venezia Giulia
2021-06-26,PUG,30886,15524,15362,15753,15133,ITF,ITF4,16,Puglia
2021-01-27,LIG,1744,603,1141,141,1603,ITC,ITC3,7,Liguria
2021-02-05,PAT,805,272,533,283,522,ITH,ITH2,4,Provincia Autonoma Trento
2021-02-24,FVG,2524,1088,1436,2506,18,ITH,ITH4,6,Friuli-Venezia Giulia
2021-03-29,LAZ,25220,11900,13320,18183,7037,ITI,ITI4,12,Lazio
2021-05-01,EMR,28402,12774,15628,15626,12776,ITH,ITH5,8,Emilia-Romagna
2021-03-10,VEN,19039,8727,10312,13356,5683,ITH,ITH3,5,Veneto
2021-02-05,PUG,5635,2273,3362,1333,4302,ITF,ITF4,16,Puglia
2021-03-12,SAR,5982,2623,3359,4674,1308,ITG,ITG2,20,Sardegna
2021-02-14,PIE,1476,498,978,876,600,ITC,ITC1,1,Piemonte
2021-05-16,PUG,24536,11063,13473,12708,11828,ITF,ITF4,16,Puglia
2021-02-24,CAL,1914,975,939,1436,478,ITF,ITF6,18,Calabria
2021-03-29,SIC,14999,7059,7940,10502,4497,ITG,ITG1,19,Sicilia
2021-04-15,CAM,34344,16664,17680,24442,9902,ITF,ITF3,15,Campania
2021-04-01,LOM,42964,17235,25729,26760,16204,ITC,ITC4,3,Lombardia
2021-02-15,TOS,8770,3376,5394,7944,826,ITI,ITI1,9,Toscana
2021-04-12,LAZ,23845,10748,13097,16945,6900,ITI,ITI4,12,Lazio
2021-07-02,PIE,42106,21126,20980,16754,25352,ITC,ITC1,1,Piemonte
2021-04-03,EMR,19940,8767,11173,16200,3740,ITH,ITH5,8,Emilia-Romagna
2021-03-07,ABR,2523,630,1893,2523,0,ITF,ITF1,13,Abruzzo
2021-05-30,EMR,27073,12791,14282,13380,13693,ITH,ITH5,8,Emilia-Romagna
2021-01-09,ABR,1484,566,918,1484,0,ITF,ITF1,13,Abruzzo
2021-02-19,EMR,7327,3010,4317,6813,514,ITH,ITH5,8,Emilia-Romagna
2021-04-16,VDA,599,261,338,597,2,ITC,ITC2,2,Valle d'Aosta / Vallée d'Aoste
2021-06-08,LAZ,66342,31618,34724,36561,29781,ITI,ITI4,12,Lazio
2020-12-31,EMR,2215,780,1435,2215,0,ITH,ITH5,8,Emilia-Romagna
2021-05-28,MAR,13952,6734,7218,9096,4856,ITI,ITI3,11,Marche
2021-06-06,EMR,36433,18926,17507,32027,4406,ITH,ITH5,8,Emilia-Romagna
2021-04-02,VDA,873,344,529,648,225,ITC,ITC2,2,Valle d'Aosta / Vallée d'Aoste
2021-05-18,UMB,7731,3349,4382,3894,3837,ITI,ITI2,10,Umbria
2021-02-26,EMR,9634,3673,5961,8586,1048,ITH,ITH5,8,Emilia-Romagna
2021-04-01,MAR,7578,3183,4395,4162,3416,ITI,ITI3,11,Marche
2021-06-25,FVG,10571,5320,5251,2062,8509,ITH,ITH4,6,Friuli-Venezia Giulia
2021-03-22,UMB,3560,1655,1905,2314,1246,ITI,ITI2,10,Umbria
2021-05-29,VDA,798,434,364,561,237,ITC,ITC2,2,Valle d'Aosta / Vallée d'Aoste
2021-06-16,PUG,41340,20338,21002,27005,14335,ITF,ITF4,16,Puglia
2021-04-05,UMB,4248,1728,2520,2193,2055,ITI,ITI2,10,Umbria
2021-04-06,MOL,1494,701,793,1151,343,ITF,ITF2,14,Molise
2021-07-02,PAT,6385,3492,2893,3302,3083,ITH,ITH2,4,Provincia Autonoma Trento
2021-02-22,TOS,9818,4253,5565,9541,277,ITI,ITI1,9,Toscana
2021-02-07,UMB,54,17,37,1,53,ITI,ITI2,10,Umbria
2021-02-08,MOL,334,141,193,216,118,ITF,ITF2,14,Molise
2021-05-19,MOL,2341,1205,1136,1916,425,ITF,ITF2,14,Molise
2021-06-01,SIC,38757,17629,21128,24968,13789,ITG,ITG1,19,Sicilia
2020-12-30,PAB,388,182,206,388,0,ITH,ITH1,4,Provincia Autonoma Bolzano / Bozen
2021-03-03,CAL,5053,2759,2294,3973,1080,ITF,ITF6,18,Calabria
2021-02-21,BAS,284,113,171,284,0,ITF,ITF5,17,Basilicata
2021-03-23,MOL,1642,694,948,1435,207,ITF,ITF2,14,Molise
2021-04-05,SIC,8013,3954,4059,6573,1440,ITG,ITG1,19,Sicilia
2021-01-15,PAT,597,132,465,597,0,ITH,ITH2,4,Provincia Autonoma Trento
2021-02-17,LIG,2689,1182,1507,2263,426,ITC,ITC3,7,Liguria
2021-03-17,FVG,3236,1267,1969,745,2491,ITH,ITH4,6,Friuli-Venezia Giulia
2021-03-07,BAS,889,309,580,851,38,ITF,ITF5,17,Basilicata
2021-07-01,MOL,2647,1288,1359,277,2370,ITF,ITF2,14,Molise
2021-05-13,FVG,11146,5372,5774,9088,2058,ITH,ITH4,6,Friuli-Venezia Giulia
2021-05-28,LIG,16279,8128,8151,11744,4535,ITC,ITC3,7,Liguria
2020-12-30,PUG,1,0,1,1,0,ITF,ITF4,16,Puglia
2021-01-09,BAS,557,160,397,557,0,ITF,ITF5,17,Basilicata
2021-01-05,LIG,2878,895,1983,2878,0,ITC,ITC3,7,Liguria
2021-06-09,PAB,3789,1884,1905,1315,2474,ITH,ITH1,4,Provincia Autonoma Bolzano / Bozen
2021-02-26,VEN,8294,3270,5024,7036,1258,ITH,ITH3,5,Veneto
2021-01-09,LAZ,6298,2562,3736,6298,0,ITI,ITI4,12,Lazio
2021-03-01,PAB,922,221,701,921,1,ITH,ITH1,4,Provincia Autonoma Bolzano / Bozen
2021-04-24,VEN,24750,10825,13925,15670,9080,ITH,ITH3,5,Veneto
2021-05-07,ABR,12199,5711,6488,7786,4413,ITF,ITF1,13,Abruzzo
2021-02-16,FVG,2516,1135,1381,2400,116,ITH,ITH4,6,Friuli-Venezia Giulia
2021-03-03,LIG,4581,1847,2734,3554,1027,ITC,ITC3,7,Liguria
2021-04-12,SAR,6998,3184,3814,5281,1717,ITG,ITG2,20,Sardegna
2021-01-02,SAR,60,21,39,60,0,ITG,ITG2,20,Sardegna
2021-03-15,PAB,1192,451,741,710,482,ITH,ITH1,4,Provincia Autonoma Bolzano / Bozen
2021-05-13,PIE,35685,17527,18158,20567,15118,ITC,ITC1,1,Piemonte
2021-06-08,SAR,14823,7067,7756,11320,3503,ITG,ITG2,20,Sardegna
2021-04-22,MAR,10797,4931,5866,9219,1578,ITI,ITI3,11,Marche
2021-05-20,PAT,5013,2357,2656,3378,1635,ITH,ITH2,4,Provincia Autonoma Trento
2021-02-02,PIE,10242,3509,6733,816,9426,ITC,ITC1,1,Piemonte
2021-02-28,SAR,368,169,199,142,226,ITG,ITG2,20,Sardegna
2021-02-24,MAR,3520,1537,1983,3442,78,ITI,ITI3,11,Marche
2021-03-24,PAT,2376,940,1436,1556,820,ITH,ITH2,4,Provincia Autonoma Trento
2021-07-03,BAS,3553,1795,1758,2410,1143,ITF,ITF5,17,Basilicata
2021-03-22,PUG,9943,5107,4836,4297,5646,ITF,ITF4,16,Puglia
2021-03-31,PIE,19110,8104,11006,10416,8694,ITC,ITC1,1,Piemonte
2021-04-19,LAZ,30103,13681,16422,19422,10681,ITI,ITI4,12,Lazio
2021-04-26,SAR,6824,3266,3558,5948,876,ITG,ITG2,20,Sardegna
2021-04-27,PAB,2226,1013,1213,1149,1077,ITH,ITH1,4,Provincia Autonoma Bolzano / Bozen
2021-01-14,VEN,7063,1924,5139,7063,0,ITH,ITH3,5,Veneto
2021-01-17,PAB,2328,1044,1284,2317,11,ITH,ITH1,4,Provincia Autonoma Bolzano / Bozen
2021-01-24,PUG,1670,750,920,154,1516,ITF,ITF4,16,Puglia
2021-02-21,LAZ,6989,3180,3809,6526,463,ITI,ITI4,12,Lazio
2021-02-25,VDA,201,101,100,194,7,ITC,ITC2,2,Valle d'Aosta / Vallée d'Aoste
2021-05-27,PIE,37392,17392,20000,19255,18137,ITC,ITC1,1,Piemonte
2021-06-23,PAB,1133,584,549,369,764,ITH,ITH1,4,Provincia Autonoma Bolzano / Bozen
2021-06-30,PUG,44350,21536,22814,17875,26475,ITF,ITF4,16,Puglia
2021-02-09,PAT,918,287,631,443,475,ITH,ITH2,4,Provincia Autonoma Trento
2021-03-12,VEN,18657,8194,10463,11909,6748,ITH,ITH3,5,Veneto
2021-06-01,LOM,93939,46093,47846,76851,17088,ITC,ITC4,3,Lombardia
2021-01-02,LOM,200,72,128,200,0,ITC,ITC4,3,Lombardia
2021-02-16,PIE,3967,1756,2211,3209,758,ITC,ITC1,1,Piemonte
2021-06-08,LOM,102347,52025,50322,88315,14032,ITC,ITC4,3,Lombardia
2021-06-29,CAL,12750,5862,6888,5129,7621,ITF,ITF6,18,Calabria
2021-03-15,PUG,12335,6144,6191,5832,6503,ITF,ITF4,16,Puglia
2021-06-22,CAM,51304,24434,26870,12314,38990,ITF,ITF3,15,Campania
2021-02-28,LOM,7884,3254,4630,7674,210,ITC,ITC4,3,Lombardia
2021-05-03,CAL,14765,6768,7997,10548,4217,ITF,ITF6,18,Calabria
2021-01-17,PUG,1308,590,718,1239,69,ITF,ITF4,16,Puglia
2021-03-14,CAM,8618,3827,4791,4478,4140,ITF,ITF3,15,Campania
2021-06-23,PUG,28730,14044,14686,17038,11692,ITF,ITF4,16,Puglia
2021-02-15,MOL,144,70,74,141,3,ITF,ITF2,14,Molise
2021-03-17,PAT,2071,792,1279,1200,871,ITH,ITH2,4,Provincia Autonoma Trento
2021-04-26,LOM,87946,40923,47023,68783,19163,ITC,ITC4,3,Lombardia
2021-04-27,PUG,26671,12068,14603,21068,5603,ITF,ITF4,16,Puglia
2021-05-07,BAS,4649,2284,2365,3295,1354,ITF,ITF5,17,Basilicata
2021-05-10,CAM,35467,16390,19077,25541,9926,ITF,ITF3,15,Campania
2021-06-04,MAR,14332,7287,7045,11894,2438,ITI,ITI3,11,Marche
2021-03-21,CAL,4455,1923,2532,2736,1719,ITF,ITF6,18,Calabria
2021-04-08,MAR,8686,3803,4883,8341,345,ITI,ITI3,11,Marche
2021-04-12,SIC,18840,9139,9701,11589,7251,ITG,ITG1,19,Sicilia
2021-05-08,TOS,29151,13113,16038,13679,15472,ITI,ITI1,9,Toscana
2021-03-24,FVG,3972,1716,2256,2492,1480,ITH,ITH4,6,Friuli-Venezia Giulia
2021-03-25,ABR,5793,2662,3131,3176,2617,ITF,ITF1,13,Abruzzo
2021-02-14,SIC,1055,402,653,915,140,ITG,ITG1,19,Sicilia
2021-03-12,TOS,16975,6613,10362,13447,3528,ITI,ITI1,9,Toscana
2021-04-28,EMR,33715,15588,18127,20827,12888,ITH,ITH5,8,Emilia-Romagna
2021-01-27,ABR,1364,515,849,39,1325,ITF,ITF1,13,Abruzzo
2021-05-20,FVG,12694,6305,6389,10179,2515,ITH,ITH4,6,Friuli-Venezia Giulia
2021-06-08,CAM,51505,25069,26436,44512,6993,ITF,ITF3,15,Campania
2021-07-03,ABR,10087,5077,5010,3547,6540,ITF,ITF1,13,Abruzzo
2021-01-14,TOS,3255,1179,2076,3255,0,ITI,ITI1,9,Toscana
2021-03-07,CAL,3392,1731,1661,3300,92,ITF,ITF6,18,Calabria
2021-06-20,TOS,25144,12457,12687,15657,9487,ITI,ITI1,9,Toscana
2021-06-24,EMR,39328,19648,19680,19798,19530,ITH,ITH5,8,Emilia-Romagna
2021-06-05,UMB,8221,3775,4446,5567,2654,ITI,ITI2,10,Umbria
2021-01-02,SIC,4846,2524,2322,4846,0,ITG,ITG1,19,Sicilia
2021-04-24,TOS,13434,6168,7266,5991,7443,ITI,ITI1,9,Toscana
2021-06-15,CAL,9584,4434,5150,6260,3324,ITF,ITF6,18,Calabria
2021-01-26,FVG,1977,647,1330,217,1760,ITH,ITH4,6,Friuli-Venezia Giulia
2021-04-26,CAM,34031,16648,17383,28409,5622,ITF,ITF3,15,Campania
2021-05-21,ABR,13016,6327,6689,8037,4979,ITF,ITF1,13,Abruzzo
2021-04-17,VEN,22418,9084,13334,15143,7275,ITH,ITH3,5,Veneto
2021-02-24,LIG,3764,1560,2204,3506,258,ITC,ITC3,7,Liguria
2021-04-20,PAB,1562,784,778,1560,2,ITH,ITH1,4,Provincia Autonoma Bolzano / Bozen
2021-01-07,VEN,8360,2318,6042,8360,0,ITH,ITH3,5,Veneto
2021-06-13,VEN,36894,19048,17846,29931,6963,ITH,ITH3,5,Veneto
2020-12-29,LIG,125,33,92,125,0,ITC,ITC3,7,Liguria
2021-01-10,PAB,2,2,0,2,0,ITH,ITH1,4,Provincia Autonoma Bolzano / Bozen
2021-06-16,PAB,3812,2018,1794,9,3803,ITH,ITH1,4,Provincia Autonoma Bolzano / Bozen
2021-03-18,ABR,3896,1651,2245,2065,1831,ITF,ITF1,13,Abruzzo
2021-01-12,LIG,2469,887,1582,2469,0,ITC,ITC3,7,Liguria
2021-02-09,FVG,1842,555,1287,1556,286,ITH,ITH4,6,Friuli-Venezia Giulia
2021-06-01,SAR,14318,6653,7665,9728,4590,ITG,ITG2,20,Sardegna
2021-06-26,ABR,9855,4924,4931,5661,4194,ITF,ITF1,13,Abruzzo
2021-02-21,SAR,1589,710,879,1559,30,ITG,ITG2,20,Sardegna
2021-04-22,LIG,13851,6208,7643,8776,5075,ITC,ITC3,7,Liguria
2021-01-21,VEN,2293,719,1574,21,2272,ITH,ITH3,5,Veneto
2021-02-02,PAT,910,240,670,191,719,ITH,ITH2,4,Provincia Autonoma Trento
2021-03-03,MAR,6693,3070,3623,5809,884,ITI,ITI3,11,Marche
2021-01-06,VDA,65,33,32,65,0,ITC,ITC2,2,Valle d'Aosta / Vallée d'Aoste
2021-04-19,SAR,10196,4622,5574,8766,1430,ITG,ITG2,20,Sardegna
2021-01-05,MAR,1575,590,985,1575,0,ITI,ITI3,11,Marche
2021-05-13,PAT,3407,1580,1827,2305,1102,ITH,ITH2,4,Provincia Autonoma Trento
2021-05-14,BAS,5907,2799,3108,3376,2531,ITF,ITF5,17,Basilicata
2021-01-09,SAR,4026,1417,2609,4026,0,ITG,ITG2,20,Sardegna
2021-02-14,LAZ,5777,2372,3405,5306,471,ITI,ITI4,12,Lazio
2021-03-24,PIE,15540,6373,9167,6413,9127,ITC,ITC1,1,Piemonte
2021-06-15,SAR,14659,6786,7873,9928,4731,ITG,ITG2,20,Sardegna
2021-03-05,VEN,13336,5020,8316,9666,3670,ITH,ITH3,5,Veneto
2021-02-18,VDA,349,153,196,261,88,ITC,ITC2,2,Valle d'Aosta / Vallée d'Aoste
2021-02-28,LAZ,10263,4017,6246,9748,515,ITI,ITI4,12,Lazio
2021-03-07,SAR,1658,751,907,1117,541,ITG,ITG2,20,Sardegna
2021-03-08,PAB,1210,534,676,1183,27,ITH,ITH1,4,Provincia Autonoma Bolzano / Bozen
2021-05-20,PIE,38624,17938,20686,13680,24944,ITC,ITC1,1,Piemonte
2021-03-31,PAT,2585,983,1602,1727,858,ITH,ITH2,4,Provincia Autonoma Trento
2021-04-12,LOM,47242,20582,26660,32901,14341,ITC,ITC4,3,Lombardia
2021-01-02,LAZ,6708,2631,4077,6708,0,ITI,ITI4,12,Lazio
2021-02-09,PIE,7392,2316,5076,722,6670,ITC,ITC1,1,Piemonte
2021-05-04,PAB,3449,1843,1606,2412,1037,ITH,ITH1,4,Provincia Autonoma Bolzano / Bozen
2021-05-11,PUG,32549,14356,18193,14130,18419,ITF,ITF4,16,Puglia
2021-03-07,CAM,11973,5404,6569,8130,3843,ITF,ITF3,15,Campania
2021-05-04,PUG,35033,14815,20218,18583,16450,ITF,ITF4,16,Puglia
2021-02-21,LOM,5053,1864,3189,5036,17,ITC,ITC4,3,Lombardia
2021-02-22,MOL,265,129,136,250,15,ITF,ITF2,14,Molise
2021-03-14,CAL,2709,1053,1656,2284,425,ITF,ITF6,18,Calabria
2021-04-07,PIE,23611,9999,13612,18150,5461,ITC,ITC1,1,Piemonte
2021-03-08,PUG,14988,6435,8553,12588,2400,ITF,ITF4,16,Puglia
2021-05-03,CAM,40777,19898,20879,28920,11857,ITF,ITF3,15,Campania
2020-12-27,MOL,50,20,30,50,0,ITF,ITF2,14,Molise
2021-04-19,LOM,60121,27350,32771,50716,9405,ITC,ITC4,3,Lombardia
2021-06-22,CAL,14223,6705,7518,7140,7083,ITF,ITF6,18,Calabria
2021-03-18,BAS,1350,564,786,25,1325,ITF,ITF5,17,Basilicata
2021-04-15,MAR,10376,4674,5702,9811,565,ITI,ITI3,11,Marche
2021-06-29,CAM,47647,23098,24549,18883,28764,ITF,ITF3,15,Campania
2021-01-26,PAT,543,154,389,27,516,ITH,ITH2,4,Provincia Autonoma Trento
2021-06-15,LOM,95457,48573,46884,49603,45854,ITC,ITC4,3,Lombardia
2021-02-17,MAR,1821,696,1125,1704,117,ITI,ITI3,11,Marche
2021-06-26,BAS,3284,1586,1698,2728,556,ITF,ITF5,17,Basilicata
2021-05-06,PAT,5531,2739,2792,4751,780,ITH,ITH2,4,Provincia Autonoma Trento
2021-05-10,CAL,13120,6087,7033,7722,5398,ITF,ITF6,18,Calabria
2021-02-02,FVG,2467,806,1661,217,2250,ITH,ITH4,6,Friuli-Venezia Giulia
2021-06-17,EMR,45784,23134,22650,21658,24126,ITH,ITH5,8,Emilia-Romagna
2021-06-27,TOS,33296,16073,17223,6057,27239,ITI,ITI1,9,Toscana
2021-03-31,FVG,8114,3559,4555,7268,846,ITH,ITH4,6,Friuli-Venezia Giulia
2021-05-14,ABR,10593,5069,5524,5446,5147,ITF,ITF1,13,Abruzzo
2021-05-01,TOS,23316,10065,13251,14135,9181,ITI,ITI1,9,Toscana
2021-03-05,TOS,16878,6688,10190,12124,4754,ITI,ITI1,9,Toscana
2021-04-26,CAL,10187,5060,5127,7768,2419,ITF,ITF6,18,Calabria
2021-04-01,ABR,5591,2505,3086,3504,2087,ITF,ITF1,13,Abruzzo
2021-02-12,LOM,13964,4366,9598,9029,4935,ITC,ITC4,3,Lombardia
2021-02-19,LAZ,10043,5078,4965,9212,831,ITI,ITI4,12,Lazio
2021-06-17,ABR,10743,5379,5364,7301,3442,ITF,ITF1,13,Abruzzo
2021-04-10,LOM,52735,21836,30899,40780,11955,ITC,ITC4,3,Lombardia
2021-06-06,LOM,89824,46176,43648,80603,9221,ITC,ITC4,3,Lombardia
2021-01-07,LOM,11759,3636,8123,11759,0,ITC,ITC4,3,Lombardia
2021-03-03,TOS,18228,6538,11690,14622,3606,ITI,ITI1,9,Toscana
2021-06-04,MOL,3037,1490,1547,2595,442,ITF,ITF2,14,Molise
2021-01-18,BAS,463,157,306,364,99,ITF,ITF5,17,Basilicata
2021-01-05,TOS,5249,1755,3494,5249,0,ITI,ITI1,9,Toscana
2021-04-08,MOL,1766,903,863,1564,202,ITF,ITF2,14,Molise
2021-06-10,SIC,51138,24016,27122,44051,7087,ITG,ITG1,19,Sicilia
2021-01-15,PUG,4551,1866,2685,4551,0,ITF,ITF4,16,Puglia
2021-04-19,EMR,20900,9797,11103,14627,6273,ITH,ITH5,8,Emilia-Romagna
2021-01-31,PAT,76,16,60,1,75,ITH,ITH2,4,Provincia Autonoma Trento
2021-03-31,UMB,3897,1728,2169,2211,1686,ITI,ITI2,10,Umbria
2021-01-09,EMR,9988,3452,6536,9988,0,ITH,ITH5,8,Emilia-Romagna
2021-06-15,EMR,43073,22193,20880,28048,15025,ITH,ITH5,8,Emilia-Romagna
2021-03-16,BAS,1908,802,1106,229,1679,ITF,ITF5,17,Basilicata
2021-03-07,EMR,7839,2958,4881,6319,1520,ITH,ITH5,8,Emilia-Romagna
2021-02-16,UMB,1308,655,653,1299,9,ITI,ITI2,10,Umbria
2021-05-27,SIC,47423,21780,25643,24843,22580,ITG,ITG1,19,Sicilia
2021-05-03,EMR,28698,13557,15141,17820,10878,ITH,ITH5,8,Emilia-Romagna
2021-01-07,CAM,8911,4167,4744,8911,0,ITF,ITF3,15,Campania
2021-05-27,UMB,9964,4864,5100,8646,1318,ITI,ITI2,10,Umbria
2021-01-19,TOS,1105,532,573,1105,0,ITI,ITI1,9,Toscana
2021-03-12,CAL,5161,2475,2686,4099,1062,ITF,ITF6,18,Calabria
2021-01-04,UMB,809,398,411,809,0,ITI,ITI2,10,Umbria
2021-03-05,CAM,16812,6665,10147,10149,6663,ITF,ITF3,15,Campania
2021-04-14,SIC,20108,9718,10390,11413,8695,ITG,ITG1,19,Sicilia
2021-01-14,CAL,2641,1252,1389,2641,0,ITF,ITF6,18,Calabria
2021-04-14,UMB,8147,3678,4469,6168,1979,ITI,ITI2,10,Umbria
2021-05-29,FVG,12015,5844,6171,7028,4987,ITH,ITH4,6,Friuli-Venezia Giulia
2021-06-17,LAZ,66355,31827,34528,32189,34166,ITI,ITI4,12,Lazio
2021-01-15,PAB,3282,1228,2054,3282,0,ITH,ITH1,4,Provincia Autonoma Bolzano / Bozen
2021-04-21,LAZ,33038,15014,18024,20663,12375,ITI,ITI4,12,Lazio
2021-01-07,LIG,3229,1095,2134,3229,0,ITC,ITC3,7,Liguria
2021-06-13,LIG,5616,2695,2921,5162,454,ITC,ITC3,7,Liguria
2021-04-17,LIG,7382,3216,4166,6632,750,ITC,ITC3,7,Liguria
2021-01-07,SAR,3113,1077,2036,3113,0,ITG,ITG2,20,Sardegna
2021-04-18,VDA,522,254,268,518,4,ITC,ITC2,2,Valle d'Aosta / Vallée d'Aoste
2021-06-22,VEN,43169,21335,21834,18857,24312,ITH,ITH3,5,Veneto
2021-07-04,PAT,91,53,38,5,86,ITH,ITH2,4,Provincia Autonoma Trento
2021-04-17,MAR,11701,5315,6386,10628,1073,ITI,ITI3,11,Marche
2021-05-01,LIG,7142,3256,3886,1342,5800,ITC,ITC3,7,Liguria
2021-02-07,PIE,3089,974,2115,445,2644,ITC,ITC1,1,Piemonte
2021-06-14,VDA,306,163,143,12,294,ITC,ITC2,2,Valle d'Aosta / Vallée d'Aoste
2021-03-05,LIG,4869,2150,2719,3737,1132,ITC,ITC3,7,Liguria
2021-06-10,SAR,17804,8477,9327,11769,6035,ITG,ITG2,20,Sardegna
2021-02-19,LOM,14218,5400,8818,13495,723,ITC,ITC4,3,Lombardia
2021-04-22,MOL,1845,864,981,1066,779,ITF,ITF2,14,Molise
2021-05-31,VDA,880,396,484,501,379,ITC,ITC2,2,Valle d'Aosta / Vallée d'Aoste
2021-04-17,LOM,48508,21301,27207,37669,10839,ITC,ITC4,3,Lombardia
2021-04-26,VEN,20715,9453,11262,15577,5138,ITH,ITH3,5,Veneto
2021-06-18,PAB,4053,2108,1945,1154,2899,ITH,ITH1,4,Provincia Autonoma Bolzano / Bozen
2021-06-03,LAZ,56319,28487,27832,38632,17687,ITI,ITI4,12,Lazio
2021-06-13,MAR,10493,5442,5051,9200,1293,ITI,ITI3,11,Marche
2020-12-27,MAR,204,99,105,204,0,ITI,ITI3,11,Marche
2021-05-05,BAS,4334,2048,2286,3444,890,ITF,ITF5,17,Basilicata
2021-02-17,MOL,72,32,40,57,15,ITF,ITF2,14,Molise
2021-02-26,LOM,18395,7554,10841,16522,1873,ITC,ITC4,3,Lombardia
2021-03-09,BAS,1401,714,687,795,606,ITF,ITF5,17,Basilicata
2021-04-21,SIC,22369,10740,11629,16261,6108,ITG,ITG1,19,Sicilia
2021-01-21,CAL,965,449,516,934,31,ITF,ITF6,18,Calabria
2021-01-22,PUG,1409,578,831,991,418,ITF,ITF4,16,Puglia
2021-05-28,MOL,2648,1363,1285,2101,547,ITF,ITF2,14,Molise
2021-02-28,EMR,6819,2527,4292,4974,1845,ITH,ITH5,8,Emilia-Romagna
2021-01-25,BAS,1024,429,595,74,950,ITF,ITF5,17,Basilicata
2021-04-26,EMR,27901,12936,14965,18580,9321,ITH,ITH5,8,Emilia-Romagna
2021-04-07,SIC,15484,7616,7868,8364,7120,ITG,ITG1,19,Sicilia
2021-06-03,UMB,9031,4463,4568,8746,285,ITI,ITI2,10,Umbria
2021-01-16,EMR,5628,1718,3910,5628,0,ITH,ITH5,8,Emilia-Romagna
2021-04-07,UMB,5571,2292,3279,3567,2004,ITI,ITI2,10,Umbria
2021-02-01,ABR,1632,573,1059,271,1361,ITF,ITF1,13,Abruzzo
2021-03-14,EMR,8801,3839,4962,5004,3797,ITH,ITH5,8,Emilia-Romagna
2021-01-11,BAS,183,66,117,183,0,ITF,ITF5,17,Basilicata
2021-01-14,CAM,7074,2978,4096,7074,0,ITF,ITF3,15,Campania
2021-02-23,UMB,1691,657,1034,1649,42,ITI,ITI2,10,Umbria
2021-06-03,SIC,45762,20983,24779,34254,11508,ITG,ITG1,19,Sicilia
2021-01-12,TOS,3581,1398,2183,3581,0,ITI,ITI1,9,Toscana
2021-01-08,PAB,1521,479,1042,1521,0,ITH,ITH1,4,Provincia Autonoma Bolzano / Bozen
2021-06-06,LIG,3818,2033,1785,2948,870,ITC,ITC3,7,Liguria
2021-06-10,LAZ,71335,33611,37724,37666,33669,ITI,ITI4,12,Lazio
2021-03-23,ABR,4832,2187,2645,2266,2566,ITF,ITF1,13,Abruzzo
2021-04-24,LIG,8218,3795,4423,5067,3151,ITC,ITC3,7,Liguria
2021-05-22,FVG,11572,5197,6375,7336,4236,ITH,ITH4,6,Friuli-Venezia Giulia
2020-12-31,SAR,32,16,16,32,0,ITG,ITG2,20,Sardegna
2021-04-25,VDA,849,408,441,710,139,ITC,ITC2,2,Valle d'Aosta / Vallée d'Aoste
2021-01-25,ABR,1604,632,972,17,1587,ITF,ITF1,13,Abruzzo
2021-02-26,LIG,3765,1523,2242,3436,329,ITC,ITC3,7,Liguria
2021-06-21,VDA,1122,600,522,617,505,ITC,ITC2,2,Valle d'Aosta / Vallée d'Aoste
2021-06-07,VDA,710,347,363,649,61,ITC,ITC2,2,Valle d'Aosta / Vallée d'Aoste
2021-06-06,MAR,12388,6104,6284,10811,1577,ITI,ITI3,11,Marche
2021-06-20,LIG,1257,618,639,982,275,ITC,ITC3,7,Liguria
2021-02-27,VDA,231,85,146,124,107,ITC,ITC2,2,Valle d'Aosta / Vallée d'Aoste
2021-04-14,LAZ,29312,13286,16026,19189,10123,ITI,ITI4,12,Lazio
2021-06-11,MOL,3442,1654,1788,2014,1428,ITF,ITF2,14,Molise
2021-06-10,ABR,12555,6244,6311,10393,2162,ITF,ITF1,13,Abruzzo
2021-01-05,EMR,9361,3170,6191,9361,0,ITH,ITH5,8,Emilia-Romagna
2021-06-02,MAR,11898,5937,5961,11221,677,ITI,ITI3,11,Marche
2021-01-28,BAS,906,402,504,119,787,ITF,ITF5,17,Basilicata
2021-01-15,TOS,3878,1347,2531,3878,0,ITI,ITI1,9,Toscana
2021-01-26,UMB,815,389,426,17,798,ITI,ITI2,10,Umbria
2021-04-18,MOL,1083,483,600,149,934,ITF,ITF2,14,Molise
2021-06-20,FVG,6464,3200,3264,1535,4929,ITH,ITH4,6,Friuli-Venezia Giulia
2021-06-27,CAL,8228,3847,4381,4833,3395,ITF,ITF6,18,Calabria
2021-06-28,PUG,47303,22965,24338,21663,25640,ITF,ITF4,16,Puglia
2021-03-21,VDA,355,165,190,355,0,ITC,ITC2,2,Valle d'Aosta / Vallée d'Aoste
2021-04-29,EMR,44952,21134,23818,27403,17549,ITH,ITH5,8,Emilia-Romagna
2021-01-19,EMR,2046,505,1541,2029,17,ITH,ITH5,8,Emilia-Romagna
2021-02-22,MAR,3447,1522,1925,3372,75,ITI,ITI3,11,Marche
2021-02-12,UMB,670,224,446,664,6,ITI,ITI2,10,Umbria
2021-02-22,PAT,745,259,486,661,84,ITH,ITH2,4,Provincia Autonoma Trento
2021-04-04,MOL,253,141,112,238,15,ITF,ITF2,14,Molise
2021-02-26,UMB,660,253,407,652,8,ITI,ITI2,10,Umbria
2021-03-29,FVG,7020,3125,3895,5439,1581,ITH,ITH4,6,Friuli-Venezia Giulia
2021-06-06,SIC,49502,23908,25594,41681,7821,ITG,ITG1,19,Sicilia
2021-06-29,VDA,779,389,390,238,541,ITC,ITC2,2,Valle d'Aosta / Vallée d'Aoste
2021-01-29,SAR,2956,1070,1886,48,2908,ITG,ITG2,20,Sardegna
2021-03-18,MOL,1156,476,680,692,464,ITF,ITF2,14,Molise
2021-01-03,PIE,3063,967,2096,3063,0,ITC,ITC1,1,Piemonte
2021-03-28,PAB,569,212,357,11,558,ITH,ITH1,4,Provincia Autonoma Bolzano / Bozen
2021-06-26,MOL,3118,1528,1590,537,2581,ITF,ITF2,14,Molise
2021-05-23,LIG,2305,1119,1186,1182,1123,ITC,ITC3,7,Liguria
2021-01-14,BAS,969,413,556,969,0,ITF,ITF5,17,Basilicata
2021-02-26,SIC,11882,5810,6072,10202,1680,ITG,ITG1,19,Sicilia
2021-06-18,TOS,30737,16205,14532,25373,5364,ITI,ITI1,9,Toscana
2021-04-22,VEN,32001,13919,18082,16256,15745,ITH,ITH3,5,Veneto
2021-01-28,ABR,1433,495,938,12,1421,ITF,ITF1,13,Abruzzo
2021-03-01,LIG,3527,1444,2083,3404,123,ITC,ITC3,7,Liguria
2021-04-03,CAL,9360,4051,5309,4553,4807,ITF,ITF6,18,Calabria
2021-05-06,SIC,29348,13960,15388,18520,10828,ITG,ITG1,19,Sicilia
2021-05-23,CAM,58744,28638,30106,37849,20895,ITF,ITF3,15,Campania
2021-05-01,LAZ,37953,17083,20870,25990,11963,ITI,ITI4,12,Lazio
2021-05-09,LOM,69707,32884,36823,56440,13267,ITC,ITC4,3,Lombardia
2021-06-09,LIG,18668,9377,9291,12112,6556,ITC,ITC3,7,Liguria
2021-02-12,CAM,6531,2861,3670,6343,188,ITF,ITF3,15,Campania
2021-04-07,BAS,1211,551,660,1174,37,ITF,ITF5,17,Basilicata
2021-01-29,LOM,13486,4127,9359,686,12800,ITC,ITC4,3,Lombardia
2021-04-17,LAZ,32362,14204,18158,20387,11975,ITI,ITI4,12,Lazio
2021-05-18,PAT,4252,2010,2242,3407,845,ITH,ITH2,4,Provincia Autonoma Trento
2021-03-29,EMR,21424,9613,11811,16774,4650,ITH,ITH5,8,Emilia-Romagna
2021-03-29,PIE,15186,6405,8781,8574,6612,ITC,ITC1,1,Piemonte
2021-01-11,ABR,1553,557,996,1553,0,ITF,ITF1,13,Abruzzo
2021-05-06,UMB,9451,4313,5138,6137,3314,ITI,ITI2,10,Umbria
2021-06-10,VDA,1002,558,444,960,42,ITC,ITC2,2,Valle d'Aosta / Vallée d'Aoste
2021-03-25,TOS,23893,10376,13517,15542,8351,ITI,ITI1,9,Toscana
2021-01-29,CAM,10053,4812,5241,47,10006,ITF,ITF3,15,Campania
2021-03-02,VDA,339,166,173,336,3,ITC,ITC2,2,Valle d'Aosta / Vallée d'Aoste
2021-04-21,ABR,6388,3100,3288,4714,1674,ITF,ITF1,13,Abruzzo
2021-01-28,CAL,2255,1121,1134,83,2172,ITF,ITF6,18,Calabria
2021-04-25,BAS,2986,1457,1529,2934,52,ITF,ITF5,17,Basilicata
2021-05-09,PUG,30649,12562,18087,15035,15614,ITF,ITF4,16,Puglia
2021-06-13,LOM,75238,40182,35056,73114,2124,ITC,ITC4,3,Lombardia
2021-01-28,SAR,2972,1046,1926,69,2903,ITG,ITG2,20,Sardegna
2021-04-12,PIE,22952,10368,12584,19962,2990,ITC,ITC1,1,Piemonte
2021-04-12,TOS,2612,1183,1429,1958,654,ITI,ITI1,9,Toscana
2021-06-27,CAM,42293,20817,21476,13230,29063,ITF,ITF3,15,Campania
2021-02-21,EMR,4450,1708,2742,4010,440,ITH,ITH5,8,Emilia-Romagna
2021-03-05,LOM,28944,11938,17006,20527,8417,ITC,ITC4,3,Lombardia
2021-03-27,MAR,7382,3075,4307,5022,2360,ITI,ITI3,11,Marche
2021-05-08,CAL,18432,8384,10048,10606,7826,ITF,ITF6,18,Calabria
2021-01-02,PIE,3545,1134,2411,3545,0,ITC,ITC1,1,Piemonte
2021-03-19,CAM,11143,4973,6170,7270,3873,ITF,ITF3,15,Campania
2021-02-10,MOL,151,79,72,131,20,ITF,ITF2,14,Molise
2021-03-12,PAT,2518,940,1578,1712,806,ITH,ITH2,4,Provincia Autonoma Trento
2021-04-10,MAR,10915,4620,6295,10602,313,ITI,ITI3,11,Marche
2021-05-22,CAL,22173,10552,11621,14322,7851,ITF,ITF6,18,Calabria
2021-01-03,MAR,907,354,553,907,0,ITI,ITI3,11,Marche
2021-04-22,PUG,23012,10534,12478,18094,4918,ITF,ITF4,16,Puglia
2021-05-12,BAS,4724,2327,2397,2842,1882,ITF,ITF5,17,Basilicata
2021-05-21,MOL,2099,1052,1047,1777,322,ITF,ITF2,14,Molise
2021-06-20,PAT,1869,1034,835,32,1837,ITH,ITH2,4,Provincia Autonoma Trento
2021-06-27,LOM,86567,44598,41969,67750,18817,ITC,ITC4,3,Lombardia
2021-03-19,LOM,32429,12916,19513,19229,13200,ITC,ITC4,3,Lombardia
2021-05-13,TOS,35035,15449,19586,13839,21196,ITI,ITI1,9,Toscana
2021-01-27,MOL,674,251,423,8,666,ITF,ITF2,14,Molise
2021-03-31,SIC,14449,6692,7757,9517,4932,ITG,ITG1,19,Sicilia
2021-05-15,FVG,12656,6104,6552,7958,4698,ITH,ITH4,6,Friuli-Venezia Giulia
2021-06-28,ABR,9804,4705,5099,5233,4571,ITF,ITF1,13,Abruzzo
2021-04-03,LIG,5405,2498,2907,4463,942,ITC,ITC3,7,Liguria
2021-04-21,CAL,11544,5800,5744,8651,2893,ITF,ITF6,18,Calabria
2021-05-01,FVG,7194,3245,3949,6151,1043,ITH,ITH4,6,Friuli-Venezia Giulia
2021-06-10,UMB,7451,3715,3736,6678,773,ITI,ITI2,10,Umbria
2021-01-07,SIC,8923,4127,4796,8923,0,ITG,ITG1,19,Sicilia
2021-04-06,ABR,7678,3579,4099,5360,2318,ITF,ITF1,13,Abruzzo
2021-04-29,TOS,39302,17703,21599,19223,20079,ITI,ITI1,9,Toscana
2021-06-10,CAM,73362,35393,37969,66331,7031,ITF,ITF3,15,Campania
2021-01-21,FVG,896,345,551,1,895,ITH,ITH4,6,Friuli-Venezia Giulia
2021-03-12,LAZ,23937,11027,12910,17620,6317,ITI,ITI4,12,Lazio
2021-06-04,PAB,6467,3238,3229,4937,1530,ITH,ITH1,4,Provincia Autonoma Bolzano / Bozen
2021-02-24,PAB,1367,406,961,1355,12,ITH,ITH1,4,Provincia Autonoma Bolzano / Bozen
2021-06-08,VEN,43460,22477,20983,37347,6113,ITH,ITH3,5,Veneto
2021-01-02,PAT,502,143,359,502,0,ITH,ITH2,4,Provincia Autonoma Trento
2021-04-05,PAT,35,17,18,33,2,ITH,ITH2,4,Provincia Autonoma Trento
2021-04-16,BAS,3321,1634,1687,2423,898,ITF,ITF5,17,Basilicata
2021-05-29,SIC,47175,21463,25712,23986,23189,ITG,ITG1,19,Sicilia
2021-06-28,PAB,4596,2299,2297,229,4367,ITH,ITH1,4,Provincia Autonoma Bolzano / Bozen
2021-01-07,TOS,6018,1751,4267,6018,0,ITI,ITI1,9,Toscana
2021-04-11,VDA,479,208,271,479,0,ITC,ITC2,2,Valle d'Aosta / Vallée d'Aoste
2021-06-15,VEN,47554,24151,23403,30068,17486,ITH,ITH3,5,Veneto
2021-05-22,PIE,33494,15115,18379,17268,16226,ITC,ITC1,1,Piemonte
2021-06-25,PUG,48912,24083,24829,23561,25351,ITF,ITF4,16,Puglia
2020-12-31,LOM,714,302,412,714,0,ITC,ITC4,3,Lombardia
2021-04-15,MOL,1926,794,1132,1081,845,ITF,ITF2,14,Molise
2021-05-16,PAT,1331,736,595,1092,239,ITH,ITH2,4,Provincia Autonoma Trento
2021-03-04,PUG,15343,6091,9252,13923,1420,ITF,ITF4,16,Puglia
2021-03-30,PAB,1299,532,767,219,1080,ITH,ITH1,4,Provincia Autonoma Bolzano / Bozen
2021-06-08,UMB,7369,3636,3733,6826,543,ITI,ITI2,10,Umbria
2021-06-11,CAM,67809,32884,34925,61787,6022,ITF,ITF3,15,Campania
2021-05-21,LIG,12841,5954,6887,9715,3126,ITC,ITC3,7,Liguria
2021-06-09,PUG,41559,20575,20984,30387,11172,ITF,ITF4,16,Puglia
2021-01-28,VDA,291,123,168,56,235,ITC,ITC2,2,Valle d'Aosta / Vallée d'Aoste
2021-03-03,CAM,13924,5496,8428,7294,6630,ITF,ITF3,15,Campania
2021-04-03,VEN,21951,9625,12326,14243,7708,ITH,ITH3,5,Veneto
2021-03-11,MAR,6593,2784,3809,5223,1370,ITI,ITI3,11,Marche
2021-04-16,PAB,2951,1419,1532,2440,511,ITH,ITH1,4,Provincia Autonoma Bolzano / Bozen
2021-04-22,CAL,9745,4864,4881,6857,2888,ITF,ITF6,18,Calabria
2021-06-30,SAR,17432,8358,9074,4558,12874,ITG,ITG2,20,Sardegna
2021-01-05,PAT,711,233,478,711,0,ITH,ITH2,4,Provincia Autonoma Trento
2021-02-27,LIG,1888,921,967,1759,129,ITC,ITC3,7,Liguria
2021-03-20,VEN,13019,5388,7631,10939,2080,ITH,ITH3,5,Veneto
2021-03-27,FVG,5376,2917,2459,3965,1411,ITH,ITH4,6,Friuli-Venezia Giulia
2021-02-15,PUG,3257,1269,1988,2635,622,ITF,ITF4,16,Puglia
2021-03-15,LAZ,20909,9793,11116,14166,6743,ITI,ITI4,12,Lazio
2021-03-22,SAR,3696,1497,2199,3183,513,ITG,ITG2,20,Sardegna
2021-03-25,MAR,6655,2772,3883,3247,3408,ITI,ITI3,11,Marche
2021-05-06,CAL,13257,6276,6981,8990,4267,ITF,ITF6,18,Calabria
2021-03-16,MOL,614,230,384,267,347,ITF,ITF2,14,Molise
2021-04-15,PAT,3202,1443,1759,3048,154,ITH,ITH2,4,Provincia Autonoma Trento
2021-06-25,CAM,64575,31336,33239,13272,51303,ITF,ITF3,15,Campania
2021-01-17,TOS,2535,870,1665,2021,514,ITI,ITI1,9,Toscana
2021-02-10,LIG,2314,836,1478,1019,1295,ITC,ITC3,7,Liguria
2021-05-26,PUG,38464,18470,19994,26792,11672,ITF,ITF4,16,Puglia
2021-07-03,MAR,13668,6912,6756,4292,9376,ITI,ITI3,11,Marche
2021-04-08,SAR,13451,5940,7511,8331,5120,ITG,ITG2,20,Sardegna
2021-06-19,PAB,5614,2985,2629,580,5034,ITH,ITH1,4,Provincia Autonoma Bolzano / Bozen
2021-06-29,ABR,11162,5502,5660,5180,5982,ITF,ITF1,13,Abruzzo
2020-12-29,SAR,57,32,25,57,0,ITG,ITG2,20,Sardegna
2021-03-11,PAB,1685,825,860,1147,538,ITH,ITH1,4,Provincia Autonoma Bolzano / Bozen
2021-01-11,MOL,557,194,363,557,0,ITF,ITF2,14,Molise
2021-06-18,PIE,40408,20179,20229,26276,14132,ITC,ITC1,1,Piemonte
2021-02-25,PAB,1498,549,949,1497,1,ITH,ITH1,4,Provincia Autonoma Bolzano / Bozen
2021-05-11,LOM,86872,41432,45440,60652,26220,ITC,ITC4,3,Lombardia
2021-03-10,PIE,13682,5214,8468,11388,2294,ITC,ITC1,1,Piemonte
2021-05-25,CAM,46499,22381,24118,23095,23404,ITF,ITF3,15,Campania
2021-06-02,PAB,1444,809,635,987,457,ITH,ITH1,4,Provincia Autonoma Bolzano / Bozen
2021-03-27,PIE,18397,7828,10569,9570,8827,ITC,ITC1,1,Piemonte
2021-04-05,CAL,3643,1728,1915,2684,959,ITF,ITF6,18,Calabria
2021-04-22,SAR,10510,4663,5847,5589,4921,ITG,ITG2,20,Sardegna
2021-01-10,VEN,5034,1672,3362,5034,0,ITH,ITH3,5,Veneto
2021-03-21,ABR,2134,914,1220,844,1290,ITF,ITF1,13,Abruzzo
2021-01-05,LAZ,7375,2803,4572,7375,0,ITI,ITI4,12,Lazio
2021-01-12,SAR,865,408,457,865,0,ITG,ITG2,20,Sardegna
2021-02-05,EMR,9290,2956,6334,1607,7683,ITH,ITH5,8,Emilia-Romagna
2021-05-28,LOM,93519,44820,48699,42937,50582,ITC,ITC4,3,Lombardia
2021-06-12,VDA,1232,599,633,1066,166,ITC,ITC2,2,Valle d'Aosta / Vallée d'Aoste
2021-04-15,FVG,6506,2873,3633,5236,1270,ITH,ITH4,6,Friuli-Venezia Giulia
2021-02-17,LOM,11990,3756,8234,10600,1390,ITC,ITC4,3,Lombardia
2021-03-15,SIC,10614,4686,5928,5722,4892,ITG,ITG1,19,Sicilia
2021-06-12,ABR,11189,5791,5398,9859,1330,ITF,ITF1,13,Abruzzo
2021-06-11,LOM,100551,51200,49351,85972,14579,ITC,ITC4,3,Lombardia
2021-03-08,TOS,6707,2945,3762,1887,4820,ITI,ITI1,9,Toscana
2021-04-29,FVG,6728,2957,3771,4165,2563,ITH,ITH4,6,Friuli-Venezia Giulia
2021-02-20,MAR,4153,1729,2424,4042,111,ITI,ITI3,11,Marche
2021-06-29,BAS,3825,1856,1969,2785,1040,ITF,ITF5,17,Basilicata
2021-01-24,LAZ,5696,2229,3467,612,5084,ITI,ITI4,12,Lazio
2021-06-16,TOS,31717,16230,15487,26569,5148,ITI,ITI1,9,Toscana
2021-06-27,UMB,7450,3728,3722,1763,5687,ITI,ITI2,10,Umbria
2021-01-27,PUG,4602,1941,2661,631,3971,ITF,ITF4,16,Puglia
2021-06-18,PAT,6922,3685,3237,1814,5108,ITH,ITH2,4,Provincia Autonoma Trento
2021-01-05,FVG,1678,551,1127,1678,0,ITH,ITH4,6,Friuli-Venezia Giulia
2021-02-07,LAZ,4944,2026,2918,387,4557,ITI,ITI4,12,Lazio
2021-03-27,PAT,1620,710,910,1363,257,ITH,ITH2,4,Provincia Autonoma Trento
2021-05-07,PUG,50003,22320,27683,26551,23452,ITF,ITF4,16,Puglia
2021-05-30,TOS,28673,13944,14729,21727,6946,ITI,ITI1,9,Toscana
2021-03-18,LIG,4986,2124,2862,2007,2979,ITC,ITC3,7,Liguria
2021-05-18,LAZ,44921,20541,24380,35378,9543,ITI,ITI4,12,Lazio
2021-06-20,EMR,29980,15214,14766,15341,14639,ITH,ITH5,8,Emilia-Romagna
2021-03-21,BAS,1060,488,572,364,696,ITF,ITF5,17,Basilicata
2021-04-01,LIG,12423,5511,6912,9653,2770,ITC,ITC3,7,Liguria
2021-01-13,PUG,4542,1729,2813,4542,0,ITF,ITF4,16,Puglia
2021-02-08,PAB,2,1,1,1,1,ITH,ITH1,4,Provincia Autonoma Bolzano / Bozen
2021-04-22,CAM,33962,16540,17422,21557,12405,ITF,ITF3,15,Campania
2021-05-23,VEN,34484,16464,18020,11084,23400,ITH,ITH3,5,Veneto
2021-06-04,PAT,5824,2605,3219,1832,3992,ITH,ITH2,4,Provincia Autonoma Trento
2021-06-08,CAL,15878,7492,8386,13856,2022,ITF,ITF6,18,Calabria
2021-01-20,MAR,403,100,303,384,19,ITI,ITI3,11,Marche
2021-05-29,BAS,3059,1534,1525,834,2225,ITF,ITF5,17,Basilicata
2021-01-12,CAM,5215,2564,2651,5215,0,ITF,ITF3,15,Campania
2021-02-12,VEN,4314,1447,2867,3742,572,ITH,ITH3,5,Veneto
2021-03-19,VDA,322,85,237,287,35,ITC,ITC2,2,Valle d'Aosta / Vallée d'Aoste
2021-02-03,MAR,2124,741,1383,119,2005,ITI,ITI3,11,Marche
2021-03-17,CAL,4102,1826,2276,2186,1916,ITF,ITF6,18,Calabria
2021-04-06,PUG,13832,6247,7585,7079,6753,ITF,ITF4,16,Puglia
2021-05-11,SAR,8895,4128,4767,6524,2371,ITG,ITG2,20,Sardegna
2021-01-25,MOL,319,130,189,3,316,ITF,ITF2,14,Molise
2021-01-29,VEN,9023,2788,6235,366,8657,ITH,ITH3,5,Veneto
2021-01-31,SAR,2121,750,1371,48,2073,ITG,ITG2,20,Sardegna
2021-05-14,MAR,13494,6218,7276,6720,6774,ITI,ITI3,11,Marche
2021-06-25,CAL,18508,8589,9919,7880,10628,ITF,ITF6,18,Calabria
2021-02-05,FVG,2610,784,1826,89,2521,ITH,ITH4,6,Friuli-Venezia Giulia
2021-05-04,LIG,13647,6084,7563,5418,8229,ITC,ITC3,7,Liguria
2021-01-10,SAR,2183,750,1433,2183,0,ITG,ITG2,20,Sardegna
2021-07-01,VDA,962,473,489,341,621,ITC,ITC2,2,Valle d'Aosta / Vallée d'Aoste
2021-02-17,PAT,1113,425,688,1022,91,ITH,ITH2,4,Provincia Autonoma Trento
2021-03-03,UMB,4431,1770,2661,3721,710,ITI,ITI2,10,Umbria
2021-06-11,SIC,48305,23020,25285,40715,7590,ITG,ITG1,19,Sicilia
2021-05-24,ABR,12267,5857,6410,8917,3350,ITF,ITF1,13,Abruzzo
2021-02-11,BAS,952,401,551,869,83,ITF,ITF5,17,Basilicata
2021-05-12,PAB,3792,2058,1734,3639,153,ITH,ITH1,4,Provincia Autonoma Bolzano / Bozen
2021-04-29,SIC,31691,14819,16872,22229,9462,ITG,ITG1,19,Sicilia
2021-06-04,PIE,37493,19597,17896,34559,2934,ITC,ITC1,1,Piemonte
2021-02-01,PAB,1452,440,1012,12,1440,ITH,ITH1,4,Provincia Autonoma Bolzano / Bozen
2021-01-17,LAZ,4893,2027,2866,4681,212,ITI,ITI4,12,Lazio
2021-02-24,PIE,11409,4629,6780,10904,505,ITC,ITC1,1,Piemonte
2021-03-03,SIC,14421,6431,7990,11356,3065,ITG,ITG1,19,Sicilia
2021-04-24,FVG,6679,2948,3731,5436,1243,ITH,ITH4,6,Friuli-Venezia Giulia
2021-05-19,PUG,26371,12752,13619,19948,6423,ITF,ITF4,16,Puglia
2021-06-14,MOL,1627,810,817,552,1075,ITF,ITF2,14,Molise
2021-01-31,CAM,8068,3711,4357,23,8045,ITF,ITF3,15,Campania
2021-01-19,LAZ,4770,1956,2814,4316,454,ITI,ITI4,12,Lazio
2021-03-23,PUG,11093,5623,5470,4619,6474,ITF,ITF4,16,Puglia
2021-05-09,LIG,2822,1244,1578,1113,1709,ITC,ITC3,7,Liguria
2021-06-06,FVG,9455,4614,4841,7909,1546,ITH,ITH4,6,Friuli-Venezia Giulia
2021-05-22,BAS,5488,2723,2765,1937,3551,ITF,ITF5,17,Basilicata
2021-02-26,FVG,3735,2093,1642,3587,148,ITH,ITH4,6,Friuli-Venezia Giulia
2021-06-25,EMR,41509,21017,20492,19293,22216,ITH,ITH5,8,Emilia-Romagna
2021-03-26,BAS,1955,703,1252,1695,260,ITF,ITF5,17,Basilicata
2021-02-17,FVG,2355,1000,1355,1875,480,ITH,ITH4,6,Friuli-Venezia Giulia
2021-02-18,ABR,2288,933,1355,2158,130,ITF,ITF1,13,Abruzzo
2021-03-17,EMR,13719,5692,8027,5873,7846,ITH,ITH5,8,Emilia-Romagna
2021-05-18,VEN,26890,12509,14381,13316,13574,ITH,ITH3,5,Veneto
2021-05-30,PAT,1770,872,898,930,840,ITH,ITH2,4,Provincia Autonoma Trento
2021-01-29,LIG,3082,1064,2018,67,3015,ITC,ITC3,7,Liguria
2021-03-27,TOS,8862,4153,4709,8647,215,ITI,ITI1,9,Toscana
2021-05-13,EMR,35785,16494,19291,27988,7797,ITH,ITH5,8,Emilia-Romagna
2021-05-29,ABR,10317,4429,5888,4544,5773,ITF,ITF1,13,Abruzzo
2021-03-06,MAR,5731,2637,3094,4464,1267,ITI,ITI3,11,Marche
2021-04-03,PAT,1141,471,670,972,169,ITH,ITH2,4,Provincia Autonoma Trento
2021-06-06,UMB,7608,3904,3704,6915,693,ITI,ITI2,10,Umbria
2021-01-09,VDA,443,199,244,443,0,ITC,ITC2,2,Valle d'Aosta / Vallée d'Aoste
2021-04-29,LAZ,38662,17248,21414,25427,13235,ITI,ITI4,12,Lazio
2021-01-20,MOL,18,8,10,18,0,ITF,ITF2,14,Molise
2021-06-30,VEN,44462,22462,22000,17712,26750,ITH,ITH3,5,Veneto
2021-01-24,CAL,46,19,27,39,7,ITF,ITF6,18,Calabria
2021-03-03,LAZ,17856,7865,9991,13562,4294,ITI,ITI4,12,Lazio
2021-06-06,PIE,35028,18306,16722,32580,2448,ITC,ITC1,1,Piemonte
2021-07-02,SAR,18926,8894,10032,4378,14548,ITG,ITG2,20,Sardegna
2021-03-22,VEN,18144,8177,9967,13098,5046,ITH,ITH3,5,Veneto
2021-04-30,MOL,2937,1556,1381,830,2107,ITF,ITF2,14,Molise
2021-05-11,CAM,39861,19236,20625,30461,9400,ITF,ITF3,15,Campania
2021-01-20,LIG,1552,555,997,1540,12,ITC,ITC3,7,Liguria
2021-06-18,LOM,106813,52454,54359,54018,52795,ITC,ITC4,3,Lombardia
2021-03-13,VEN,17229,7303,9926,14098,3131,ITH,ITH3,5,Veneto
2021-03-25,PUG,11700,5991,5709,5458,6242,ITF,ITF4,16,Puglia
2021-07-03,PUG,30509,15195,15314,12700,17809,ITF,ITF4,16,Puglia
2021-02-24,UMB,1518,563,955,1503,15,ITI,ITI2,10,Umbria
2021-02-25,MOL,541,239,302,473,68,ITF,ITF2,14,Molise
2021-03-15,EMR,13444,6244,7200,6945,6499,ITH,ITH5,8,Emilia-Romagna
2021-05-22,ABR,13093,6363,6730,8198,4895,ITF,ITF1,13,Abruzzo
2021-06-14,MAR,12615,6377,6238,9307,3308,ITI,ITI3,11,Marche
2021-04-27,SAR,7617,3552,4065,5574,2043,ITG,ITG2,20,Sardegna
2021-01-15,VEN,5875,1820,4055,5875,0,ITH,ITH3,5,Veneto
2021-03-09,PAB,1194,543,651,1192,2,ITH,ITH1,4,Provincia Autonoma Bolzano / Bozen
2021-03-26,ABR,5354,2311,3043,3279,2075,ITF,ITF1,13,Abruzzo
2021-01-17,SAR,860,277,583,859,1,ITG,ITG2,20,Sardegna
2021-02-17,PIE,4794,2157,2637,3804,990,ITC,ITC1,1,Piemonte
2021-02-24,SIC,9306,4760,4546,8746,560,ITG,ITG1,19,Sicilia
2021-03-15,SAR,2799,1319,1480,2426,373,ITG,ITG2,20,Sardegna
2021-06-24,VDA,1221,629,592,388,833,ITC,ITC2,2,Valle d'Aosta / Vallée d'Aoste
2021-05-30,FVG,11059,4987,6072,7474,3585,ITH,ITH4,6,Friuli-Venezia Giulia
2021-03-01,LOM,18793,8232,10561,17088,1705,ITC,ITC4,3,Lombardia
2021-06-30,TOS,38207,18484,19723,8712,29495,ITI,ITI1,9,Toscana
2021-02-08,PUG,3992,1609,2383,1597,2395,ITF,ITF4,16,Puglia
2021-05-31,ABR,11311,5104,6207,6888,4423,ITF,ITF1,13,Abruzzo
2021-01-21,SIC,1434,706,728,501,933,ITG,ITG1,19,Sicilia
2021-04-20,ABR,5596,2693,2903,4178,1418,ITF,ITF1,13,Abruzzo
2021-04-24,PAT,3547,1701,1846,3533,14,ITH,ITH2,4,Provincia Autonoma Trento
2021-07-03,VDA,935,484,451,399,536,ITC,ITC2,2,Valle d'Aosta / Vallée d'Aoste
2021-01-26,LAZ,7964,3129,4835,727,7237,ITI,ITI4,12,Lazio
2021-07-04,SAR,4122,1998,2124,1091,3031,ITG,ITG2,20,Sardegna
2021-02-26,PAT,1218,435,783,923,295,ITH,ITH2,4,Provincia Autonoma Trento
2021-05-01,SIC,24439,11311,13128,19275,5164,ITG,ITG1,19,Sicilia
2021-02-14,TOS,9000,2569,6431,8890,110,ITI,ITI1,9,Toscana
2021-03-26,SAR,8440,3492,4948,6914,1526,ITG,ITG2,20,Sardegna
2021-06-08,PIE,37638,19489,18149,34797,2841,ITC,ITC1,1,Piemonte
2021-05-20,VEN,44747,21227,23520,20442,24305,ITH,ITH3,5,Veneto
2021-05-22,SAR,24848,11955,12893,19703,5145,ITG,ITG2,20,Sardegna
2021-05-23,PAB,4338,2303,2035,4330,8,ITH,ITH1,4,Provincia Autonoma Bolzano / Bozen
2021-05-25,TOS,34151,16477,17674,19533,14618,ITI,ITI1,9,Toscana
2021-01-14,PAT,701,203,498,701,0,ITH,ITH2,4,Provincia Autonoma Trento
2021-02-09,VEN,5248,1891,3357,3445,1803,ITH,ITH3,5,Veneto
2021-05-10,UMB,5975,2793,3182,3827,2148,ITI,ITI2,10,Umbria
2021-03-29,TOS,9670,4828,4842,9346,324,ITI,ITI1,9,Toscana
2021-04-26,PIE,19800,8748,11052,15398,4402,ITC,ITC1,1,Piemonte
2021-02-13,BAS,799,313,486,738,61,ITF,ITF5,17,Basilicata
2020-12-28,CAL,6,2,4,6,0,ITF,ITF6,18,Calabria
2021-02-03,PAB,1503,478,1025,5,1498,ITH,ITH1,4,Provincia Autonoma Bolzano / Bozen
2021-05-25,VEN,27749,13398,14351,11734,16015,ITH,ITH3,5,Veneto
2021-05-27,SAR,17828,9263,8565,12294,5534,ITG,ITG2,20,Sardegna
2021-02-14,VEN,126,56,70,113,13,ITH,ITH3,5,Veneto
2021-02-21,FVG,801,281,520,423,378,ITH,ITH4,6,Friuli-Venezia Giulia
2021-02-16,SAR,700,289,411,673,27,ITG,ITG2,20,Sardegna
2021-03-24,TOS,20012,8301,11711,10556,9456,ITI,ITI1,9,Toscana
2021-05-01,PIE,28540,12999,15541,16741,11799,ITC,ITC1,1,Piemonte
2021-02-12,PUG,4212,1672,2540,3120,1092,ITF,ITF4,16,Puglia
2021-03-08,MAR,6292,2757,3535,5290,1002,ITI,ITI3,11,Marche
2021-01-11,VDA,325,112,213,325,0,ITC,ITC2,2,Valle d'Aosta / Vallée d'Aoste
2021-01-21,PIE,6881,2314,4567,3385,3496,ITC,ITC1,1,Piemonte
2021-01-24,LIG,756,237,519,113,643,ITC,ITC3,7,Liguria
2021-03-05,SAR,5213,2606,2607,2857,2356,ITG,ITG2,20,Sardegna
2021-02-09,LAZ,8802,3770,5032,4581,4221,ITI,ITI4,12,Lazio
2021-03-27,PAB,3051,1554,1497,1543,1508,ITH,ITH1,4,Provincia Autonoma Bolzano / Bozen
2021-03-29,PAT,2493,966,1527,1758,735,ITH,ITH2,4,Provincia Autonoma Trento
2021-04-02,CAL,8525,3902,4623,4608,3917,ITF,ITF6,18,Calabria
2021-02-28,VEN,4136,1389,2747,3299,837,ITH,ITH3,5,Veneto
2021-02-23,LAZ,11095,4784,6311,10330,765,ITI,ITI4,12,Lazio
2021-03-13,PAB,2885,1459,1426,2784,101,ITH,ITH1,4,Provincia Autonoma Bolzano / Bozen
2021-04-12,PAT,3084,1407,1677,2588,496,ITH,ITH2,4,Provincia Autonoma Trento
2021-05-15,PIE,33779,15747,18032,20061,13718,ITC,ITC1,1,Piemonte
2021-01-29,PUG,6201,2663,3538,435,5766,ITF,ITF4,16,Puglia
2021-04-06,BAS,1273,464,809,1089,184,ITF,ITF5,17,Basilicata
2021-06-01,PIE,29260,14668,14592,24866,4394,ITC,ITC1,1,Piemonte
2021-03-17,VEN,14645,5992,8653,7849,6796,ITH,ITH3,5,Veneto
2021-05-27,LOM,94809,45428,49381,41393,53416,ITC,ITC4,3,Lombardia
2021-06-27,LIG,1931,887,1044,697,1234,ITC,ITC3,7,Liguria
2021-01-08,MOL,429,141,288,429,0,ITF,ITF2,14,Molise
2021-02-21,PIE,5090,2083,3007,4988,102,ITC,ITC1,1,Piemonte
2021-02-21,TOS,5105,2089,3016,4935,170,ITI,ITI1,9,Toscana
2021-03-19,SAR,7271,3051,4220,5056,2215,ITG,ITG2,20,Sardegna
2021-06-24,CAL,14949,6793,8156,6667,8282,ITF,ITF6,18,Calabria
2021-02-05,MAR,2154,653,1501,439,1715,ITI,ITI3,11,Marche
2021-03-19,CAL,4185,1953,2232,1894,2291,ITF,ITF6,18,Calabria
2021-03-20,PUG,8413,3878,4535,3819,4594,ITF,ITF4,16,Puglia
2021-06-14,BAS,4812,2148,2664,2103,2709,ITF,ITF5,17,Basilicata
2021-03-03,PUG,16778,6798,9980,14862,1916,ITF,ITF4,16,Puglia
2021-04-04,VDA,572,253,319,571,1,ITC,ITC2,2,Valle d'Aosta / Vallée d'Aoste
2021-05-08,CAM,56418,27132,29286,40590,15828,ITF,ITF3,15,Campania
2021-06-01,TOS,26908,13366,13542,23095,3813,ITI,ITI1,9,Toscana
2021-01-02,EMR,2375,916,1459,2375,0,ITH,ITH5,8,Emilia-Romagna
2021-04-24,LOM,75805,33595,42210,54675,21130,ITC,ITC4,3,Lombardia
2021-05-16,MAR,10898,4957,5941,6670,4228,ITI,ITI3,11,Marche
2021-01-28,CAM,8833,4122,4711,134,8699,ITF,ITF3,15,Campania
2021-02-05,PAB,3195,1181,2014,8,3187,ITH,ITH1,4,Provincia Autonoma Bolzano / Bozen
2021-03-23,BAS,1591,610,981,1423,168,ITF,ITF5,17,Basilicata
2021-06-11,PUG,47431,23199,24232,33501,13930,ITF,ITF4,16,Puglia
2021-01-14,LOM,26916,7803,19113,26916,0,ITC,ITC4,3,Lombardia
2021-01-21,PAT,353,95,258,229,124,ITH,ITH2,4,Provincia Autonoma Trento
2021-04-01,MOL,1469,667,802,743,726,ITF,ITF2,14,Molise
2021-05-30,MAR,9732,4690,5042,6743,2989,ITI,ITI3,11,Marche
2021-06-05,EMR,44073,22277,21796,37208,6865,ITH,ITH5,8,Emilia-Romagna
2021-07-01,BAS,3568,1765,1803,2464,1104,ITF,ITF5,17,Basilicata
2021-05-01,PAT,4851,2470,2381,4815,36,ITH,ITH2,4,Provincia Autonoma Trento
2021-07-04,FVG,2272,1148,1124,678,1594,ITH,ITH4,6,Friuli-Venezia Giulia
2021-05-08,LOM,87723,40756,46967,65684,22039,ITC,ITC4,3,Lombardia
2021-06-22,EMR,35526,17676,17850,16149,19377,ITH,ITH5,8,Emilia-Romagna
2021-07-02,TOS,28188,14134,14054,11065,17123,ITI,ITI1,9,Toscana
2021-02-09,SIC,4348,1798,2550,3313,1035,ITG,ITG1,19,Sicilia
2021-03-26,FVG,6000,2602,3398,3984,2016,ITH,ITH4,6,Friuli-Venezia Giulia
2021-05-09,ABR,9156,4090,5066,4286,4870,ITF,ITF1,13,Abruzzo
2021-02-12,LIG,1935,690,1245,897,1038,ITC,ITC3,7,Liguria
2021-03-12,FVG,4102,1696,2406,2721,1381,ITH,ITH4,6,Friuli-Venezia Giulia
2021-04-21,UMB,5319,2315,3004,3092,2227,ITI,ITI2,10,Umbria
2021-06-15,TOS,31177,16048,15129,26620,4557,ITI,ITI1,9,Toscana
2021-02-15,ABR,1795,832,963,1753,42,ITF,ITF1,13,Abruzzo
2021-03-10,TOS,18372,7408,10964,14354,4018,ITI,ITI1,9,Toscana
2021-06-10,CAL,15314,7040,8274,12549,2765,ITF,ITF6,18,Calabria
2021-04-21,CAM,30230,14727,15503,18003,12227,ITF,ITF3,15,Campania
2021-05-26,ABR,13557,6047,7510,8562,4995,ITF,ITF1,13,Abruzzo
2021-05-17,EMR,32394,15389,17005,22903,9491,ITH,ITH5,8,Emilia-Romagna
2021-01-02,FVG,1216,470,746,1216,0,ITH,ITH4,6,Friuli-Venezia Giulia
2021-01-21,LAZ,5603,2348,3255,550,5053,ITI,ITI4,12,Lazio
2021-04-15,PAB,4399,2307,2092,4136,263,ITH,ITH1,4,Provincia Autonoma Bolzano / Bozen
2021-06-14,ABR,10828,5348,5480,7463,3365,ITF,ITF1,13,Abruzzo
2021-01-12,VEN,5231,1517,3714,5231,0,ITH,ITH3,5,Veneto
2021-02-21,PAT,155,92,63,43,112,ITH,ITH2,4,Provincia Autonoma Trento
2021-03-02,UMB,3641,1346,2295,3637,4,ITI,ITI2,10,Umbria
2021-04-19,VEN,21544,8922,12622,5134,16410,ITH,ITH3,5,Veneto
2021-05-20,SIC,43745,20971,22774,27841,15904,ITG,ITG1,19,Sicilia
2021-06-20,PIE,33985,17025,16960,19268,14717,ITC,ITC1,1,Piemonte
2021-04-05,VEN,19153,8370,10783,13718,5435,ITH,ITH3,5,Veneto
2021-02-02,TOS,3743,1475,2268,196,3547,ITI,ITI1,9,Toscana
2021-03-12,PIE,14014,5241,8773,11078,2936,ITC,ITC1,1,Piemonte
2021-04-07,SAR,13552,6056,7496,7900,5652,ITG,ITG2,20,Sardegna
2021-04-12,FVG,7260,3183,4077,6128,1132,ITH,ITH4,6,Friuli-Venezia Giulia
2021-06-24,UMB,10103,5096,5007,6116,3987,ITI,ITI2,10,Umbria
2021-01-26,VEN,6919,2090,4829,149,6770,ITH,ITH3,5,Veneto
2021-04-24,SAR,10369,4850,5519,8032,2337,ITG,ITG2,20,Sardegna
2021-04-27,MAR,9544,4371,5173,5558,3986,ITI,ITI3,11,Marche
2021-05-15,PAT,1568,815,753,679,889,ITH,ITH2,4,Provincia Autonoma Trento
2021-03-31,LAZ,27623,13324,14299,20527,7096,ITI,ITI4,12,Lazio
2021-07-04,PIE,18398,9181,9217,5026,13372,ITC,ITC1,1,Piemonte
2021-01-14,SAR,1106,426,680,1106,0,ITG,ITG2,20,Sardegna
2021-02-01,BAS,242,91,151,46,196,ITF,ITF5,17,Basilicata
2021-03-15,LIG,7246,3097,4149,4540,2706,ITC,ITC3,7,Liguria
2021-06-15,CAM,18084,8804,9280,10694,7390,ITF,ITF3,15,Campania
2021-02-21,SIC,5168,2501,2667,5062,106,ITG,ITG1,19,Sicilia
2021-06-13,TOS,24606,12345,12261,22942,1664,ITI,ITI1,9,Toscana
2021-04-02,LAZ,29308,14014,15294,21971,7337,ITI,ITI4,12,Lazio
2021-06-03,CAL,14154,6624,7530,9580,4574,ITF,ITF6,18,Calabria
2021-05-15,LOM,80904,38782,42122,47522,33382,ITC,ITC4,3,Lombardia
2021-05-24,BAS,4833,2343,2490,1103,3730,ITF,ITF5,17,Basilicata
2021-01-19,SAR,747,270,477,692,55,ITG,ITG2,20,Sardegna
2021-04-07,CAL,7084,3211,3873,4078,3006,ITF,ITF6,18,Calabria
2021-01-29,MAR,1992,730,1262,167,1825,ITI,ITI3,11,Marche
2021-02-08,VDA,223,83,140,25,198,ITC,ITC2,2,Valle d'Aosta / Vallée d'Aoste
2021-02-10,PUG,3646,1436,2210,2135,1511,ITF,ITF4,16,Puglia
2021-03-17,SAR,6560,2852,3708,4952,1608,ITG,ITG2,20,Sardegna
2021-02-09,EMR,4154,1249,2905,2307,1847,ITH,ITH5,8,Emilia-Romagna
2021-02-23,CAL,1593,754,839,1478,115,ITF,ITF6,18,Calabria
2021-04-25,ABR,9066,4621,4445,8256,810,ITF,ITF1,13,Abruzzo
2021-05-18,MAR,11064,5259,5805,7655,3409,ITI,ITI3,11,Marche
2021-02-28,PAT,242,121,121,242,0,ITH,ITH2,4,Provincia Autonoma Trento
2021-03-23,VDA,379,150,229,245,134,ITC,ITC2,2,Valle d'Aosta / Vallée d'Aoste
2021-05-08,UMB,8126,3738,4388,4900,3226,ITI,ITI2,10,Umbria
2021-05-19,VDA,993,498,495,418,575,ITC,ITC2,2,Valle d'Aosta / Vallée d'Aoste
2021-06-08,PAT,5919,2863,3056,1870,4049,ITH,ITH2,4,Provincia Autonoma Trento
2021-01-28,LAZ,8279,3165,5114,782,7497,ITI,ITI4,12,Lazio
2021-02-02,CAM,5724,2805,2919,444,5280,ITF,ITF3,15,Campania
2021-02-10,PAB,1636,605,1031,26,1610,ITH,ITH1,4,Provincia Autonoma Bolzano / Bozen
2021-05-10,SIC,28329,13603,14726,16178,12151,ITG,ITG1,19,Sicilia
2021-07-04,LAZ,20199,9429,10770,2304,17895,ITI,ITI4,12,Lazio
2021-03-31,CAM,23183,11369,11814,19743,3440,ITF,ITF3,15,Campania
2021-05-08,LAZ,45432,20738,24694,30024,15408,ITI,ITI4,12,Lazio
2021-01-28,UMB,1248,394,854,19,1229,ITI,ITI2,10,Umbria
2021-01-29,MOL,421,136,285,6,415,ITF,ITF2,14,Molise
2021-04-26,PAT,2655,1252,1403,2560,95,ITH,ITH2,4,Provincia Autonoma Trento
2021-05-09,MOL,2052,933,1119,1956,96,ITF,ITF2,14,Molise
2021-05-13,LOM,87142,41764,45378,58292,28850,ITC,ITC4,3,Lombardia
2021-05-23,PUG,17914,8371,9543,14109,3805,ITF,ITF4,16,Puglia
2021-02-02,LOM,19880,6598,13282,499,19381,ITC,ITC4,3,Lombardia
2021-03-26,SIC,17858,8293,9565,12427,5431,ITG,ITG1,19,Sicilia
2021-06-02,BAS,5960,2804,3156,4417,1543,ITF,ITF5,17,Basilicata
2021-03-31,LOM,42054,17052,25002,26822,15232,ITC,ITC4,3,Lombardia
2021-05-15,EMR,33248,14982,18266,22840,10408,ITH,ITH5,8,Emilia-Romagna
2021-05-03,FVG,7208,3285,3923,3429,3779,ITH,ITH4,6,Friuli-Venezia Giulia
2021-06-27,SAR,9008,4304,4704,2982,6026,ITG,ITG2,20,Sardegna
2021-02-04,EMR,9920,3201,6719,1230,8690,ITH,ITH5,8,Emilia-Romagna
2021-05-22,EMR,33036,14132,18904,16912,16124,ITH,ITH5,8,Emilia-Romagna
2021-05-03,UMB,5086,2270,2816,2199,2887,ITI,ITI2,10,Umbria
2021-01-14,FVG,2584,789,1795,2584,0,ITH,ITH4,6,Friuli-Venezia Giulia
2021-04-05,LIG,3978,1753,2225,2329,1649,ITC,ITC3,7,Liguria
2021-04-18,BAS,3719,1846,1873,2352,1367,ITF,ITF5,17,Basilicata
2021-04-09,EMR,25724,11666,14058,20027,5697,ITH,ITH5,8,Emilia-Romagna
2021-01-28,SIC,9027,4272,4755,393,8634,ITG,ITG1,19,Sicilia
2021-07-04,SIC,15337,7551,7786,4052,11285,ITG,ITG1,19,Sicilia
2021-05-11,MOL,3207,1414,1793,2957,250,ITF,ITF2,14,Molise
2021-01-23,UMB,280,100,180,2,278,ITI,ITI2,10,Umbria
2021-05-08,SIC,35621,17025,18596,25324,10297,ITG,ITG1,19,Sicilia
2021-05-27,VEN,46466,22837,23629,23318,23148,ITH,ITH3,5,Veneto
2021-02-17,PUG,4278,1747,2531,3673,605,ITF,ITF4,16,Puglia
2021-05-03,PIE,26659,12168,14491,12498,14161,ITC,ITC1,1,Piemonte
2021-04-07,CAM,24972,11985,12987,20247,4725,ITF,ITF3,15,Campania
2021-03-26,LAZ,29994,13807,16187,23148,6846,ITI,ITI4,12,Lazio
2021-05-21,PAB,6924,3806,3118,5079,1845,ITH,ITH1,4,Provincia Autonoma Bolzano / Bozen
2021-05-28,PUG,43816,20754,23062,28146,15670,ITF,ITF4,16,Puglia
2021-02-07,VEN,2315,862,1453,714,1601,ITH,ITH3,5,Veneto
2021-02-02,EMR,9474,3048,6426,515,8959,ITH,ITH5,8,Emilia-Romagna
2021-02-20,BAS,1163,532,631,1044,119,ITF,ITF5,17,Basilicata
2021-02-19,PAT,929,359,570,870,59,ITH,ITH2,4,Provincia Autonoma Trento
2021-05-31,BAS,4229,2009,2220,1721,2508,ITF,ITF5,17,Basilicata
2021-01-26,SIC,9525,4713,4812,249,9276,ITG,ITG1,19,Sicilia
2021-02-26,PIE,12293,4933,7360,11556,737,ITC,ITC1,1,Piemonte
2021-03-24,SAR,7409,3108,4301,6050,1359,ITG,ITG2,20,Sardegna
2021-01-08,ABR,1525,507,1018,1525,0,ITF,ITF1,13,Abruzzo
2021-06-08,FVG,10288,5384,4904,9872,416,ITH,ITH4,6,Friuli-Venezia Giulia
2021-01-21,UMB,608,202,406,339,269,ITI,ITI2,10,Umbria
2021-03-10,LOM,33248,12716,20532,25385,7863,ITC,ITC4,3,Lombardia
2021-04-24,PIE,27507,12436,15071,21853,5654,ITC,ITC1,1,Piemonte
2021-05-27,TOS,28321,13173,15148,13487,14834,ITI,ITI1,9,Toscana
2021-02-28,FVG,2686,1003,1683,2292,394,ITH,ITH4,6,Friuli-Venezia Giulia
2021-04-18,ABR,5814,2728,3086,4871,943,ITF,ITF1,13,Abruzzo
2021-05-11,MAR,10622,4832,5790,5679,4943,ITI,ITI3,11,Marche
2021-01-14,PIE,9767,3152,6615,9767,0,ITC,ITC1,1,Piemonte
2021-03-16,VDA,182,37,145,118,64,ITC,ITC2,2,Valle d'Aosta / Vallée d'Aoste
2021-03-31,TOS,32705,13249,19456,20542,12163,ITI,ITI1,9,Toscana
2021-05-06,LOM,89823,42191,47632,73331,16492,ITC,ITC4,3,Lombardia
2021-01-26,LOM,8342,2706,5636,349,7993,ITC,ITC4,3,Lombardia
2021-03-31,CAL,9086,4136,4950,5047,4039,ITF,ITF6,18,Calabria
2021-02-18,BAS,1070,401,669,855,215,ITF,ITF5,17,Basilicata
2021-04-09,CAL,7941,3723,4218,5053,2888,ITF,ITF6,18,Calabria
2021-07-02,VEN,48149,24414,23735,15931,32218,ITH,ITH3,5,Veneto
2021-04-02,CAM,21862,10522,11340,19540,2322,ITF,ITF3,15,Campania
2021-05-11,LIG,13914,6388,7526,7299,6615,ITC,ITC3,7,Liguria
2021-05-30,PUG,20923,10022,10901,15887,5036,ITF,ITF4,16,Puglia
2021-01-22,MOL,128,36,92,128,0,ITF,ITF2,14,Molise
2021-03-22,TOS,5251,2763,2488,4807,444,ITI,ITI1,9,Toscana
2021-03-24,VEN,22109,9573,12536,15307,6802,ITH,ITH3,5,Veneto
2021-05-16,PAB,2025,932,1093,1333,692,ITH,ITH1,4,Provincia Autonoma Bolzano / Bozen
2021-05-02,MOL,1893,932,961,588,1305,ITF,ITF2,14,Molise
2021-02-20,ABR,4773,1841,2932,4697,76,ITF,ITF1,13,Abruzzo
2021-03-15,MAR,4406,2029,2377,1312,3094,ITI,ITI3,11,Marche
2021-03-29,LIG,10577,4619,5958,7446,3131,ITC,ITC3,7,Liguria
2021-04-26,FVG,5460,2450,3010,3811,1649,ITH,ITH4,6,Friuli-Venezia Giulia
2021-03-06,MOL,1728,807,921,1569,159,ITF,ITF2,14,Molise
2021-04-03,PUG,10559,4644,5915,7000,3559,ITF,ITF4,16,Puglia
2021-03-26,PIE,17810,7027,10783,8903,8907,ITC,ITC1,1,Piemonte
2021-05-02,PAB,2457,1288,1169,1536,921,ITH,ITH1,4,Provincia Autonoma Bolzano / Bozen
2021-06-01,PAT,4012,1875,2137,1157,2855,ITH,ITH2,4,Provincia Autonoma Trento
2021-02-13,VDA,216,196,20,215,1,ITC,ITC2,2,Valle d'Aosta / Vallée d'Aoste
2021-01-22,PAB,248,143,105,124,124,ITH,ITH1,4,Provincia Autonoma Bolzano / Bozen
2021-04-07,LOM,50588,20921,29667,34779,15809,ITC,ITC4,3,Lombardia
2021-05-06,VEN,46954,22024,24930,38479,8475,ITH,ITH3,5,Veneto
2021-01-07,LAZ,7752,2904,4848,7752,0,ITI,ITI4,12,Lazio
2021-01-17,MAR,1616,693,923,1556,60,ITI,ITI3,11,Marche
2021-05-26,BAS,4488,2259,2229,1706,2782,ITF,ITF5,17,Basilicata
2021-02-24,PAT,1325,525,800,926,399,ITH,ITH2,4,Provincia Autonoma Trento
2021-05-05,MOL,2414,1042,1372,2273,141,ITF,ITF2,14,Molise
2021-05-06,CAM,57282,27910,29372,42831,14451,ITF,ITF3,15,Campania
2021-05-19,PAB,3637,1850,1787,1851,1786,ITH,ITH1,4,Provincia Autonoma Bolzano / Bozen
2021-01-03,PAB,41,16,25,41,0,ITH,ITH1,4,Provincia Autonoma Bolzano / Bozen
2021-04-14,FVG,7217,3118,4099,5505,1712,ITH,ITH4,6,Friuli-Venezia Giulia
2021-01-13,ABR,1258,441,817,1258,0,ITF,ITF1,13,Abruzzo
2021-07-02,MAR,14371,7074,7297,4750,9621,ITI,ITI3,11,Marche
2021-06-03,PAT,4766,2235,2531,1301,3465,ITH,ITH2,4,Provincia Autonoma Trento
2021-01-19,PIE,6466,2105,4361,6454,12,ITC,ITC1,1,Piemonte
2021-02-14,SAR,539,263,276,537,2,ITG,ITG2,20,Sardegna
2021-06-08,LIG,17820,8896,8924,11202,6618,ITC,ITC3,7,Liguria
2021-04-13,PAB,2395,1132,1263,2388,7,ITH,ITH1,4,Provincia Autonoma Bolzano / Bozen
2021-05-03,LAZ,39224,17708,21516,26617,12607,ITI,ITI4,12,Lazio
2021-05-07,VDA,564,245,319,533,31,ITC,ITC2,2,Valle d'Aosta / Vallée d'Aoste
2021-07-04,TOS,5995,2951,3044,1959,4036,ITI,ITI1,9,Toscana
2021-03-17,LIG,5552,2368,3184,2473,3079,ITC,ITC3,7,Liguria
2021-04-23,VDA,921,443,478,538,383,ITC,ITC2,2,Valle d'Aosta / Vallée d'Aoste
2021-05-04,MOL,2705,1181,1524,2577,128,ITF,ITF2,14,Molise
2021-05-08,VEN,41434,18746,22688,29621,11813,ITH,ITH3,5,Veneto
2021-01-13,VDA,337,110,227,337,0,ITC,ITC2,2,Valle d'Aosta / Vallée d'Aoste
2021-06-25,LIG,13603,6508,7095,6763,6840,ITC,ITC3,7,Liguria
2021-01-10,MOL,270,72,198,270,0,ITF,ITF2,14,Molise
2021-04-05,LOM,27380,11695,15685,19277,8103,ITC,ITC4,3,Lombardia
2021-04-06,VDA,741,381,360,629,112,ITC,ITC2,2,Valle d'Aosta / Vallée d'Aoste
2021-04-20,MOL,2318,1025,1293,1220,1098,ITF,ITF2,14,Molise
2021-06-18,MAR,15118,7550,7568,8371,6747,ITI,ITI3,11,Marche
2021-06-09,MOL,1023,565,458,523,500,ITF,ITF2,14,Molise
2021-06-22,SIC,39417,18127,21290,18166,21251,ITG,ITG1,19,Sicilia
2021-01-13,BAS,916,387,529,916,0,ITF,ITF5,17,Basilicata
2020-12-31,TOS,802,201,601,802,0,ITI,ITI1,9,Toscana
2021-04-14,PIE,27715,12566,15149,23190,4525,ITC,ITC1,1,Piemonte
2021-04-23,BAS,4535,2184,2351,3536,999,ITF,ITF5,17,Basilicata
2021-05-23,MOL,1701,864,837,1695,6,ITF,ITF2,14,Molise
2021-04-10,TOS,11721,5348,6373,10978,743,ITI,ITI1,9,Toscana
2021-04-14,EMR,27040,12842,14198,20937,6103,ITH,ITH5,8,Emilia-Romagna
2021-01-19,PAT,407,77,330,407,0,ITH,ITH2,4,Provincia Autonoma Trento
2021-01-30,BAS,706,229,477,129,577,ITF,ITF5,17,Basilicata
2021-03-01,PUG,15104,5867,9237,13732,1372,ITF,ITF4,16,Puglia
2021-02-13,ABR,854,385,469,438,416,ITF,ITF1,13,Abruzzo
2021-04-19,CAL,7869,3798,4071,6194,1675,ITF,ITF6,18,Calabria
2021-01-21,EMR,2165,729,1436,819,1346,ITH,ITH5,8,Emilia-Romagna
2021-02-11,UMB,839,348,491,834,5,ITI,ITI2,10,Umbria
2021-05-22,SIC,47957,22779,25178,28649,19308,ITG,ITG1,19,Sicilia
2021-05-22,UMB,6960,2752,4208,2641,4319,ITI,ITI2,10,Umbria
2021-02-28,SIC,7163,3062,4101,6533,630,ITG,ITG1,19,Sicilia
2021-02-28,CAM,10412,3207,7205,8512,1900,ITF,ITF3,15,Campania
2021-01-09,CAL,1944,1048,896,1944,0,ITF,ITF6,18,Calabria
2021-06-08,SIC,47454,22304,25150,40940,6514,ITG,ITG1,19,Sicilia
2021-03-18,VDA,136,43,93,99,37,ITC,ITC2,2,Valle d'Aosta / Vallée d'Aoste
2021-06-03,FVG,12251,6675,5576,10272,1979,ITH,ITH4,6,Friuli-Venezia Giulia
2021-06-22,LAZ,62356,28756,33600,29089,33267,ITI,ITI4,12,Lazio
2021-03-04,ABR,5936,2360,3576,5014,922,ITF,ITF1,13,Abruzzo
2021-04-05,SAR,2037,784,1253,2036,1,ITG,ITG2,20,Sardegna
2021-01-31,LOM,9739,3765,5974,29,9710,ITC,ITC4,3,Lombardia
2021-02-14,CAM,3928,1923,2005,3894,34,ITF,ITF3,15,Campania
2021-02-22,PAB,526,143,383,514,12,ITH,ITH1,4,Provincia Autonoma Bolzano / Bozen
2021-03-14,LAZ,17240,6754,10486,12086,5154,ITI,ITI4,12,Lazio
2021-06-26,VDA,1061,509,552,357,704,ITC,ITC2,2,Valle d'Aosta / Vallée d'Aoste
2021-06-27,VEN,39589,20225,19364,15325,24264,ITH,ITH3,5,Veneto
2021-05-06,LIG,14518,6441,8077,6195,8323,ITC,ITC3,7,Liguria
2021-03-19,VEN,13791,5668,8123,7696,6095,ITH,ITH3,5,Veneto
2021-05-25,LOM,91147,43617,47530,44664,46483,ITC,ITC4,3,Lombardia
2021-03-04,VDA,291,139,152,42,249,ITC,ITC2,2,Valle d'Aosta / Vallée d'Aoste
2021-02-14,LOM,3583,1547,2036,2948,635,ITC,ITC4,3,Lombardia
2021-05-26,VDA,1209,587,622,576,633,ITC,ITC2,2,Valle d'Aosta / Vallée d'Aoste
2021-03-01,MOL,662,274,388,447,215,ITF,ITF2,14,Molise
2021-04-29,MAR,13388,6132,7256,7290,6098,ITI,ITI3,11,Marche
2021-01-26,LIG,2487,806,1681,16,2471,ITC,ITC3,7,Liguria
2021-01-12,LOM,20228,6700,13528,20228,0,ITC,ITC4,3,Lombardia
2021-01-26,CAM,7340,3726,3614,351,6989,ITF,ITF3,15,Campania
2021-03-10,PAT,2405,929,1476,1483,922,ITH,ITH2,4,Provincia Autonoma Trento
2021-06-29,SAR,17841,8576,9265,3793,14048,ITG,ITG2,20,Sardegna
2021-01-19,FVG,6,2,4,6,0,ITH,ITH4,6,Friuli-Venezia Giulia
2021-03-04,BAS,1881,892,989,1085,796,ITF,ITF5,17,Basilicata
2021-04-03,MOL,1773,851,922,1738,35,ITF,ITF2,14,Molise
2021-01-09,SIC,7184,3387,3797,7184,0,ITG,ITG1,19,Sicilia
2021-02-19,TOS,8293,2952,5341,7780,513,ITI,ITI1,9,Toscana
2021-06-03,EMR,37851,18417,19434,30345,7506,ITH,ITH5,8,Emilia-Romagna
2021-06-03,PIE,34594,17865,16729,30196,4398,ITC,ITC1,1,Piemonte
2021-01-10,PUG,2348,1061,1287,2348,0,ITF,ITF4,16,Puglia
2021-02-23,EMR,8216,3219,4997,7830,386,ITH,ITH5,8,Emilia-Romagna
2021-04-20,PUG,21151,9824,11327,17686,3465,ITF,ITF4,16,Puglia
2021-05-03,SIC,23304,10794,12510,13516,9788,ITG,ITG1,19,Sicilia
2021-03-12,EMR,18306,7701,10605,11589,6717,ITH,ITH5,8,Emilia-Romagna
2020-12-27,PUG,509,252,257,509,0,ITF,ITF4,16,Puglia
2021-04-02,UMB,4343,1778,2565,3588,755,ITI,ITI2,10,Umbria
2021-04-19,CAM,30766,14829,15937,19194,11572,ITF,ITF3,15,Campania
2021-05-28,ABR,14008,6307,7701,7659,6349,ITF,ITF1,13,Abruzzo
2021-06-12,BAS,3675,1687,1988,2987,688,ITF,ITF5,17,Basilicata
2021-01-09,UMB,1717,495,1222,1717,0,ITI,ITI2,10,Umbria
2021-04-19,SIC,18232,8634,9598,12653,5579,ITG,ITG1,19,Sicilia
2021-01-09,CAM,10567,5024,5543,10567,0,ITF,ITF3,15,Campania
2021-02-28,CAL,2334,1058,1276,2181,153,ITF,ITF6,18,Calabria
2021-04-19,UMB,5030,2224,2806,2982,2048,ITI,ITI2,10,Umbria
2021-06-05,CAL,20354,9534,10820,17385,2969,ITF,ITF6,18,Calabria
2021-01-31,LIG,624,270,354,9,615,ITC,ITC3,7,Liguria
2021-06-23,MAR,13663,6698,6965,6666,6997,ITI,ITI3,11,Marche
2020-12-31,VDA,18,4,14,18,0,ITC,ITC2,2,Valle d'Aosta / Vallée d'Aoste
2021-01-03,UMB,270,112,158,270,0,ITI,ITI2,10,Umbria
2021-02-20,LOM,9338,3867,5471,9040,298,ITC,ITC4,3,Lombardia
2021-04-25,CAL,15876,8053,7823,14844,1032,ITF,ITF6,18,Calabria
2021-05-05,PUG,39132,17153,21979,24953,14179,ITF,ITF4,16,Puglia
2021-06-06,VDA,1160,582,578,787,373,ITC,ITC2,2,Valle d'Aosta / Vallée d'Aoste
2021-04-23,MAR,11270,5195,6075,8215,3055,ITI,ITI3,11,Marche
2021-05-21,PAT,5052,2421,2631,3341,1711,ITH,ITH2,4,Provincia Autonoma Trento
2021-01-06,TOS,4519,1460,3059,4519,0,ITI,ITI1,9,Toscana
2021-03-10,ABR,5045,1682,3363,4089,956,ITF,ITF1,13,Abruzzo
2021-04-16,LIG,11988,5286,6702,10160,1828,ITC,ITC3,7,Liguria
2021-04-18,LOM,36403,16227,20176,31164,5239,ITC,ITC4,3,Lombardia
2021-04-27,CAM,32158,15625,16533,24237,7921,ITF,ITF3,15,Campania
2021-06-07,VEN,44403,23169,21234,37385,7018,ITH,ITH3,5,Veneto
2021-01-08,LOM,12706,3919,8787,12706,0,ITC,ITC4,3,Lombardia
2021-06-10,PAB,4443,2307,2136,1348,3095,ITH,ITH1,4,Provincia Autonoma Bolzano / Bozen
2021-06-17,PUG,41889,20468,21421,21296,20593,ITF,ITF4,16,Puglia
2021-02-27,VEN,8990,2692,6298,8143,847,ITH,ITH3,5,Veneto
2021-06-23,CAM,45973,21699,24274,10207,35766,ITF,ITF3,15,Campania
2021-01-26,ABR,1542,567,975,30,1512,ITF,ITF1,13,Abruzzo
2021-06-15,VDA,876,479,397,621,255,ITC,ITC2,2,Valle d'Aosta / Vallée d'Aoste
2021-02-09,MOL,359,170,189,197,162,ITF,ITF2,14,Molise
2021-01-06,LIG,1660,616,1044,1660,0,ITC,ITC3,7,Liguria
2021-05-06,ABR,12986,6077,6909,7960,5026,ITF,ITF1,13,Abruzzo
2021-06-30,CAL,16036,7319,8717,6817,9219,ITF,ITF6,18,Calabria
2021-02-15,SIC,3730,1733,1997,3166,564,ITG,ITG1,19,Sicilia
2021-04-13,SAR,7619,3601,4018,5792,1827,ITG,ITG2,20,Sardegna
2021-04-27,EMR,32101,14863,17238,19640,12461,ITH,ITH5,8,Emilia-Romagna
2021-02-08,FVG,2357,694,1663,92,2265,ITH,ITH4,6,Friuli-Venezia Giulia
2021-05-14,PIE,33417,16277,17140,17993,15424,ITC,ITC1,1,Piemonte
2021-05-26,SIC,44505,20857,23648,24077,20428,ITG,ITG1,19,Sicilia
2021-06-09,SAR,15459,7366,8093,11721,3738,ITG,ITG2,20,Sardegna
2021-02-01,PAT,1224,338,886,92,1132,ITH,ITH2,4,Provincia Autonoma Trento
2021-03-11,TOS,15884,6340,9544,12555,3329,ITI,ITI1,9,Toscana
2021-01-03,SIC,4782,2496,2286,4782,0,ITG,ITG1,19,Sicilia
2021-06-19,TOS,26460,13884,12576,21711,4749,ITI,ITI1,9,Toscana
2021-01-01,LAZ,3555,1382,2173,3555,0,ITI,ITI4,12,Lazio
2021-04-13,SIC,19681,9589,10092,10930,8751,ITG,ITG1,19,Sicilia
2021-01-10,LAZ,4043,1702,2341,4043,0,ITI,ITI4,12,Lazio
2021-01-15,CAM,4980,2381,2599,4980,0,ITF,ITF3,15,Campania
2021-03-10,BAS,1680,842,838,841,839,ITF,ITF5,17,Basilicata
2021-06-16,LAZ,64005,30638,33367,32306,31699,ITI,ITI4,12,Lazio
2021-06-21,CAM,45774,22104,23670,10605,35169,ITF,ITF3,15,Campania
2021-06-28,CAL,13003,5966,7037,5191,7812,ITF,ITF6,18,Calabria
2021-03-13,CAM,14518,7038,7480,9236,5282,ITF,ITF3,15,Campania
2021-04-20,LAZ,31085,14276,16809,19785,11300,ITI,ITI4,12,Lazio
2021-04-22,UMB,5444,2246,3198,2780,2664,ITI,ITI2,10,Umbria
2021-03-04,VEN,12980,4884,8096,9508,3472,ITH,ITH3,5,Veneto
2021-04-26,PAB,1543,771,772,1538,5,ITH,ITH1,4,Provincia Autonoma Bolzano / Bozen
2021-01-26,BAS,800,353,447,101,699,ITF,ITF5,17,Basilicata
2021-02-23,MAR,3303,1422,1881,3247,56,ITI,ITI3,11,Marche
2021-03-05,VDA,275,124,151,53,222,ITC,ITC2,2,Valle d'Aosta / Vallée d'Aoste
2021-03-08,LAZ,20864,9046,11818,15591,5273,ITI,ITI4,12,Lazio
2021-05-06,BAS,5052,2435,2617,3483,1569,ITF,ITF5,17,Basilicata
2021-03-20,CAL,6712,3074,3638,4200,2512,ITF,ITF6,18,Calabria
2021-03-22,CAM,13181,6344,6837,11141,2040,ITF,ITF3,15,Campania
2021-05-15,BAS,6529,3344,3185,3958,2571,ITF,ITF5,17,Basilicata
2021-03-30,PUG,12350,5914,6436,6442,5908,ITF,ITF4,16,Puglia
2021-06-13,FVG,8646,4501,4145,5325,3321,ITH,ITH4,6,Friuli-Venezia Giulia
2021-02-01,PUG,3966,1660,2306,373,3593,ITF,ITF4,16,Puglia
2021-02-07,CAM,2929,1382,1547,2158,771,ITF,ITF3,15,Campania
2021-04-02,BAS,2317,1046,1271,1713,604,ITF,ITF5,17,Basilicata
2021-06-28,LIG,11412,5517,5895,7154,4258,ITC,ITC3,7,Liguria
2021-02-03,PAT,847,315,532,414,433,ITH,ITH2,4,Provincia Autonoma Trento
2021-02-04,BAS,1098,442,656,63,1035,ITF,ITF5,17,Basilicata
2021-04-17,FVG,7453,3235,4218,5970,1483,ITH,ITH4,6,Friuli-Venezia Giulia
2021-05-06,EMR,35927,16602,19325,22871,13056,ITH,ITH5,8,Emilia-Romagna
2021-01-10,SIC,3534,1578,1956,3534,0,ITG,ITG1,19,Sicilia
2021-01-26,EMR,8334,3000,5334,214,8120,ITH,ITH5,8,Emilia-Romagna
2021-02-05,TOS,5749,2245,3504,1924,3825,ITI,ITI1,9,Toscana
2021-04-09,ABR,8924,4226,4698,6385,2539,ITF,ITF1,13,Abruzzo
2021-04-22,LAZ,38872,19229,19643,24252,14620,ITI,ITI4,12,Lazio
2021-07-02,EMR,32948,16182,16766,11531,21417,ITH,ITH5,8,Emilia-Romagna
2021-01-15,MAR,1771,500,1271,1771,0,ITI,ITI3,11,Marche
2021-04-17,UMB,6675,3069,3606,5335,1340,ITI,ITI2,10,Umbria
2021-05-23,PAT,1956,994,962,448,1508,ITH,ITH2,4,Provincia Autonoma Trento
2021-03-20,LIG,2316,995,1321,1142,1174,ITC,ITC3,7,Liguria
2021-03-24,EMR,21219,9401,11818,13837,7382,ITH,ITH5,8,Emilia-Romagna
2021-05-16,TOS,26672,12885,13787,24205,2467,ITI,ITI1,9,Toscana
2021-02-28,VDA,260,86,174,77,183,ITC,ITC2,2,Valle d'Aosta / Vallée d'Aoste
2021-03-10,LAZ,23330,10652,12678,17683,5647,ITI,ITI4,12,Lazio
2021-03-11,MOL,1465,637,828,1459,6,ITF,ITF2,14,Molise
2021-04-10,PAT,2823,1321,1502,2028,795,ITH,ITH2,4,Provincia Autonoma Trento
2021-05-11,VEN,33156,16497,16659,28438,4718,ITH,ITH3,5,Veneto
2021-06-30,CAM,46092,21979,24113,17634,28458,ITF,ITF3,15,Campania
2021-01-12,LAZ,5413,1981,3432,5413,0,ITI,ITI4,12,Lazio
2021-01-15,LOM,25219,7433,17786,25219,0,ITC,ITC4,3,Lombardia
2021-03-15,CAL,3582,1711,1871,2135,1447,ITF,ITF6,18,Calabria
2021-06-18,LAZ,63738,30619,33119,30709,33029,ITI,ITI4,12,Lazio
2021-01-18,PAB,1772,687,1085,1767,5,ITH,ITH1,4,Provincia Autonoma Bolzano / Bozen
2021-05-14,PUG,44907,20523,24384,28786,16121,ITF,ITF4,16,Puglia
2021-02-02,BAS,367,143,224,175,192,ITF,ITF5,17,Basilicata
2021-04-17,PIE,30463,14149,16314,27147,3316,ITC,ITC1,1,Piemonte
2021-01-22,VEN,1080,332,748,25,1055,ITH,ITH3,5,Veneto
2021-01-06,MOL,689,260,429,689,0,ITF,ITF2,14,Molise
2021-04-29,LOM,115510,53587,61923,85666,29844,ITC,ITC4,3,Lombardia
2021-06-13,PIE,37870,19994,17876,33739,4131,ITC,ITC1,1,Piemonte
2021-07-02,CAL,15945,7375,8570,6063,9882,ITF,ITF6,18,Calabria
2021-04-02,ABR,6694,3102,3592,5207,1487,ITF,ITF1,13,Abruzzo
2021-04-25,MAR,8600,3993,4607,7025,1575,ITI,ITI3,11,Marche
2021-04-16,MOL,2430,1033,1397,1198,1232,ITF,ITF2,14,Molise
2021-05-05,VDA,1038,566,472,456,582,ITC,ITC2,2,Valle d'Aosta / Vallée d'Aoste
2021-06-25,LOM,104145,54151,49994,76733,27412,ITC,ITC4,3,Lombardia
2021-01-24,EMR,2443,885,1558,298,2145,ITH,ITH5,8,Emilia-Romagna
2021-02-04,ABR,1682,616,1066,610,1072,ITF,ITF1,13,Abruzzo
2021-03-08,SAR,4680,2426,2254,3459,1221,ITG,ITG2,20,Sardegna
2021-05-20,CAL,16901,8436,8465,11295,5606,ITF,ITF6,18,Calabria
2021-01-05,SIC,10333,5077,5256,10333,0,ITG,ITG1,19,Sicilia
2021-02-10,PIE,7535,2371,5164,1316,6219,ITC,ITC1,1,Piemonte
2021-04-09,BAS,1151,350,801,1088,63,ITF,ITF5,17,Basilicata
2021-05-04,SAR,9543,4388,5155,7690,1853,ITG,ITG2,20,Sardegna
2021-04-10,FVG,5047,2212,2835,3822,1225,ITH,ITH4,6,Friuli-Venezia Giulia
2021-06-30,LIG,14814,7058,7756,8075,6739,ITC,ITC3,7,Liguria
2021-01-05,UMB,854,429,425,854,0,ITI,ITI2,10,Umbria
2021-01-24,SAR,90,34,56,5,85,ITG,ITG2,20,Sardegna
2021-04-08,PIE,25153,10935,14218,20423,4730,ITC,ITC1,1,Piemonte
2021-04-15,SIC,21036,10246,10790,11743,9293,ITG,ITG1,19,Sicilia
2021-05-11,TOS,27950,12983,14967,12483,15467,ITI,ITI1,9,Toscana
2021-04-20,LOM,67656,30831,36825,57317,10339,ITC,ITC4,3,Lombardia
2021-06-21,MOL,2900,1350,1550,1669,1231,ITF,ITF2,14,Molise
2021-05-23,FVG,10274,4855,5419,6124,4150,ITH,ITH4,6,Friuli-Venezia Giulia
2021-01-10,LOM,10518,3960,6558,10518,0,ITC,ITC4,3,Lombardia
2021-04-25,MOL,792,395,397,559,233,ITF,ITF2,14,Molise
2021-01-15,LIG,2257,755,1502,2257,0,ITC,ITC3,7,Liguria
2021-01-17,LOM,8349,3346,5003,8148,201,ITC,ITC4,3,Lombardia
2021-02-07,CAL,860,429,431,148,712,ITF,ITF6,18,Calabria
2021-03-13,TOS,9288,3310,5978,5324,3964,ITI,ITI1,9,Toscana
2021-03-17,LAZ,13811,5914,7897,7555,6256,ITI,ITI4,12,Lazio
2021-06-23,LOM,107979,55918,52061,76620,31359,ITC,ITC4,3,Lombardia
2021-03-15,LOM,31552,11328,20224,23035,8517,ITC,ITC4,3,Lombardia
2021-04-25,LIG,1935,920,1015,1520,415,ITC,ITC3,7,Liguria
2021-05-18,CAL,15279,7638,7641,11864,3415,ITF,ITF6,18,Calabria
2021-06-25,LAZ,62536,30083,32453,28388,34148,ITI,ITI4,12,Lazio
2021-05-04,VEN,42935,20334,22601,34908,8027,ITH,ITH3,5,Veneto
2021-06-20,SIC,32890,15563,17327,14918,17972,ITG,ITG1,19,Sicilia
2021-01-25,PUG,3828,1680,2148,425,3403,ITF,ITF4,16,Puglia
2021-01-13,MAR,2107,746,1361,2107,0,ITI,ITI3,11,Marche
2021-02-10,PAT,853,291,562,511,342,ITH,ITH2,4,Provincia Autonoma Trento
2021-03-13,LIG,3849,1637,2212,2994,855,ITC,ITC3,7,Liguria
2021-05-03,VDA,839,400,439,488,351,ITC,ITC2,2,Valle d'Aosta / Vallée d'Aoste
2021-06-18,SAR,16477,7504,8973,8714,7763,ITG,ITG2,20,Sardegna
2021-05-02,MAR,8900,3937,4963,3161,5739,ITI,ITI3,11,Marche
2021-03-10,SAR,6052,2955,3097,5202,850,ITG,ITG2,20,Sardegna
2021-01-17,CAM,1155,551,604,702,453,ITF,ITF3,15,Campania
2021-01-29,TOS,6144,1700,4444,304,5840,ITI,ITI1,9,Toscana
2021-03-22,CAL,4944,2319,2625,3184,1760,ITF,ITF6,18,Calabria
2021-04-10,PIE,30192,13428,16764,25914,4278,ITC,ITC1,1,Piemonte
2021-05-06,SAR,12953,6013,6940,9805,3148,ITG,ITG2,20,Sardegna
2021-05-07,PAB,4193,2061,2132,3665,528,ITH,ITH1,4,Provincia Autonoma Bolzano / Bozen
2021-01-24,VEN,4117,1219,2898,28,4089,ITH,ITH3,5,Veneto
2021-03-15,CAM,13343,6490,6853,8598,4745,ITF,ITF3,15,Campania
2021-06-20,UMB,6208,3000,3208,1580,4628,ITI,ITI2,10,Umbria
2021-03-07,VDA,64,30,34,11,53,ITC,ITC2,2,Valle d'Aosta / Vallée d'Aoste
2021-05-09,TOS,22533,9768,12765,9672,12861,ITI,ITI1,9,Toscana
2021-07-03,PAB,5600,2775,2825,1045,4555,ITH,ITH1,4,Provincia Autonoma Bolzano / Bozen
2021-04-24,UMB,4558,1960,2598,3377,1181,ITI,ITI2,10,Umbria
2021-06-28,MAR,12150,5916,6234,4700,7450,ITI,ITI3,11,Marche
2021-01-13,MOL,474,160,314,474,0,ITF,ITF2,14,Molise
2021-06-19,MOL,2326,1156,1170,1316,1010,ITF,ITF2,14,Molise
2021-05-05,PAB,4154,1945,2209,2038,2116,ITH,ITH1,4,Provincia Autonoma Bolzano / Bozen
2021-06-27,LAZ,47006,21465,25541,21021,25985,ITI,ITI4,12,Lazio
2021-07-02,CAM,53875,25951,27924,13216,40659,ITF,ITF3,15,Campania
2021-04-23,MOL,2050,882,1168,1391,659,ITF,ITF2,14,Molise
2021-01-17,EMR,2890,887,2003,2644,246,ITH,ITH5,8,Emilia-Romagna
2021-01-25,PAB,487,183,304,3,484,ITH,ITH1,4,Provincia Autonoma Bolzano / Bozen
2021-03-01,SAR,2267,1155,1112,1608,659,ITG,ITG2,20,Sardegna
2021-06-23,LIG,14064,6730,7334,8906,5158,ITC,ITC3,7,Liguria
2021-01-12,UMB,834,247,587,834,0,ITI,ITI2,10,Umbria
2021-04-22,SIC,26733,12627,14106,20276,6457,ITG,ITG1,19,Sicilia
2021-04-04,ABR,1631,767,864,1502,129,ITF,ITF1,13,Abruzzo
2021-04-08,PAT,3139,1316,1823,2020,1119,ITH,ITH2,4,Provincia Autonoma Trento
2021-03-10,SIC,13861,6059,7802,11678,2183,ITG,ITG1,19,Sicilia
2021-04-15,PIE,29652,13583,16069,24166,5486,ITC,ITC1,1,Piemonte
2021-03-23,PAB,1555,760,795,1554,1,ITH,ITH1,4,Provincia Autonoma Bolzano / Bozen
2021-01-05,PIE,5381,1603,3778,5381,0,ITC,ITC1,1,Piemonte
2021-01-12,SIC,4326,2120,2206,4326,0,ITG,ITG1,19,Sicilia
2021-04-27,LOM,85996,39973,46023,69446,16550,ITC,ITC4,3,Lombardia
2021-06-18,SIC,42990,19874,23116,18722,24268,ITG,ITG1,19,Sicilia
2021-03-14,UMB,66,48,18,66,0,ITI,ITI2,10,Umbria
2021-04-07,VEN,36006,16182,19824,28668,7338,ITH,ITH3,5,Veneto
2021-06-27,SIC,24874,11975,12899,11924,12950,ITG,ITG1,19,Sicilia
2021-01-07,FVG,2093,718,1375,2093,0,ITH,ITH4,6,Friuli-Venezia Giulia
2021-02-14,LIG,233,122,111,233,0,ITC,ITC3,7,Liguria
2021-04-02,EMR,23394,10552,12842,18913,4481,ITH,ITH5,8,Emilia-Romagna
2021-02-27,BAS,1993,861,1132,1829,164,ITF,ITF5,17,Basilicata
2021-06-22,UMB,8009,4060,3949,5237,2772,ITI,ITI2,10,Umbria
2021-03-05,FVG,3772,1511,2261,2698,1074,ITH,ITH4,6,Friuli-Venezia Giulia
2021-05-25,LIG,14110,6866,7244,10930,3180,ITC,ITC3,7,Liguria
2021-05-29,EMR,37831,16493,21338,17159,20672,ITH,ITH5,8,Emilia-Romagna
2021-05-15,SIC,56469,26385,30084,41233,15236,ITG,ITG1,19,Sicilia
2021-03-19,SIC,16215,7985,8230,10734,5481,ITG,ITG1,19,Sicilia
2021-06-16,ABR,10707,5355,5352,8045,2662,ITF,ITF1,13,Abruzzo
2021-01-30,VDA,439,202,237,14,425,ITC,ITC2,2,Valle d'Aosta / Vallée d'Aoste
2021-06-30,MOL,2898,1377,1521,931,1967,ITF,ITF2,14,Molise
2021-01-31,VEN,4769,1563,3206,391,4378,ITH,ITH3,5,Veneto
2021-05-27,CAM,72914,35353,37561,26383,46531,ITF,ITF3,15,Campania
2021-06-22,PIE,40433,19955,20478,18242,22191,ITC,ITC1,1,Piemonte
2021-02-16,CAM,5439,2411,3028,4668,771,ITF,ITF3,15,Campania
2021-03-29,VEN,31505,13723,17782,27629,3876,ITH,ITH3,5,Veneto
2021-02-04,LAZ,6336,2505,3831,1021,5315,ITI,ITI4,12,Lazio
2021-04-01,PAB,2786,1407,1379,2642,144,ITH,ITH1,4,Provincia Autonoma Bolzano / Bozen
2021-04-08,PUG,17470,7580,9890,11293,6177,ITF,ITF4,16,Puglia
2020-12-31,PAT,1626,449,1177,1626,0,ITH,ITH2,4,Provincia Autonoma Trento
2021-06-07,BAS,4234,1918,2316,3918,316,ITF,ITF5,17,Basilicata
2021-04-11,BAS,851,330,521,785,66,ITF,ITF5,17,Basilicata
2021-05-13,SAR,12384,5864,6520,8938,3446,ITG,ITG2,20,Sardegna
2021-04-19,FVG,6711,3133,3578,3295,3416,ITH,ITH4,6,Friuli-Venezia Giulia
2021-02-02,SAR,1498,669,829,257,1241,ITG,ITG2,20,Sardegna
2021-01-09,FVG,2513,841,1672,2513,0,ITH,ITH4,6,Friuli-Venezia Giulia
2021-02-27,ABR,2812,1338,1474,2546,266,ITF,ITF1,13,Abruzzo
2021-03-22,MAR,5654,2376,3278,2525,3129,ITI,ITI3,11,Marche
2021-06-15,FVG,11753,5941,5812,5303,6450,ITH,ITH4,6,Friuli-Venezia Giulia
2021-01-07,PIE,5387,1739,3648,5387,0,ITC,ITC1,1,Piemonte
2021-03-12,UMB,2694,1081,1613,2199,495,ITI,ITI2,10,Umbria
2021-06-06,PUG,30534,15370,15164,25504,5030,ITF,ITF4,16,Puglia
2021-02-09,CAL,2158,912,1246,956,1202,ITF,ITF6,18,Calabria
2021-03-05,PIE,15376,6060,9316,11558,3818,ITC,ITC1,1,Piemonte
2021-05-20,TOS,29732,13886,15846,18918,10814,ITI,ITI1,9,Toscana
2021-06-22,PAT,6180,3374,2806,3646,2534,ITH,ITH2,4,Provincia Autonoma Trento
2021-04-10,PUG,30882,13097,17785,26658,4224,ITF,ITF4,16,Puglia
2021-01-25,VDA,147,65,82,0,147,ITC,ITC2,2,Valle d'Aosta / Vallée d'Aoste
2021-03-17,LOM,26257,10495,15762,15258,10999,ITC,ITC4,3,Lombardia
2021-03-22,LIG,7745,3467,4278,4808,2937,ITC,ITC3,7,Liguria
2021-05-22,CAM,67950,32506,35444,46467,21483,ITF,ITF3,15,Campania
2021-01-31,TOS,3050,1129,1921,106,2944,ITI,ITI1,9,Toscana
2021-05-13,VEN,44228,21828,22400,34342,9886,ITH,ITH3,5,Veneto
2021-05-29,CAL,19250,8939,10311,9401,9849,ITF,ITF6,18,Calabria
2021-02-02,VEN,6512,1881,4631,396,6116,ITH,ITH3,5,Veneto
2021-03-13,MOL,1189,594,595,200,989,ITF,ITF2,14,Molise
2021-01-24,MAR,881,339,542,5,876,ITI,ITI3,11,Marche
2021-02-07,LIG,407,153,254,2,405,ITC,ITC3,7,Liguria
2021-03-07,FVG,2545,932,1613,2544,1,ITH,ITH4,6,Friuli-Venezia Giulia
2021-06-07,ABR,10995,5243,5752,9179,1816,ITF,ITF1,13,Abruzzo
2021-06-30,MAR,13475,6581,6894,4504,8971,ITI,ITI3,11,Marche
2021-01-15,MOL,538,242,296,538,0,ITF,ITF2,14,Molise
2021-04-11,ABR,5330,2606,2724,4847,483,ITF,ITF1,13,Abruzzo
2021-05-04,MAR,10926,4823,6103,5027,5899,ITI,ITI3,11,Marche
2021-05-18,LIG,13461,6117,7344,10168,3293,ITC,ITC3,7,Liguria
2021-05-30,PAB,4762,2515,2247,752,4010,ITH,ITH1,4,Provincia Autonoma Bolzano / Bozen
2021-03-05,PAT,2248,704,1544,1682,566,ITH,ITH2,4,Provincia Autonoma Trento
2021-03-12,SIC,12773,5492,7281,10778,1995,ITG,ITG1,19,Sicilia
2021-06-09,ABR,11424,6023,5401,9746,1678,ITF,ITF1,13,Abruzzo
2021-05-15,SAR,13794,6426,7368,10360,3434,ITG,ITG2,20,Sardegna
2021-01-07,PAT,1272,310,962,1272,0,ITH,ITH2,4,Provincia Autonoma Trento
2021-05-14,VDA,960,442,518,291,669,ITC,ITC2,2,Valle d'Aosta / Vallée d'Aoste
2020-12-31,FVG,1053,384,669,1053,0,ITH,ITH4,6,Friuli-Venezia Giulia
2021-04-05,TOS,15285,6826,8459,14548,737,ITI,ITI1,9,Toscana
2021-06-15,PIE,38867,20019,18848,27108,11759,ITC,ITC1,1,Piemonte
2021-03-21,UMB,675,338,337,675,0,ITI,ITI2,10,Umbria
2021-03-31,VEN,38814,16389,22425,31319,7495,ITH,ITH3,5,Veneto
2021-02-07,TOS,2806,952,1854,886,1920,ITI,ITI1,9,Toscana
2021-03-07,PIE,11977,4658,7319,11099,878,ITC,ITC1,1,Piemonte
2021-04-03,PAB,831,364,467,21,810,ITH,ITH1,4,Provincia Autonoma Bolzano / Bozen
2021-06-29,UMB,9843,5010,4833,4171,5672,ITI,ITI2,10,Umbria
2021-03-25,PAB,2150,1063,1087,1707,443,ITH,ITH1,4,Provincia Autonoma Bolzano / Bozen
2021-04-14,CAL,8060,3891,4169,6615,1445,ITF,ITF6,18,Calabria
2021-05-22,LAZ,55101,26993,28108,44420,10681,ITI,ITI4,12,Lazio
2021-04-04,BAS,610,225,385,197,413,ITF,ITF5,17,Basilicata
2021-02-16,CAL,1740,736,1004,1461,279,ITF,ITF6,18,Calabria
2021-06-23,MOL,2787,1284,1503,230,2557,ITF,ITF2,14,Molise
2021-05-17,UMB,6367,3060,3307,4190,2177,ITI,ITI2,10,Umbria
2021-07-04,LOM,37190,18258,18932,13050,24140,ITC,ITC4,3,Lombardia
2021-04-01,PUG,13924,6536,7388,7577,6347,ITF,ITF4,16,Puglia
2021-01-14,UMB,722,192,530,722,0,ITI,ITI2,10,Umbria
2021-03-20,MAR,4139,1742,2397,1049,3090,ITI,ITI3,11,Marche
2021-04-17,PAT,2232,1139,1093,2175,57,ITH,ITH2,4,Provincia Autonoma Trento
2020-12-31,PIE,3909,1334,2575,3909,0,ITC,ITC1,1,Piemonte
2021-01-26,SAR,1336,453,883,27,1309,ITG,ITG2,20,Sardegna
2021-01-27,PAB,84,28,56,1,83,ITH,ITH1,4,Provincia Autonoma Bolzano / Bozen
2021-02-03,PUG,5037,2005,3032,729,4308,ITF,ITF4,16,Puglia
2021-03-31,EMR,25266,11043,14223,19810,5456,ITH,ITH5,8,Emilia-Romagna
2021-01-22,MAR,488,168,320,194,294,ITI,ITI3,11,Marche
2021-06-17,FVG,11298,5705,5593,2291,9007,ITH,ITH4,6,Friuli-Venezia Giulia
2021-02-01,VDA,404,127,277,87,317,ITC,ITC2,2,Valle d'Aosta / Vallée d'Aoste
2021-03-19,UMB,1740,565,1175,1084,656,ITI,ITI2,10,Umbria
2021-04-19,PAT,2625,1235,1390,2603,22,ITH,ITH2,4,Provincia Autonoma Trento
2021-03-30,VDA,402,223,179,382,20,ITC,ITC2,2,Valle d'Aosta / Vallée d'Aoste
2021-03-24,CAM,17923,8370,9553,14965,2958,ITF,ITF3,15,Campania
2021-05-20,LIG,12857,5969,6888,8832,4025,ITC,ITC3,7,Liguria
2021-05-27,CAL,17610,8690,8920,9831,7779,ITF,ITF6,18,Calabria
2021-05-15,LAZ,57338,27395,29943,40827,16511,ITI,ITI4,12,Lazio
2021-05-20,CAM,60800,28120,32680,43176,17624,ITF,ITF3,15,Campania
2021-06-29,SIC,30417,14253,16164,15343,15074,ITG,ITG1,19,Sicilia
2021-05-12,VDA,1140,549,591,470,670,ITC,ITC2,2,Valle d'Aosta / Vallée d'Aoste
2021-06-15,PAT,6238,3281,2957,1723,4515,ITH,ITH2,4,Provincia Autonoma Trento
2021-07-02,LOM,98915,49586,49329,46501,52414,ITC,ITC4,3,Lombardia
2021-02-09,CAM,4643,2202,2441,4391,252,ITF,ITF3,15,Campania
2021-03-06,ABR,4177,1358,2819,3607,570,ITF,ITF1,13,Abruzzo
2021-03-19,LAZ,17437,7553,9884,11109,6328,ITI,ITI4,12,Lazio
2021-03-20,MOL,2321,968,1353,1000,1321,ITF,ITF2,14,Molise
2021-03-24,LOM,43238,15608,27630,31357,11881,ITC,ITC4,3,Lombardia
2021-05-18,TOS,28833,14268,14565,20012,8821,ITI,ITI1,9,Toscana
2021-06-28,MOL,2881,1343,1538,1011,1870,ITF,ITF2,14,Molise
2021-05-29,CAM,67811,32256,35555,43947,23864,ITF,ITF3,15,Campania
2021-02-09,LOM,12216,3334,8882,4037,8179,ITC,ITC4,3,Lombardia
2021-07-04,EMR,9003,4391,4612,3351,5652,ITH,ITH5,8,Emilia-Romagna
2021-03-26,EMR,23703,10110,13593,17266,6437,ITH,ITH5,8,Emilia-Romagna
2021-05-08,SAR,13090,5972,7118,10800,2290,ITG,ITG2,20,Sardegna
2021-06-22,FVG,11363,5858,5505,2295,9068,ITH,ITH4,6,Friuli-Venezia Giulia
