data_somministrazione,area,totale,sesso_maschile,sesso_femminile,prima_dose,seconda_dose,codice_NUTS1,codice_NUTS2,codice_regione_ISTAT,nome_area
2021-04-16,LAZ,34428,15694,18734,22338,12090,ITI,ITI4,12,Lazio
2021-06-21,EMR,37063,18737,18326,16223,20840,ITH,ITH5,8,Emilia-Romagna
2021-04-18,CAL,5845,2792,3053,4932,913,ITF,ITF6,18,Calabria
2021-04-08,BAS,763,348,415,753,10,ITF,ITF5,17,Basilicata
2021-07-01,TOS,29864,14442,15422,10387,19477,ITI,ITI1,9,Toscana
2021-01-27,VDA,151,71,80,79,72,ITC,ITC2,2,Valle d'Aosta / Vallée d'Aoste
2021-02-06,PAT,574,298,276,433,141,ITH,ITH2,4,Provincia Autonoma Trento
2021-03-26,TOS,20667,9383,11284,14902,5765,ITI,ITI1,9,Toscana
2021-06-27,MOL,1726,809,917,503,1223,ITF,ITF2,14,Molise
2021-04-20,VDA,933,430,503,739,194,ITC,ITC2,2,Valle d'Aosta / Vallée d'Aoste
2021-04-22,BAS,5037,2347,2690,3434,1603,ITF,ITF5,17,Basilicata
2021-01-23,LAZ,7214,2869,4345,585,6629,ITI,ITI4,12,Lazio
2021-03-30,EMR,23345,10338,13007,18304,5041,ITH,ITH5,8,Emilia-Romagna
2021-01-06,LAZ,5124,1962,3162,5124,0,ITI,ITI4,12,Lazio
2021-01-10,VDA,220,71,149,220,0,ITC,ITC2,2,Valle d'Aosta / Vallée d'Aoste
2021-02-23,PAT,1112,395,717,899,213,ITH,ITH2,4,Provincia Autonoma Trento
2021-03-09,TOS,11129,4567,6562,5577,5552,ITI,ITI1,9,Toscana
2021-03-24,MAR,7032,2983,4049,3364,3668,ITI,ITI3,11,Marche
2021-03-28,FVG,4937,2354,2583,4779,158,ITH,ITH4,6,Friuli-Venezia Giulia
2021-04-05,PUG,12745,6189,6556,12212,533,ITF,ITF4,16,Puglia
2020-12-27,VDA,20,9,11,20,0,ITC,ITC2,2,Valle d'Aosta / Vallée d'Aoste
2021-03-19,PUG,7961,3653,4308,3413,4548,ITF,ITF4,16,Puglia
2021-01-07,MOL,598,209,389,598,0,ITF,ITF2,14,Molise
2021-01-11,VEN,7239,2102,5137,7239,0,ITH,ITH3,5,Veneto
2021-06-01,MAR,12068,6160,5908,9973,2095,ITI,ITI3,11,Marche
2021-02-28,LIG,1058,580,478,1049,9,ITC,ITC3,7,Liguria
2021-05-07,UMB,10091,4697,5394,6903,3188,ITI,ITI2,10,Umbria
2021-06-20,PAB,4955,2697,2258,369,4586,ITH,ITH1,4,Provincia Autonoma Bolzano / Bozen
2021-06-27,PUG,17853,8855,8998,9692,8161,ITF,ITF4,16,Puglia
2021-01-18,FVG,1961,606,1355,1867,94,ITH,ITH4,6,Friuli-Venezia Giulia
2021-03-03,ABR,4633,1891,2742,3727,906,ITF,ITF1,13,Abruzzo
2021-03-10,MAR,5669,2402,3267,4530,1139,ITI,ITI3,11,Marche
2021-05-24,CAM,31357,15150,16207,16208,15149,ITF,ITF3,15,Campania
2021-01-04,FVG,1507,558,949,1507,0,ITH,ITH4,6,Friuli-Venezia Giulia
2021-04-09,TOS,24592,10579,14013,21183,3409,ITI,ITI1,9,Toscana
2021-05-17,PAT,4294,2122,2172,3943,351,ITH,ITH2,4,Provincia Autonoma Trento
2021-02-13,CAM,5508,2550,2958,5291,217,ITF,ITF3,15,Campania
2021-02-21,MAR,376,141,235,375,1,ITI,ITI3,11,Marche
2021-04-04,CAL,1568,784,784,1148,420,ITF,ITF6,18,Calabria
2021-04-21,VEN,32331,13179,19152,16273,16058,ITH,ITH3,5,Veneto
2021-06-30,BAS,3394,1636,1758,2281,1113,ITF,ITF5,17,Basilicata
2021-02-07,PAB,2362,1058,1304,14,2348,ITH,ITH1,4,Provincia Autonoma Bolzano / Bozen
2021-02-12,MOL,332,150,182,208,124,ITF,ITF2,14,Molise
2021-02-25,SIC,9867,5155,4712,8704,1163,ITG,ITG1,19,Sicilia
2021-03-28,PIE,16062,6901,9161,8440,7622,ITC,ITC1,1,Piemonte
2021-04-23,SAR,12864,5741,7123,7388,5476,ITG,ITG2,20,Sardegna
2021-05-22,VEN,34761,16672,18089,13366,21395,ITH,ITH3,5,Veneto
2021-02-11,VEN,4012,1238,2774,3384,628,ITH,ITH3,5,Veneto
2021-04-08,ABR,7395,3337,4058,5065,2330,ITF,ITF1,13,Abruzzo
2021-06-05,SIC,59910,28497,31413,49334,10576,ITG,ITG1,19,Sicilia
2021-04-23,CAM,32322,15520,16802,23174,9148,ITF,ITF3,15,Campania
2021-05-10,SAR,9739,4341,5398,7201,2538,ITG,ITG2,20,Sardegna
2021-01-28,VEN,9210,2662,6548,172,9038,ITH,ITH3,5,Veneto
2021-04-22,ABR,6729,3249,3480,4999,1730,ITF,ITF1,13,Abruzzo
2021-06-26,CAL,15352,7077,8275,7421,7931,ITF,ITF6,18,Calabria
2021-01-30,SAR,3863,1392,2471,362,3501,ITG,ITG2,20,Sardegna
2021-03-14,SIC,8773,3927,4846,4937,3836,ITG,ITG1,19,Sicilia
2021-04-11,PIE,20841,9327,11514,18687,2154,ITC,ITC1,1,Piemonte
2021-05-18,PAB,3342,1753,1589,2156,1186,ITH,ITH1,4,Provincia Autonoma Bolzano / Bozen
2021-01-04,EMR,7315,2527,4788,7315,0,ITH,ITH5,8,Emilia-Romagna
2021-01-04,PIE,5564,1679,3885,5564,0,ITC,ITC1,1,Piemonte
2021-04-23,LOM,73490,33308,40182,56947,16543,ITC,ITC4,3,Lombardia
2021-06-17,TOS,32405,16558,15847,26960,5445,ITI,ITI1,9,Toscana
2021-04-28,PIE,26048,11740,14308,16013,10035,ITC,ITC1,1,Piemonte
2021-01-18,PIE,6167,2048,4119,5918,249,ITC,ITC1,1,Piemonte
2021-03-22,ABR,4344,1908,2436,2373,1971,ITF,ITF1,13,Abruzzo
2021-05-10,LOM,85259,40879,44380,63686,21573,ITC,ITC4,3,Lombardia
2021-02-11,SIC,5236,2060,3176,4773,463,ITG,ITG1,19,Sicilia
2021-01-30,LOM,12309,4564,7745,154,12155,ITC,ITC4,3,Lombardia
2021-06-30,ABR,10919,5293,5626,4421,6498,ITF,ITF1,13,Abruzzo
2021-02-06,FVG,1154,338,816,22,1132,ITH,ITH4,6,Friuli-Venezia Giulia
2021-02-17,BAS,1135,493,642,1059,76,ITF,ITF5,17,Basilicata
2021-02-25,LAZ,12679,5536,7143,11601,1078,ITI,ITI4,12,Lazio
2021-04-14,PAT,3119,1465,1654,2382,737,ITH,ITH2,4,Provincia Autonoma Trento
2021-02-04,TOS,4253,1594,2659,961,3292,ITI,ITI1,9,Toscana
2021-02-23,FVG,2644,1278,1366,2464,180,ITH,ITH4,6,Friuli-Venezia Giulia
2021-03-28,PAT,753,294,459,751,2,ITH,ITH2,4,Provincia Autonoma Trento
2021-06-07,CAL,17010,7904,9106,13800,3210,ITF,ITF6,18,Calabria
2021-01-19,MAR,230,85,145,142,88,ITI,ITI3,11,Marche
2021-05-28,BAS,3614,1809,1805,951,2663,ITF,ITF5,17,Basilicata
2021-06-05,LAZ,65911,32509,33402,43188,22723,ITI,ITI4,12,Lazio
2021-02-14,PUG,786,347,439,662,124,ITF,ITF4,16,Puglia
2021-05-15,TOS,29215,13786,15429,23440,5775,ITI,ITI1,9,Toscana
2021-05-19,EMR,33716,14958,18758,18542,15174,ITH,ITH5,8,Emilia-Romagna
2021-02-02,MAR,1193,398,795,72,1121,ITI,ITI3,11,Marche
2021-06-09,VDA,1027,535,492,991,36,ITC,ITC2,2,Valle d'Aosta / Vallée d'Aoste
2021-06-11,BAS,4492,2059,2433,3222,1270,ITF,ITF5,17,Basilicata
2021-05-25,PUG,34640,16167,18473,21140,13500,ITF,ITF4,16,Puglia
2021-01-04,PAT,871,228,643,871,0,ITH,ITH2,4,Provincia Autonoma Trento
2021-03-01,VDA,181,66,115,147,34,ITC,ITC2,2,Valle d'Aosta / Vallée d'Aoste
2021-03-15,MOL,832,338,494,587,245,ITF,ITF2,14,Molise
2021-04-28,TOS,19097,8171,10926,3811,15286,ITI,ITI1,9,Toscana
2021-05-13,MAR,12603,5695,6908,7104,5499,ITI,ITI3,11,Marche
2021-05-17,FVG,8803,4085,4718,6318,2485,ITH,ITH4,6,Friuli-Venezia Giulia
2021-03-02,VEN,11490,4625,6865,8181,3309,ITH,ITH3,5,Veneto
2021-03-09,FVG,4009,1722,2287,1262,2747,ITH,ITH4,6,Friuli-Venezia Giulia
2021-04-12,MAR,8564,3770,4794,8082,482,ITI,ITI3,11,Marche
2021-01-26,MAR,2020,747,1273,90,1930,ITI,ITI3,11,Marche
2021-03-09,CAL,6405,3307,3098,5424,981,ITF,ITF6,18,Calabria
2021-05-17,VEN,26490,12977,13513,16475,10015,ITH,ITH3,5,Veneto
2021-03-26,LIG,9329,4025,5304,6174,3155,ITC,ITC3,7,Liguria
2021-03-28,LOM,20480,7816,12664,14317,6163,ITC,ITC4,3,Lombardia
2021-04-11,SIC,15384,7597,7787,8354,7030,ITG,ITG1,19,Sicilia
2021-05-22,TOS,25992,12647,13345,21714,4278,ITI,ITI1,9,Toscana
2021-02-06,VEN,4095,1354,2741,709,3386,ITH,ITH3,5,Veneto
2021-04-14,LOM,47181,21027,26154,34215,12966,ITC,ITC4,3,Lombardia
2021-02-20,CAL,1433,764,669,1114,319,ITF,ITF6,18,Calabria
2021-05-26,LAZ,47474,21802,25672,35375,12099,ITI,ITI4,12,Lazio
2021-01-02,LIG,691,245,446,691,0,ITC,ITC3,7,Liguria
2021-01-04,LOM,6100,2103,3997,6100,0,ITC,ITC4,3,Lombardia
2021-01-30,FVG,2277,745,1532,270,2007,ITH,ITH4,6,Friuli-Venezia Giulia
2021-03-04,LAZ,19406,8713,10693,14388,5018,ITI,ITI4,12,Lazio
2021-04-21,PAT,2910,1359,1551,2860,50,ITH,ITH2,4,Provincia Autonoma Trento
2021-05-05,TOS,30066,13415,16651,15596,14470,ITI,ITI1,9,Toscana
2021-06-12,LAZ,63730,29022,34708,34391,29339,ITI,ITI4,12,Lazio
2021-04-24,PAB,5105,2450,2655,4620,485,ITH,ITH1,4,Provincia Autonoma Bolzano / Bozen
2021-02-05,VDA,294,102,192,101,193,ITC,ITC2,2,Valle d'Aosta / Vallée d'Aoste
2021-02-07,PUG,1579,669,910,253,1326,ITF,ITF4,16,Puglia
2021-05-19,SAR,17018,8664,8354,12780,4238,ITG,ITG2,20,Sardegna
2021-01-21,PUG,2132,904,1228,1271,861,ITF,ITF4,16,Puglia
2021-01-22,ABR,118,57,61,118,0,ITF,ITF1,13,Abruzzo
2021-02-22,VDA,316,94,222,213,103,ITC,ITC2,2,Valle d'Aosta / Vallée d'Aoste
2021-03-28,CAM,15556,7504,8052,13931,1625,ITF,ITF3,15,Campania
2021-04-23,PIE,27447,12603,14844,20685,6762,ITC,ITC1,1,Piemonte
2021-02-28,TOS,1649,667,982,922,727,ITI,ITI1,9,Toscana
2021-05-01,PUG,27611,12645,14966,16961,10650,ITF,ITF4,16,Puglia
2021-06-05,SAR,17867,8430,9437,11413,6454,ITG,ITG2,20,Sardegna
2021-02-23,VEN,7383,3254,4129,7112,271,ITH,ITH3,5,Veneto
2021-04-19,MAR,9602,4497,5105,8021,1581,ITI,ITI3,11,Marche
2021-05-31,CAL,15259,7323,7936,7378,7881,ITF,ITF6,18,Calabria
2021-02-25,SAR,2899,1255,1644,2294,605,ITG,ITG2,20,Sardegna
2021-01-04,CAM,5826,2963,2863,5826,0,ITF,ITF3,15,Campania
2021-02-11,TOS,5384,2022,3362,5142,242,ITI,ITI1,9,Toscana
2021-05-16,VDA,688,341,347,347,341,ITC,ITC2,2,Valle d'Aosta / Vallée d'Aoste
2021-01-30,EMR,10079,3520,6559,141,9938,ITH,ITH5,8,Emilia-Romagna
2021-03-14,SAR,607,376,231,607,0,ITG,ITG2,20,Sardegna
2021-03-24,MOL,1631,658,973,1229,402,ITF,ITF2,14,Molise
2020-12-30,SIC,184,109,75,184,0,ITG,ITG1,19,Sicilia
2021-02-09,TOS,4488,1468,3020,3877,611,ITI,ITI1,9,Toscana
2021-04-05,PAB,301,144,157,23,278,ITH,ITH1,4,Provincia Autonoma Bolzano / Bozen
2021-06-14,LAZ,62529,29324,33205,32416,30113,ITI,ITI4,12,Lazio
2021-06-19,CAM,61114,29080,32034,23406,37708,ITF,ITF3,15,Campania
2021-06-27,PAB,4413,2307,2106,607,3806,ITH,ITH1,4,Provincia Autonoma Bolzano / Bozen
2021-01-16,SIC,2579,1152,1427,2579,0,ITG,ITG1,19,Sicilia
2021-01-28,PAT,530,147,383,48,482,ITH,ITH2,4,Provincia Autonoma Trento
2021-07-01,SIC,30316,13692,16624,10558,19758,ITG,ITG1,19,Sicilia
2021-01-11,PAT,732,223,509,732,0,ITH,ITH2,4,Provincia Autonoma Trento
2021-01-22,BAS,67,24,43,67,0,ITF,ITF5,17,Basilicata
2021-06-19,LOM,103293,51498,51795,58505,44788,ITC,ITC4,3,Lombardia
2021-03-21,LAZ,18226,7162,11064,13175,5051,ITI,ITI4,12,Lazio
2021-04-09,SIC,20293,9881,10412,11216,9077,ITG,ITG1,19,Sicilia
2021-01-12,PAB,1709,459,1250,1709,0,ITH,ITH1,4,Provincia Autonoma Bolzano / Bozen
2021-03-23,SIC,20831,10006,10825,15318,5513,ITG,ITG1,19,Sicilia
2021-01-02,PUG,2950,1302,1648,2950,0,ITF,ITF4,16,Puglia
2021-01-03,ABR,471,185,286,471,0,ITF,ITF1,13,Abruzzo
2021-04-12,PUG,29246,13777,15469,26369,2877,ITF,ITF4,16,Puglia
2020-12-30,LAZ,1630,629,1001,1630,0,ITI,ITI4,12,Lazio
2021-02-16,PAT,665,245,420,660,5,ITH,ITH2,4,Provincia Autonoma Trento
2021-03-09,CAM,14124,6870,7254,10339,3785,ITF,ITF3,15,Campania
2021-05-02,BAS,4180,2001,2179,3551,629,ITF,ITF5,17,Basilicata
2021-06-26,FVG,9492,4834,4658,3356,6136,ITH,ITH4,6,Friuli-Venezia Giulia
2021-04-15,BAS,3386,1659,1727,2632,754,ITF,ITF5,17,Basilicata
2021-07-01,LAZ,45923,21811,24112,6889,39034,ITI,ITI4,12,Lazio
2021-01-17,MOL,78,38,40,48,30,ITF,ITF2,14,Molise
2021-06-15,LIG,17073,8295,8778,10611,6462,ITC,ITC3,7,Liguria
2021-02-14,MAR,738,301,437,738,0,ITI,ITI3,11,Marche
2021-04-28,VEN,32394,15168,17226,23376,9018,ITH,ITH3,5,Veneto
2021-04-23,EMR,29561,13811,15750,14680,14881,ITH,ITH5,8,Emilia-Romagna
2021-04-23,PAT,3637,1769,1868,3583,54,ITH,ITH2,4,Provincia Autonoma Trento
2021-01-30,PAT,386,132,254,152,234,ITH,ITH2,4,Provincia Autonoma Trento
2021-04-21,FVG,7754,3458,4296,4074,3680,ITH,ITH4,6,Friuli-Venezia Giulia
2020-12-28,SIC,213,127,86,213,0,ITG,ITG1,19,Sicilia
2021-01-13,EMR,9077,2942,6135,9077,0,ITH,ITH5,8,Emilia-Romagna
2021-03-27,ABR,6121,2620,3501,3635,2486,ITF,ITF1,13,Abruzzo
2021-04-09,LAZ,27562,12496,15066,19310,8252,ITI,ITI4,12,Lazio
2021-01-11,FVG,1882,608,1274,1882,0,ITH,ITH4,6,Friuli-Venezia Giulia
2021-03-23,LAZ,25214,11773,13441,18618,6596,ITI,ITI4,12,Lazio
2021-04-10,MOL,2640,1261,1379,2488,152,ITF,ITF2,14,Molise
2021-05-10,PAT,3212,1646,1566,2707,505,ITH,ITH2,4,Provincia Autonoma Trento
2021-06-26,PIE,40940,20826,20114,22598,18342,ITC,ITC1,1,Piemonte
2021-03-07,LIG,1915,1138,777,1614,301,ITC,ITC3,7,Liguria
2021-05-31,CAM,40711,20654,20057,30402,10309,ITF,ITF3,15,Campania
2021-01-03,BAS,901,344,557,901,0,ITF,ITF5,17,Basilicata
2021-01-01,UMB,273,104,169,273,0,ITI,ITI2,10,Umbria
2021-02-05,MOL,593,269,324,55,538,ITF,ITF2,14,Molise
2021-04-11,UMB,3097,1504,1593,3048,49,ITI,ITI2,10,Umbria
2021-04-30,SAR,11134,5301,5833,6923,4211,ITG,ITG2,20,Sardegna
2021-01-18,VEN,2762,776,1986,2563,199,ITH,ITH3,5,Veneto
2021-01-05,ABR,1615,604,1011,1615,0,ITF,ITF1,13,Abruzzo
2021-03-11,CAL,7238,3431,3807,5971,1267,ITF,ITF6,18,Calabria
2021-04-04,EMR,9879,4717,5162,7612,2267,ITH,ITH5,8,Emilia-Romagna
2021-04-04,PIE,9261,4062,5199,6547,2714,ITC,ITC1,1,Piemonte
2021-06-04,VDA,908,383,525,474,434,ITC,ITC2,2,Valle d'Aosta / Vallée d'Aoste
2021-01-18,UMB,613,218,395,529,84,ITI,ITI2,10,Umbria
2021-03-02,SIC,14668,6306,8362,11894,2774,ITG,ITG1,19,Sicilia
2021-05-30,ABR,8632,4098,4534,5397,3235,ITF,ITF1,13,Abruzzo
2021-03-09,SAR,5547,2742,2805,4818,729,ITG,ITG2,20,Sardegna
2021-01-04,SIC,8383,4189,4194,8383,0,ITG,ITG1,19,Sicilia
2021-04-03,ABR,5160,2257,2903,3563,1597,ITF,ITF1,13,Abruzzo
2021-01-28,LIG,2847,971,1876,39,2808,ITC,ITC3,7,Liguria
2021-02-11,PIE,6764,2107,4657,3006,3758,ITC,ITC1,1,Piemonte
2021-05-05,SAR,10162,4647,5515,8149,2013,ITG,ITG2,20,Sardegna
2021-01-18,SIC,1478,600,878,1325,153,ITG,ITG1,19,Sicilia
2021-01-23,VEN,4051,1246,2805,31,4020,ITH,ITH3,5,Veneto
2021-06-29,VEN,44454,22199,22255,18958,25496,ITH,ITH3,5,Veneto
2021-07-01,CAL,12032,5676,6356,5213,6819,ITF,ITF6,18,Calabria
2021-01-26,PAB,810,291,519,1,809,ITH,ITH1,4,Provincia Autonoma Bolzano / Bozen
2021-04-09,PIE,25856,11390,14466,21349,4507,ITC,ITC1,1,Piemonte
2021-06-24,CAM,64717,31079,33638,12719,51998,ITF,ITF3,15,Campania
2021-03-21,VEN,11980,4752,7228,8518,3462,ITH,ITH3,5,Veneto
2021-04-28,SIC,29206,13703,15503,20114,9092,ITG,ITG1,19,Sicilia
2020-12-30,PIE,730,322,408,730,0,ITC,ITC1,1,Piemonte
2021-03-16,CAM,8086,3519,4567,3772,4314,ITF,ITF3,15,Campania
2021-03-24,PAB,2063,998,1065,2050,13,ITH,ITH1,4,Provincia Autonoma Bolzano / Bozen
2021-06-05,PIE,36917,18914,18003,32460,4457,ITC,ITC1,1,Piemonte
2021-04-28,LOM,95723,43664,52059,68822,26901,ITC,ITC4,3,Lombardia
2021-06-22,TOS,30979,15573,15406,22809,8170,ITI,ITI1,9,Toscana
2021-02-25,PIE,12219,5252,6967,11672,547,ITC,ITC1,1,Piemonte
2021-06-24,LOM,106025,54867,51158,77781,28244,ITC,ITC4,3,Lombardia
2021-03-16,LAZ,13545,5740,7805,7101,6444,ITI,ITI4,12,Lazio
2021-03-16,LOM,25494,10113,15381,16418,9076,ITC,ITC4,3,Lombardia
2021-01-23,EMR,2448,871,1577,443,2005,ITH,ITH5,8,Emilia-Romagna
2021-05-12,LOM,87472,41743,45729,59920,27552,ITC,ITC4,3,Lombardia
2021-01-21,MAR,918,261,657,591,327,ITI,ITI3,11,Marche
2021-05-30,BAS,2774,1419,1355,922,1852,ITF,ITF5,17,Basilicata
2021-04-09,PAT,2740,1162,1578,1540,1200,ITH,ITH2,4,Provincia Autonoma Trento
2021-05-02,VDA,765,345,420,605,160,ITC,ITC2,2,Valle d'Aosta / Vallée d'Aoste
2021-05-07,EMR,35265,16958,18307,23413,11852,ITH,ITH5,8,Emilia-Romagna
2021-05-17,TOS,29689,14810,14879,20819,8870,ITI,ITI1,9,Toscana
2021-02-18,FVG,3218,1492,1726,2811,407,ITH,ITH4,6,Friuli-Venezia Giulia
2021-04-03,BAS,1808,749,1059,1472,336,ITF,ITF5,17,Basilicata
2021-05-01,MAR,9318,3924,5394,3576,5742,ITI,ITI3,11,Marche
2021-01-22,VDA,56,21,35,20,36,ITC,ITC2,2,Valle d'Aosta / Vallée d'Aoste
2021-02-11,PAT,1133,365,768,796,337,ITH,ITH2,4,Provincia Autonoma Trento
2021-03-21,TOS,3293,1627,1666,1860,1433,ITI,ITI1,9,Toscana
2021-02-09,PUG,3839,1569,2270,2167,1672,ITF,ITF4,16,Puglia
2021-03-09,LAZ,21951,9905,12046,16752,5199,ITI,ITI4,12,Lazio
2021-01-08,VDA,299,130,169,299,0,ITC,ITC2,2,Valle d'Aosta / Vallée d'Aoste
2021-01-23,TOS,3966,1360,2606,640,3326,ITI,ITI1,9,Toscana
2021-02-25,PAT,1641,643,998,1200,441,ITH,ITH2,4,Provincia Autonoma Trento
2021-06-29,TOS,36831,17895,18936,8108,28723,ITI,ITI1,9,Toscana
2021-01-11,LAZ,5542,2109,3433,5542,0,ITI,ITI4,12,Lazio
2021-04-02,FVG,6593,2925,3668,4755,1838,ITH,ITH4,6,Friuli-Venezia Giulia
2021-05-20,PUG,33563,15228,18335,21223,12340,ITF,ITF4,16,Puglia
2021-06-14,UMB,5369,2744,2625,3360,2009,ITI,ITI2,10,Umbria
2020-12-30,PAT,7,3,4,7,0,ITH,ITH2,4,Provincia Autonoma Trento
2021-03-06,VDA,22,4,18,22,0,ITC,ITC2,2,Valle d'Aosta / Vallée d'Aoste
2021-05-03,TOS,11919,5505,6414,10608,1311,ITI,ITI1,9,Toscana
2021-06-05,PAT,4081,1915,2166,750,3331,ITH,ITH2,4,Provincia Autonoma Trento
2021-01-25,CAM,5746,2927,2819,163,5583,ITF,ITF3,15,Campania
2021-03-24,PUG,13566,6504,7062,6259,7307,ITF,ITF4,16,Puglia
2021-07-01,CAM,58920,28496,30424,18573,40347,ITF,ITF3,15,Campania
2021-01-12,MOL,336,114,222,336,0,ITF,ITF2,14,Molise
2021-01-16,VEN,4611,1542,3069,4611,0,ITH,ITH3,5,Veneto
2021-02-01,CAL,2515,1198,1317,244,2271,ITF,ITF6,18,Calabria
2021-03-10,PAB,1268,529,739,1125,143,ITH,ITH1,4,Provincia Autonoma Bolzano / Bozen
2021-01-26,PUG,5362,2397,2965,571,4791,ITF,ITF4,16,Puglia
2021-03-23,CAM,15740,7443,8297,13227,2513,ITF,ITF3,15,Campania
2021-03-14,VEN,15176,5942,9234,14282,894,ITH,ITH3,5,Veneto
2021-05-06,PAB,5181,2747,2434,2613,2568,ITH,ITH1,4,Provincia Autonoma Bolzano / Bozen
2021-05-12,CAL,16396,7997,8399,10908,5488,ITF,ITF6,18,Calabria
2021-02-05,BAS,987,444,543,64,923,ITF,ITF5,17,Basilicata
2021-03-05,MAR,6204,2866,3338,4736,1468,ITI,ITI3,11,Marche
2021-04-16,FVG,6950,3020,3930,5025,1925,ITH,ITH4,6,Friuli-Venezia Giulia
2021-05-06,PUG,39554,17294,22260,19876,19678,ITF,ITF4,16,Puglia
2021-05-19,CAM,51154,22602,28552,34545,16609,ITF,ITF3,15,Campania
2021-02-24,MOL,666,278,388,333,333,ITF,ITF2,14,Molise
2021-05-22,PAT,3257,1597,1660,924,2333,ITH,ITH2,4,Provincia Autonoma Trento
2021-05-26,CAL,18670,9282,9388,10399,8271,ITF,ITF6,18,Calabria
2021-01-06,FVG,710,264,446,710,0,ITH,ITH4,6,Friuli-Venezia Giulia
2021-01-07,MAR,1808,636,1172,1808,0,ITI,ITI3,11,Marche
2021-01-21,LIG,1106,385,721,675,431,ITC,ITC3,7,Liguria
2021-03-02,SAR,3061,1640,1421,1908,1153,ITG,ITG2,20,Sardegna
2021-05-16,BAS,4972,2468,2504,2859,2113,ITF,ITF5,17,Basilicata
2021-03-30,CAL,6379,2752,3627,3636,2743,ITF,ITF6,18,Calabria
2021-04-02,PIE,20143,8304,11839,11716,8427,ITC,ITC1,1,Piemonte
2021-04-28,SAR,9026,4282,4744,5323,3703,ITG,ITG2,20,Sardegna
2021-02-12,ABR,1228,567,661,1039,189,ITF,ITF1,13,Abruzzo
2021-01-18,SAR,904,326,578,780,124,ITG,ITG2,20,Sardegna
2021-05-29,PIE,32797,15226,17571,20629,12168,ITC,ITC1,1,Piemonte
2021-06-24,SAR,19141,9188,9953,8194,10947,ITG,ITG2,20,Sardegna
2021-02-23,SIC,8685,4590,4095,8219,466,ITG,ITG1,19,Sicilia
2021-05-23,ABR,9882,4696,5186,7190,2692,ITF,ITF1,13,Abruzzo
2021-02-18,PIE,4791,2094,2697,4361,430,ITC,ITC1,1,Piemonte
2021-03-16,SAR,4374,1949,2425,3452,922,ITG,ITG2,20,Sardegna
2021-03-17,PAB,582,213,369,580,2,ITH,ITH1,4,Provincia Autonoma Bolzano / Bozen
2021-03-09,SIC,13082,5703,7379,10882,2200,ITG,ITG1,19,Sicilia
2021-05-10,VEN,36452,17045,19407,26600,9852,ITH,ITH3,5,Veneto
2021-06-06,ABR,11025,5256,5769,8835,2190,ITF,ITF1,13,Abruzzo
2021-04-16,PIE,28405,13214,15191,23418,4987,ITC,ITC1,1,Piemonte
2021-05-05,CAM,51171,24857,26314,44787,6384,ITF,ITF3,15,Campania
2021-04-11,CAM,17523,8606,8917,15441,2082,ITF,ITF3,15,Campania
2021-05-24,FVG,11414,5522,5892,7800,3614,ITH,ITH4,6,Friuli-Venezia Giulia
2021-06-04,BAS,4829,2286,2543,3783,1046,ITF,ITF5,17,Basilicata
2021-02-22,ABR,2642,1173,1469,2612,30,ITF,ITF1,13,Abruzzo
2021-06-02,UMB,3914,1881,2033,3874,40,ITI,ITI2,10,Umbria
2021-02-13,FVG,566,179,387,560,6,ITH,ITH4,6,Friuli-Venezia Giulia
2021-02-18,LAZ,10018,4975,5043,9207,811,ITI,ITI4,12,Lazio
2021-02-21,PUG,2177,474,1703,2115,62,ITF,ITF4,16,Puglia
2021-04-28,CAM,36435,17642,18793,26679,9756,ITF,ITF3,15,Campania
2021-01-18,CAM,958,399,559,714,244,ITF,ITF3,15,Campania
2021-06-01,PUG,34738,17371,17367,21903,12835,ITF,ITF4,16,Puglia
2021-02-24,BAS,1803,743,1060,1734,69,ITF,ITF5,17,Basilicata
2021-05-15,PUG,43532,18952,24580,23530,20002,ITF,ITF4,16,Puglia
2021-05-26,EMR,33218,14727,18491,10298,22920,ITH,ITH5,8,Emilia-Romagna
2021-04-26,LIG,10555,4981,5574,7918,2637,ITC,ITC3,7,Liguria
2021-05-12,LAZ,47531,21567,25964,30895,16636,ITI,ITI4,12,Lazio
2021-06-17,VEN,50856,25498,25358,25996,24860,ITH,ITH3,5,Veneto
2021-06-29,PAT,6214,3130,3084,2716,3498,ITH,ITH2,4,Provincia Autonoma Trento
2021-06-12,EMR,40352,21333,19019,35462,4890,ITH,ITH5,8,Emilia-Romagna
2021-06-12,PAT,5357,2688,2669,472,4885,ITH,ITH2,4,Provincia Autonoma Trento
2021-03-09,VEN,16543,7446,9097,10220,6323,ITH,ITH3,5,Veneto
2021-04-05,MAR,5691,2358,3333,4422,1269,ITI,ITI3,11,Marche
2021-02-05,ABR,1534,521,1013,788,746,ITF,ITF1,13,Abruzzo
2021-03-04,EMR,16452,5350,11102,13435,3017,ITH,ITH5,8,Emilia-Romagna
2021-02-19,MOL,169,93,76,167,2,ITF,ITF2,14,Molise
2021-01-16,LIG,1278,557,721,1278,0,ITC,ITC3,7,Liguria
2021-05-16,ABR,9580,4139,5441,5767,3813,ITF,ITF1,13,Abruzzo
2021-05-31,VEN,31587,16210,15377,21679,9908,ITH,ITH3,5,Veneto
2021-02-01,LAZ,5676,2178,3498,354,5322,ITI,ITI4,12,Lazio
2021-03-02,FVG,4220,1519,2701,2721,1499,ITH,ITH4,6,Friuli-Venezia Giulia
2021-03-21,PAT,129,69,60,129,0,ITH,ITH2,4,Provincia Autonoma Trento
2021-06-03,PUG,50302,24405,25897,31058,19244,ITF,ITF4,16,Puglia
2021-06-04,ABR,15599,7371,8228,10911,4688,ITF,ITF1,13,Abruzzo
2021-06-27,MAR,9819,4750,5069,4528,5291,ITI,ITI3,11,Marche
2021-02-22,BAS,1790,773,1017,1737,53,ITF,ITF5,17,Basilicata
2021-02-20,UMB,283,101,182,259,24,ITI,ITI2,10,Umbria
2021-05-24,PIE,28984,13422,15562,17023,11961,ITC,ITC1,1,Piemonte
2021-06-19,SAR,15330,7507,7823,9210,6120,ITG,ITG2,20,Sardegna
2021-02-02,LIG,2671,1005,1666,129,2542,ITC,ITC3,7,Liguria
2021-05-18,ABR,12110,5660,6450,7730,4380,ITF,ITF1,13,Abruzzo
2021-03-22,PAB,1144,523,621,1139,5,ITH,ITH1,4,Provincia Autonoma Bolzano / Bozen
2021-04-15,VDA,810,377,433,671,139,ITC,ITC2,2,Valle d'Aosta / Vallée d'Aoste
2021-05-24,EMR,29943,13715,16228,18467,11476,ITH,ITH5,8,Emilia-Romagna
2021-06-05,LOM,102107,52793,49314,92341,9766,ITC,ITC4,3,Lombardia
2021-02-13,EMR,3628,1085,2543,3030,598,ITH,ITH5,8,Emilia-Romagna
2021-02-24,ABR,3305,1441,1864,3129,176,ITF,ITF1,13,Abruzzo
2021-03-19,MAR,3834,1598,2236,337,3497,ITI,ITI3,11,Marche
2021-03-26,VEN,29577,13141,16436,24115,5462,ITH,ITH3,5,Veneto
2021-04-30,CAL,14971,7342,7629,10616,4355,ITF,ITF6,18,Calabria
2021-03-09,UMB,4088,2000,2088,2800,1288,ITI,ITI2,10,Umbria
2021-03-10,MOL,1737,720,1017,1687,50,ITF,ITF2,14,Molise
2021-03-28,SAR,4646,1839,2807,4566,80,ITG,ITG2,20,Sardegna
2021-03-04,FVG,3451,1597,1854,2792,659,ITH,ITH4,6,Friuli-Venezia Giulia
2021-03-02,PIE,11202,4506,6696,10386,816,ITC,ITC1,1,Piemonte
2021-03-14,LOM,14874,5348,9526,11591,3283,ITC,ITC4,3,Lombardia
2021-01-04,SAR,592,217,375,592,0,ITG,ITG2,20,Sardegna
2021-06-01,MOL,2598,1322,1276,2490,108,ITF,ITF2,14,Molise
2021-04-28,LIG,14444,6520,7924,6460,7984,ITC,ITC3,7,Liguria
2021-03-10,PUG,14809,6613,8196,11686,3123,ITF,ITF4,16,Puglia
2021-06-12,FVG,8074,4630,3444,6916,1158,ITH,ITH4,6,Friuli-Venezia Giulia
2021-02-04,LIG,2817,986,1831,179,2638,ITC,ITC3,7,Liguria
2021-04-02,TOS,31981,13566,18415,23955,8026,ITI,ITI1,9,Toscana
2021-05-24,PAT,4383,2012,2371,1361,3022,ITH,ITH2,4,Provincia Autonoma Trento
2021-03-17,MAR,3430,1496,1934,107,3323,ITI,ITI3,11,Marche
2021-03-28,VEN,31296,13603,17693,27684,3612,ITH,ITH3,5,Veneto
2021-05-15,LIG,7306,3264,4042,4352,2954,ITC,ITC3,7,Liguria
2021-05-31,SIC,37893,17046,20847,21572,16321,ITG,ITG1,19,Sicilia
2021-06-19,VEN,48408,24640,23768,25930,22478,ITH,ITH3,5,Veneto
2021-01-13,LAZ,5694,2151,3543,5694,0,ITI,ITI4,12,Lazio
2021-02-21,LIG,869,491,378,865,4,ITC,ITC3,7,Liguria
2021-02-23,LOM,11828,4803,7025,11497,331,ITC,ITC4,3,Lombardia
2021-03-02,PAT,1306,440,866,930,376,ITH,ITH2,4,Provincia Autonoma Trento
2021-03-21,FVG,2672,1000,1672,2263,409,ITH,ITH4,6,Friuli-Venezia Giulia
2021-06-24,TOS,29331,14532,14799,19655,9676,ITI,ITI1,9,Toscana
2021-01-18,CAL,1289,583,706,1052,237,ITF,ITF6,18,Calabria
2021-04-23,LAZ,37697,18098,19599,22421,15276,ITI,ITI4,12,Lazio
2021-06-10,PAT,6125,2978,3147,1916,4209,ITH,ITH2,4,Provincia Autonoma Trento
2021-03-29,PUG,13536,6597,6939,6795,6741,ITF,ITF4,16,Puglia
2021-06-12,PIE,42466,22380,20086,39846,2620,ITC,ITC1,1,Piemonte
2021-03-05,PAB,1840,625,1215,1397,443,ITH,ITH1,4,Provincia Autonoma Bolzano / Bozen
2021-05-17,CAM,49358,21700,27658,24102,25256,ITF,ITF3,15,Campania
2021-06-23,BAS,3308,1556,1752,2433,875,ITF,ITF5,17,Basilicata
2021-01-09,TOS,4485,1596,2889,4485,0,ITI,ITI1,9,Toscana
2021-02-06,CAM,5341,2666,2675,2102,3239,ITF,ITF3,15,Campania
2021-04-13,VDA,373,171,202,329,44,ITC,ITC2,2,Valle d'Aosta / Vallée d'Aoste
2021-02-28,MAR,2836,1251,1585,2830,6,ITI,ITI3,11,Marche
2021-04-11,CAL,4180,1899,2281,2237,1943,ITF,ITF6,18,Calabria
2021-04-14,VEN,15905,6894,9011,9278,6627,ITH,ITH3,5,Veneto
2021-05-27,PAB,6087,3200,2887,4077,2010,ITH,ITH1,4,Provincia Autonoma Bolzano / Bozen
2021-05-31,UMB,5802,2837,2965,4918,884,ITI,ITI2,10,Umbria
2021-03-12,PUG,14275,6434,7841,10347,3928,ITF,ITF4,16,Puglia
2021-04-16,SAR,14446,6490,7956,9102,5344,ITG,ITG2,20,Sardegna
2021-01-04,VEN,6734,2033,4701,6734,0,ITH,ITH3,5,Veneto
2021-03-27,VDA,333,164,169,302,31,ITC,ITC2,2,Valle d'Aosta / Vallée d'Aoste
2021-06-08,MAR,13914,7013,6901,11303,2611,ITI,ITI3,11,Marche
2021-05-14,UMB,5321,2507,2814,3504,1817,ITI,ITI2,10,Umbria
2021-06-13,PAB,3618,2018,1600,427,3191,ITH,ITH1,4,Provincia Autonoma Bolzano / Bozen
2021-02-07,MOL,66,32,34,19,47,ITF,ITF2,14,Molise
2021-05-18,MOL,1645,877,768,990,655,ITF,ITF2,14,Molise
2021-05-19,PIE,33157,15307,17850,22032,11125,ITC,ITC1,1,Piemonte
2021-02-13,SIC,2977,1123,1854,2722,255,ITG,ITG1,19,Sicilia
2021-05-24,LOM,89502,43479,46023,49511,39991,ITC,ITC4,3,Lombardia
2021-03-22,MOL,1148,440,708,905,243,ITF,ITF2,14,Molise
2021-02-18,EMR,7039,2892,4147,6456,583,ITH,ITH5,8,Emilia-Romagna
2021-05-04,BAS,4137,1991,2146,3614,523,ITF,ITF5,17,Basilicata
2021-03-14,PIE,8205,3336,4869,5308,2897,ITC,ITC1,1,Piemonte
2021-04-09,SAR,12305,5471,6834,7952,4353,ITG,ITG2,20,Sardegna
2021-03-08,BAS,1460,713,747,847,613,ITF,ITF5,17,Basilicata
2021-06-24,FVG,10773,5447,5326,1901,8872,ITH,ITH4,6,Friuli-Venezia Giulia
2021-05-10,PIE,28945,13955,14990,15832,13113,ITC,ITC1,1,Piemonte
2021-06-06,PAB,4530,2176,2354,855,3675,ITH,ITH1,4,Provincia Autonoma Bolzano / Bozen
2021-05-24,SIC,35705,17312,18393,15718,19987,ITG,ITG1,19,Sicilia
2021-01-30,PIE,5980,2136,3844,218,5762,ITC,ITC1,1,Piemonte
2021-02-26,PAB,1526,551,975,1496,30,ITH,ITH1,4,Provincia Autonoma Bolzano / Bozen
2021-03-05,PUG,17685,7167,10518,15380,2305,ITF,ITF4,16,Puglia
2021-02-11,LOM,17078,5010,12068,9707,7371,ITC,ITC4,3,Lombardia
2021-04-07,TOS,35823,15461,20362,28575,7248,ITI,ITI1,9,Toscana
2021-01-06,CAL,931,502,429,931,0,ITF,ITF6,18,Calabria
2021-02-26,PUG,13762,5054,8708,12728,1034,ITF,ITF4,16,Puglia
2020-12-31,PUG,1634,782,852,1634,0,ITF,ITF4,16,Puglia
2021-02-16,LIG,2426,956,1470,2004,422,ITC,ITC3,7,Liguria
2021-03-16,FVG,3155,1288,1867,1074,2081,ITH,ITH4,6,Friuli-Venezia Giulia
2021-06-16,BAS,4590,2082,2508,2136,2454,ITF,ITF5,17,Basilicata
2021-05-12,FVG,10867,5034,5833,9460,1407,ITH,ITH4,6,Friuli-Venezia Giulia
2021-05-27,LIG,16869,8648,8221,12724,4145,ITC,ITC3,7,Liguria
2021-02-25,VEN,7898,3339,4559,7293,605,ITH,ITH3,5,Veneto
2021-03-09,PAT,1584,590,994,939,645,ITH,ITH2,4,Provincia Autonoma Trento
2021-03-23,UMB,3790,1682,2108,2161,1629,ITI,ITI2,10,Umbria
2021-05-04,ABR,10751,5051,5700,7135,3616,ITF,ITF1,13,Abruzzo
2021-05-17,LAZ,44505,20368,24137,35934,8571,ITI,ITI4,12,Lazio
2021-05-27,MAR,13731,6816,6915,9430,4301,ITI,ITI3,11,Marche
2021-06-07,EMR,40381,20724,19657,34134,6247,ITH,ITH5,8,Emilia-Romagna
2021-06-17,PAT,6591,3456,3135,2115,4476,ITH,ITH2,4,Provincia Autonoma Trento
2021-02-11,CAM,6279,2704,3575,6213,66,ITF,ITF3,15,Campania
2021-03-08,ABR,5148,1693,3455,4178,970,ITF,ITF1,13,Abruzzo
2021-03-31,MAR,7373,3085,4288,4349,3024,ITI,ITI3,11,Marche
2021-04-14,LIG,13068,5667,7401,10866,2202,ITC,ITC3,7,Liguria
2021-07-01,UMB,9394,4655,4739,3380,6014,ITI,ITI2,10,Umbria
2021-02-03,VDA,351,114,237,14,337,ITC,ITC2,2,Valle d'Aosta / Vallée d'Aoste
2021-04-09,VEN,31192,13763,17429,22847,8345,ITH,ITH3,5,Veneto
2021-04-16,CAL,10214,4979,5235,8628,1586,ITF,ITF6,18,Calabria
2021-06-01,PAB,3558,2317,1241,2086,1472,ITH,ITH1,4,Provincia Autonoma Bolzano / Bozen
2021-02-08,UMB,635,203,432,88,547,ITI,ITI2,10,Umbria
2021-04-11,SAR,5394,2443,2951,4274,1120,ITG,ITG2,20,Sardegna
2021-06-24,PIE,39001,19535,19466,18820,20181,ITC,ITC1,1,Piemonte
2021-02-18,CAL,1849,848,1001,1621,228,ITF,ITF6,18,Calabria
2021-04-01,VDA,777,394,383,765,12,ITC,ITC2,2,Valle d'Aosta / Vallée d'Aoste
2021-06-05,VEN,46689,24047,22642,38662,8027,ITH,ITH3,5,Veneto
2021-01-24,ABR,50,22,28,6,44,ITF,ITF1,13,Abruzzo
2021-02-06,LAZ,6159,2492,3667,840,5319,ITI,ITI4,12,Lazio
2021-03-16,PIE,10523,4269,6254,4463,6060,ITC,ITC1,1,Piemonte
2021-05-19,UMB,9411,4211,5200,5668,3743,ITI,ITI2,10,Umbria
2021-06-07,SAR,12557,6142,6415,9553,3004,ITG,ITG2,20,Sardegna
2021-06-15,PUG,42095,20577,21518,22567,19528,ITF,ITF4,16,Puglia
2021-06-08,PUG,38997,18962,20035,21290,17707,ITF,ITF4,16,Puglia
2021-05-12,PIE,31898,15196,16702,18994,12904,ITC,ITC1,1,Piemonte
2021-02-19,PAB,2252,512,1740,2241,11,ITH,ITH1,4,Provincia Autonoma Bolzano / Bozen
2021-05-29,LIG,6863,3251,3612,3993,2870,ITC,ITC3,7,Liguria
2021-05-31,LOM,95627,47391,48236,79445,16182,ITC,ITC4,3,Lombardia
2021-06-21,CAL,15050,6905,8145,7720,7330,ITF,ITF6,18,Calabria
2021-02-04,SAR,2272,816,1456,916,1356,ITG,ITG2,20,Sardegna
2021-03-01,ABR,3478,1385,2093,2727,751,ITF,ITF1,13,Abruzzo
2021-04-02,SAR,8992,3548,5444,5751,3241,ITG,ITG2,20,Sardegna
2021-02-06,UMB,396,138,258,34,362,ITI,ITI2,10,Umbria
2021-03-14,PAT,108,65,43,21,87,ITH,ITH2,4,Provincia Autonoma Trento
2021-05-17,SIC,31916,15383,16533,19231,12685,ITG,ITG1,19,Sicilia
2021-06-12,TOS,29378,15144,14234,24992,4386,ITI,ITI1,9,Toscana
2021-03-21,SIC,15217,7340,7877,11248,3969,ITG,ITG1,19,Sicilia
2021-04-16,TOS,28894,12861,16033,22018,6876,ITI,ITI1,9,Toscana
2021-06-18,ABR,9981,4906,5075,6520,3461,ITF,ITF1,13,Abruzzo
2021-03-26,LOM,41288,15690,25598,28148,13140,ITC,ITC4,3,Lombardia
2021-01-04,CAL,1068,529,539,1068,0,ITF,ITF6,18,Calabria
2021-02-06,SIC,4699,2099,2600,1465,3234,ITG,ITG1,19,Sicilia
2021-05-22,LOM,70570,33827,36743,32427,38143,ITC,ITC4,3,Lombardia
2021-02-11,LAZ,7000,3012,3988,6467,533,ITI,ITI4,12,Lazio
2021-05-20,MOL,2661,1371,1290,2475,186,ITF,ITF2,14,Molise
2021-02-09,LIG,1941,690,1251,257,1684,ITC,ITC3,7,Liguria
2021-04-11,LAZ,19155,8470,10685,13274,5881,ITI,ITI4,12,Lazio
2021-04-16,CAM,34321,16559,17762,23656,10665,ITF,ITF3,15,Campania
2021-05-19,FVG,12036,5934,6102,9692,2344,ITH,ITH4,6,Friuli-Venezia Giulia
2021-06-09,BAS,4493,2084,2409,3999,494,ITF,ITF5,17,Basilicata
2021-06-13,PUG,21636,10836,10800,16461,5175,ITF,ITF4,16,Puglia
2021-04-23,CAL,13117,6439,6678,9524,3593,ITF,ITF6,18,Calabria
2021-01-06,CAM,7652,3749,3903,7652,0,ITF,ITF3,15,Campania
2021-02-13,LAZ,6612,2627,3985,6194,418,ITI,ITI4,12,Lazio
2021-04-13,BAS,2112,1050,1062,1295,817,ITF,ITF5,17,Basilicata
2021-05-29,LOM,88292,42404,45888,42240,46052,ITC,ITC4,3,Lombardia
2021-02-18,LOM,14050,4924,9126,13014,1036,ITC,ITC4,3,Lombardia
2021-03-07,PAT,22,6,16,22,0,ITH,ITH2,4,Provincia Autonoma Trento
2021-03-01,BAS,548,284,264,382,166,ITF,ITF5,17,Basilicata
2021-03-29,MAR,5867,2569,3298,3439,2428,ITI,ITI3,11,Marche
2021-01-09,PAT,190,40,150,190,0,ITH,ITH2,4,Provincia Autonoma Trento
2021-01-13,CAL,2046,1032,1014,2046,0,ITF,ITF6,18,Calabria
2021-02-24,VDA,183,82,101,164,19,ITC,ITC2,2,Valle d'Aosta / Vallée d'Aoste
2021-02-12,PAB,730,217,513,482,248,ITH,ITH1,4,Provincia Autonoma Bolzano / Bozen
2021-03-23,PIE,13120,5491,7629,6875,6245,ITC,ITC1,1,Piemonte
2021-04-19,PUG,27646,12851,14795,24603,3043,ITF,ITF4,16,Puglia
2021-04-10,PAB,5391,2664,2727,4803,588,ITH,ITH1,4,Provincia Autonoma Bolzano / Bozen
2021-06-07,CAM,55725,26790,28935,51692,4033,ITF,ITF3,15,Campania
2021-04-06,UMB,5287,2165,3122,2900,2387,ITI,ITI2,10,Umbria
2021-05-20,MAR,12390,5827,6563,7688,4702,ITI,ITI3,11,Marche
2021-01-10,ABR,1139,409,730,1139,0,ITF,ITF1,13,Abruzzo
2021-05-30,VDA,865,429,436,694,171,ITC,ITC2,2,Valle d'Aosta / Vallée d'Aoste
2021-06-14,CAL,13989,6338,7651,9355,4634,ITF,ITF6,18,Calabria
2021-01-16,PIE,7771,2630,5141,7771,0,ITC,ITC1,1,Piemonte
2021-02-11,SAR,1315,490,825,1204,111,ITG,ITG2,20,Sardegna
2021-01-23,PAT,577,334,243,388,189,ITH,ITH2,4,Provincia Autonoma Trento
2021-01-30,SIC,7691,3534,4157,168,7523,ITG,ITG1,19,Sicilia
2021-03-28,UMB,1095,441,654,1071,24,ITI,ITI2,10,Umbria
2021-04-28,FVG,7285,3219,4066,3797,3488,ITH,ITH4,6,Friuli-Venezia Giulia
2021-04-29,ABR,12671,5850,6821,9576,3095,ITF,ITF1,13,Abruzzo
2021-06-05,LIG,8089,4115,3974,4937,3152,ITC,ITC3,7,Liguria
2021-01-30,UMB,1575,486,1089,44,1531,ITI,ITI2,10,Umbria
2021-04-09,LIG,12449,5557,6892,10683,1766,ITC,ITC3,7,Liguria
2021-05-03,PAT,4259,2197,2062,4105,154,ITH,ITH2,4,Provincia Autonoma Trento
2021-06-05,TOS,28409,13588,14821,20801,7608,ITI,ITI1,9,Toscana
2020-12-31,PAB,913,519,394,913,0,ITH,ITH1,4,Provincia Autonoma Bolzano / Bozen
2021-02-04,LOM,27811,8109,19702,2013,25798,ITC,ITC4,3,Lombardia
2021-03-28,SIC,10960,5141,5819,6949,4011,ITG,ITG1,19,Sicilia
2021-06-25,ABR,10781,5320,5461,4802,5979,ITF,ITF1,13,Abruzzo
2021-03-04,CAL,5483,3191,2292,4686,797,ITF,ITF6,18,Calabria
2021-02-20,LAZ,9207,4274,4933,8436,771,ITI,ITI4,12,Lazio
2021-02-25,CAM,12425,4478,7947,11237,1188,ITF,ITF3,15,Campania
2021-03-31,LIG,11923,5273,6650,9153,2770,ITC,ITC3,7,Liguria
2021-04-24,PUG,29353,13366,15987,25408,3945,ITF,ITF4,16,Puglia
2021-04-09,LOM,52367,22364,30003,36376,15991,ITC,ITC4,3,Lombardia
2021-06-12,CAL,12882,6134,6748,10485,2397,ITF,ITF6,18,Calabria
2021-05-31,LAZ,51458,22841,28617,31794,19664,ITI,ITI4,12,Lazio
2021-01-10,BAS,77,24,53,77,0,ITF,ITF5,17,Basilicata
2021-01-15,ABR,379,149,230,379,0,ITF,ITF1,13,Abruzzo
2021-02-07,MAR,1871,735,1136,344,1527,ITI,ITI3,11,Marche
2021-04-20,BAS,4035,1921,2114,2202,1833,ITF,ITF5,17,Basilicata
2021-01-11,TOS,5094,1691,3403,5094,0,ITI,ITI1,9,Toscana
2021-04-11,EMR,15277,6934,8343,12229,3048,ITH,ITH5,8,Emilia-Romagna
2021-04-19,PAB,1872,858,1014,1690,182,ITH,ITH1,4,Provincia Autonoma Bolzano / Bozen
2021-05-28,VDA,975,414,561,563,412,ITC,ITC2,2,Valle d'Aosta / Vallée d'Aoste
2021-05-24,SAR,14478,7261,7217,8495,5983,ITG,ITG2,20,Sardegna
2021-02-17,VDA,327,144,183,227,100,ITC,ITC2,2,Valle d'Aosta / Vallée d'Aoste
2021-04-21,TOS,29555,12651,16904,17481,12074,ITI,ITI1,9,Toscana
2021-04-23,VEN,31238,13837,17401,22529,8709,ITH,ITH3,5,Veneto
2021-06-15,PAB,1999,1156,843,468,1531,ITH,ITH1,4,Provincia Autonoma Bolzano / Bozen
2021-01-23,FVG,816,324,492,4,812,ITH,ITH4,6,Friuli-Venezia Giulia
2021-02-13,SAR,1456,565,891,1454,2,ITG,ITG2,20,Sardegna
2021-02-23,TOS,7722,3325,4397,7561,161,ITI,ITI1,9,Toscana
2021-07-01,PAT,5792,3034,2758,3136,2656,ITH,ITH2,4,Provincia Autonoma Trento
2021-04-04,LAZ,17531,8104,9427,12266,5265,ITI,ITI4,12,Lazio
2021-04-09,CAM,30044,14152,15892,23910,6134,ITF,ITF3,15,Campania
2021-04-05,MOL,391,189,202,292,99,ITF,ITF2,14,Molise
2021-05-05,PAT,4988,2580,2408,4692,296,ITH,ITH2,4,Provincia Autonoma Trento
2021-06-03,TOS,31975,15404,16571,27430,4545,ITI,ITI1,9,Toscana
2021-06-05,CAM,77027,37282,39745,71004,6023,ITF,ITF3,15,Campania
2021-01-08,BAS,554,219,335,554,0,ITF,ITF5,17,Basilicata
2021-03-29,MOL,2033,835,1198,1547,486,ITF,ITF2,14,Molise
2021-02-16,VEN,6644,2870,3774,6468,176,ITH,ITH3,5,Veneto
2021-04-04,LOM,7611,3230,4381,3716,3895,ITC,ITC4,3,Lombardia
2021-01-31,MOL,268,70,198,6,262,ITF,ITF2,14,Molise
2021-02-11,EMR,4254,1415,2839,3413,841,ITH,ITH5,8,Emilia-Romagna
2021-04-27,ABR,9085,4368,4717,6618,2467,ITF,ITF1,13,Abruzzo
2021-06-14,CAM,36693,17714,18979,18713,17980,ITF,ITF3,15,Campania
2021-03-15,BAS,2360,986,1374,524,1836,ITF,ITF5,17,Basilicata
2021-05-29,SAR,17994,8648,9346,13401,4593,ITG,ITG2,20,Sardegna
2021-01-16,PAT,319,148,171,319,0,ITH,ITH2,4,Provincia Autonoma Trento
2021-01-17,BAS,328,133,195,327,1,ITF,ITF5,17,Basilicata
2021-05-05,FVG,9757,4262,5495,6289,3468,ITH,ITH4,6,Friuli-Venezia Giulia
2021-02-18,SAR,1878,732,1146,1814,64,ITG,ITG2,20,Sardegna
2021-04-04,SIC,6811,3323,3488,5518,1293,ITG,ITG1,19,Sicilia
2021-01-23,PIE,4257,1325,2932,879,3378,ITC,ITC1,1,Piemonte
2021-04-17,PAB,5239,2602,2637,5195,44,ITH,ITH1,4,Provincia Autonoma Bolzano / Bozen
2021-01-07,PAB,918,327,591,918,0,ITH,ITH1,4,Provincia Autonoma Bolzano / Bozen
2021-01-14,PUG,4071,1590,2481,4071,0,ITF,ITF4,16,Puglia
2021-03-21,PIE,10728,4741,5987,4195,6533,ITC,ITC1,1,Piemonte
2021-01-07,PUG,5718,2459,3259,5718,0,ITF,ITF4,16,Puglia
2021-01-31,MAR,1919,769,1150,103,1816,ITI,ITI3,11,Marche
2021-04-02,LOM,41181,16848,24333,26730,14451,ITC,ITC4,3,Lombardia
2021-04-17,PUG,39955,18935,21020,36387,3568,ITF,ITF4,16,Puglia
2021-02-25,CAL,2887,1554,1333,2291,596,ITF,ITF6,18,Calabria
2021-05-29,VEN,32984,16664,16320,25322,7662,ITH,ITH3,5,Veneto
2020-12-28,LIG,80,30,50,80,0,ITC,ITC3,7,Liguria
2021-01-25,FVG,1583,567,1016,194,1389,ITH,ITH4,6,Friuli-Venezia Giulia
2021-02-19,PUG,4733,2011,2722,4341,392,ITF,ITF4,16,Puglia
2021-04-27,BAS,4727,2242,2485,4402,325,ITF,ITF5,17,Basilicata
2021-06-03,LIG,15509,7681,7828,9148,6361,ITC,ITC3,7,Liguria
2021-07-01,FVG,11303,5860,5443,2595,8708,ITH,ITH4,6,Friuli-Venezia Giulia
2021-03-23,FVG,3887,1681,2206,1746,2141,ITH,ITH4,6,Friuli-Venezia Giulia
2021-04-07,LIG,13677,6107,7570,11389,2288,ITC,ITC3,7,Liguria
2021-03-15,ABR,3683,1447,2236,1876,1807,ITF,ITF1,13,Abruzzo
2021-04-07,MAR,8173,3613,4560,7826,347,ITI,ITI3,11,Marche
2021-02-10,VDA,248,77,171,141,107,ITC,ITC2,2,Valle d'Aosta / Vallée d'Aoste
2021-01-17,ABR,188,59,129,181,7,ITF,ITF1,13,Abruzzo
2021-02-09,MAR,124,42,82,46,78,ITI,ITI3,11,Marche
2021-02-23,LIG,3806,1559,2247,3697,109,ITC,ITC3,7,Liguria
2021-03-08,VDA,485,233,252,240,245,ITC,ITC2,2,Valle d'Aosta / Vallée d'Aoste
2021-04-23,UMB,6604,2782,3822,3484,3120,ITI,ITI2,10,Umbria
2021-05-12,EMR,38888,18281,20607,29223,9665,ITH,ITH5,8,Emilia-Romagna
2021-02-25,UMB,1332,495,837,1280,52,ITI,ITI2,10,Umbria
2021-05-04,VDA,1135,510,625,462,673,ITC,ITC2,2,Valle d'Aosta / Vallée d'Aoste
2021-02-01,EMR,10320,3610,6710,362,9958,ITH,ITH5,8,Emilia-Romagna
2021-06-15,MAR,12905,6413,6492,9854,3051,ITI,ITI3,11,Marche
2021-03-11,UMB,3582,1722,1860,2576,1006,ITI,ITI2,10,Umbria
2021-01-28,TOS,6282,1882,4400,354,5928,ITI,ITI1,9,Toscana
2021-05-01,MOL,2647,1268,1379,424,2223,ITF,ITF2,14,Molise
2021-01-13,UMB,449,139,310,449,0,ITI,ITI2,10,Umbria
2021-06-16,VDA,683,365,318,642,41,ITC,ITC2,2,Valle d'Aosta / Vallée d'Aoste
2021-06-19,UMB,4564,2199,2365,2534,2030,ITI,ITI2,10,Umbria
2021-03-05,MOL,1219,649,570,1015,204,ITF,ITF2,14,Molise
2021-05-31,PAT,4721,2174,2547,1676,3045,ITH,ITH2,4,Provincia Autonoma Trento
2021-01-30,CAM,10722,5080,5642,38,10684,ITF,ITF3,15,Campania
2021-03-25,BAS,1886,604,1282,1542,344,ITF,ITF5,17,Basilicata
2021-02-06,CAL,2911,1341,1570,444,2467,ITF,ITF6,18,Calabria
2021-06-13,MOL,2785,1485,1300,2460,325,ITF,ITF2,14,Molise
2021-01-27,BAS,412,175,237,113,299,ITF,ITF5,17,Basilicata
2021-04-17,MOL,3054,1501,1553,1568,1486,ITF,ITF2,14,Molise
2021-02-10,BAS,548,238,310,496,52,ITF,ITF5,17,Basilicata
2021-03-14,LIG,1659,752,907,1055,604,ITC,ITC3,7,Liguria
2021-04-11,FVG,3433,1520,1913,2527,906,ITH,ITH4,6,Friuli-Venezia Giulia
2021-01-12,MAR,1229,415,814,1229,0,ITI,ITI3,11,Marche
2021-05-21,BAS,4574,2320,2254,1491,3083,ITF,ITF5,17,Basilicata
2021-06-07,FVG,9112,4734,4378,8156,956,ITH,ITH4,6,Friuli-Venezia Giulia
2021-06-22,LIG,15575,7352,8223,8500,7075,ITC,ITC3,7,Liguria
2021-01-16,SAR,1492,525,967,1492,0,ITG,ITG2,20,Sardegna
2021-01-16,CAM,3371,1677,1694,3371,0,ITF,ITF3,15,Campania
2021-05-10,LIG,12645,5639,7006,6273,6372,ITC,ITC3,7,Liguria
2021-06-19,SIC,43734,20777,22957,18598,25136,ITG,ITG1,19,Sicilia
2021-05-05,VEN,44320,21238,23082,37749,6571,ITH,ITH3,5,Veneto
2021-04-23,SIC,28557,13694,14863,22735,5822,ITG,ITG1,19,Sicilia
2021-01-23,CAL,401,186,215,359,42,ITF,ITF6,18,Calabria
2021-07-01,VEN,46400,23761,22639,19719,26681,ITH,ITH3,5,Veneto
2021-06-07,PIE,34871,17851,17020,30083,4788,ITC,ITC1,1,Piemonte
2021-06-26,LAZ,55765,26264,29501,25061,30704,ITI,ITI4,12,Lazio
2021-01-16,LOM,15432,5734,9698,15432,0,ITC,ITC4,3,Lombardia
2021-04-30,LAZ,41357,18318,23039,27143,14214,ITI,ITI4,12,Lazio
2021-02-10,ABR,947,312,635,503,444,ITF,ITF1,13,Abruzzo
2021-01-18,EMR,3128,879,2249,2449,679,ITH,ITH5,8,Emilia-Romagna
2021-03-15,VDA,362,123,239,159,203,ITC,ITC2,2,Valle d'Aosta / Vallée d'Aoste
2021-03-16,EMR,12246,5027,7219,4938,7308,ITH,ITH5,8,Emilia-Romagna
2021-05-11,VDA,647,325,322,496,151,ITC,ITC2,2,Valle d'Aosta / Vallée d'Aoste
2021-01-25,EMR,6462,2146,4316,207,6255,ITH,ITH5,8,Emilia-Romagna
2021-06-22,MAR,12996,6374,6622,6551,6445,ITI,ITI3,11,Marche
2021-07-01,EMR,31909,15576,16333,13699,18210,ITH,ITH5,8,Emilia-Romagna
2021-01-06,UMB,846,325,521,846,0,ITI,ITI2,10,Umbria
2021-04-27,VDA,978,423,555,686,292,ITC,ITC2,2,Valle d'Aosta / Vallée d'Aoste
2021-06-12,UMB,7706,3683,4023,6129,1577,ITI,ITI2,10,Umbria
2021-03-23,EMR,18797,8144,10653,12110,6687,ITH,ITH5,8,Emilia-Romagna
2021-04-26,MAR,9122,4041,5081,6100,3022,ITI,ITI3,11,Marche
2021-01-17,VDA,131,56,75,131,0,ITC,ITC2,2,Valle d'Aosta / Vallée d'Aoste
2021-04-16,UMB,8094,3738,4356,6256,1838,ITI,ITI2,10,Umbria
2021-06-23,VDA,1043,551,492,427,616,ITC,ITC2,2,Valle d'Aosta / Vallée d'Aoste
2021-04-30,UMB,6249,2971,3278,2852,3397,ITI,ITI2,10,Umbria
2021-06-19,LAZ,60009,28071,31938,29723,30286,ITI,ITI4,12,Lazio
2021-03-19,TOS,10142,4460,5682,7274,2868,ITI,ITI1,9,Toscana
2021-06-20,MOL,421,174,247,51,370,ITF,ITF2,14,Molise
2021-03-04,UMB,4485,1855,2630,3658,827,ITI,ITI2,10,Umbria
2021-04-24,MOL,2551,1202,1349,710,1841,ITF,ITF2,14,Molise
2021-06-26,SIC,36732,17477,19255,16180,20552,ITG,ITG1,19,Sicilia
2021-01-24,PAB,12,10,2,0,12,ITH,ITH1,4,Provincia Autonoma Bolzano / Bozen
2021-01-31,PUG,1816,832,984,75,1741,ITF,ITF4,16,Puglia
2021-02-26,MOL,563,260,303,490,73,ITF,ITF2,14,Molise
2021-03-28,CAL,2691,1231,1460,1568,1123,ITF,ITF6,18,Calabria
2021-01-20,UMB,602,221,381,602,0,ITI,ITI2,10,Umbria
2021-04-30,SIC,34976,16330,18646,23971,11005,ITG,ITG1,19,Sicilia
2021-06-06,MOL,2060,1059,1001,1737,323,ITF,ITF2,14,Molise
2021-04-01,BAS,2698,1108,1590,1977,721,ITF,ITF5,17,Basilicata
2021-05-03,LIG,13279,5922,7357,6467,6812,ITC,ITC3,7,Liguria
2021-05-31,FVG,8877,4411,4466,6707,2170,ITH,ITH4,6,Friuli-Venezia Giulia
2021-02-03,BAS,669,301,368,32,637,ITF,ITF5,17,Basilicata
2021-05-12,VEN,36734,17781,18953,31628,5106,ITH,ITH3,5,Veneto
2021-03-21,LIG,550,220,330,69,481,ITC,ITC3,7,Liguria
2020-12-28,PIE,1,1,0,1,0,ITC,ITC1,1,Piemonte
2021-01-23,LIG,809,295,514,153,656,ITC,ITC3,7,Liguria
2021-06-29,LIG,14791,6998,7793,8944,5847,ITC,ITC3,7,Liguria
2021-01-09,LOM,12419,4574,7845,12419,0,ITC,ITC4,3,Lombardia
2021-01-30,CAL,2186,1152,1034,352,1834,ITF,ITF6,18,Calabria
2021-06-24,VEN,54818,27724,27094,17395,37423,ITH,ITH3,5,Veneto
2021-01-23,CAM,3839,2029,1810,273,3566,ITF,ITF3,15,Campania
2021-03-04,SIC,15071,6569,8502,10954,4117,ITG,ITG1,19,Sicilia
2021-06-26,SAR,18735,8780,9955,5510,13225,ITG,ITG2,20,Sardegna
2021-03-07,LOM,12085,5359,6726,9528,2557,ITC,ITC4,3,Lombardia
2021-03-16,VEN,12527,5353,7174,6907,5620,ITH,ITH3,5,Veneto
2021-03-21,CAM,10071,4674,5397,7681,2390,ITF,ITF3,15,Campania
2021-05-17,LIG,12024,5519,6505,8701,3323,ITC,ITC3,7,Liguria
2021-06-12,SIC,44500,21746,22754,38634,5866,ITG,ITG1,19,Sicilia
2021-01-21,TOS,1589,686,903,867,722,ITI,ITI1,9,Toscana
2021-05-07,LAZ,48216,22603,25613,30466,17750,ITI,ITI4,12,Lazio
2021-03-11,LAZ,25264,11871,13393,19034,6230,ITI,ITI4,12,Lazio
2021-03-09,EMR,14753,6019,8734,10798,3955,ITH,ITH5,8,Emilia-Romagna
2021-06-30,VDA,1117,542,575,425,692,ITC,ITC2,2,Valle d'Aosta / Vallée d'Aoste
2021-05-05,EMR,30090,13984,16106,18841,11249,ITH,ITH5,8,Emilia-Romagna
2021-02-03,ABR,2062,717,1345,419,1643,ITF,ITF1,13,Abruzzo
2021-01-12,PUG,4213,1770,2443,4213,0,ITF,ITF4,16,Puglia
2021-02-16,LOM,9506,3073,6433,9058,448,ITC,ITC4,3,Lombardia
2021-03-02,CAM,12761,4558,8203,8416,4345,ITF,ITF3,15,Campania
2021-05-20,PAB,4726,2336,2390,3257,1469,ITH,ITH1,4,Provincia Autonoma Bolzano / Bozen
2021-01-11,CAL,2167,1046,1121,2167,0,ITF,ITF6,18,Calabria
2020-12-27,ABR,37,19,18,37,0,ITF,ITF1,13,Abruzzo
2021-01-25,CAL,1076,515,561,147,929,ITF,ITF6,18,Calabria
2021-06-10,LOM,101644,51732,49912,87253,14391,ITC,ITC4,3,Lombardia
2021-06-24,SIC,41317,19140,22177,17149,24168,ITG,ITG1,19,Sicilia
2021-01-15,BAS,814,351,463,814,0,ITF,ITF5,17,Basilicata
2021-02-11,LIG,1979,767,1212,1103,876,ITC,ITC3,7,Liguria
2021-07-01,SAR,19409,9530,9879,6923,12486,ITG,ITG2,20,Sardegna
2021-03-02,LOM,22810,9701,13109,19773,3037,ITC,ITC4,3,Lombardia
2021-05-05,CAL,13539,6475,7064,8485,5054,ITF,ITF6,18,Calabria
2021-03-23,SAR,6413,2879,3534,5335,1078,ITG,ITG2,20,Sardegna
2021-05-22,LIG,6647,3218,3429,4964,1683,ITC,ITC3,7,Liguria
2021-06-07,SIC,49517,23352,26165,41614,7903,ITG,ITG1,19,Sicilia
2021-01-16,TOS,3271,1046,2225,3271,0,ITI,ITI1,9,Toscana
2021-03-20,ABR,4795,2200,2595,2624,2171,ITF,ITF1,13,Abruzzo
2021-04-16,EMR,29222,13763,15459,20386,8836,ITH,ITH5,8,Emilia-Romagna
2021-01-06,EMR,8287,2955,5332,8287,0,ITH,ITH5,8,Emilia-Romagna
2021-04-26,TOS,10137,4930,5207,7586,2551,ITI,ITI1,9,Toscana
2021-04-03,VDA,676,341,335,661,15,ITC,ITC2,2,Valle d'Aosta / Vallée d'Aoste
2021-04-04,VEN,7782,3532,4250,6634,1148,ITH,ITH3,5,Veneto
2021-02-13,UMB,114,27,87,111,3,ITI,ITI2,10,Umbria
2021-03-20,VDA,208,86,122,172,36,ITC,ITC2,2,Valle d'Aosta / Vallée d'Aoste
2021-03-30,LAZ,26795,12959,13836,19646,7149,ITI,ITI4,12,Lazio
2021-06-19,PIE,39924,20250,19674,23296,16628,ITC,ITC1,1,Piemonte
2021-01-02,TOS,3497,1096,2401,3497,0,ITI,ITI1,9,Toscana
2021-04-30,EMR,36605,16788,19817,21811,14794,ITH,ITH5,8,Emilia-Romagna
2021-05-24,UMB,9054,4509,4545,8175,879,ITI,ITI2,10,Umbria
2021-04-18,UMB,1531,681,850,601,930,ITI,ITI2,10,Umbria
2021-01-11,UMB,1303,341,962,1303,0,ITI,ITI2,10,Umbria
2021-03-28,EMR,13499,6025,7474,9629,3870,ITH,ITH5,8,Emilia-Romagna
2021-04-07,PUG,15699,7125,8574,9021,6678,ITF,ITF4,16,Puglia
2020-12-27,BAS,106,41,65,106,0,ITF,ITF5,17,Basilicata
2021-01-26,MOL,450,184,266,8,442,ITF,ITF2,14,Molise
2021-06-28,VDA,986,496,490,329,657,ITC,ITC2,2,Valle d'Aosta / Vallée d'Aoste
2021-02-04,FVG,2725,808,1917,35,2690,ITH,ITH4,6,Friuli-Venezia Giulia
2021-05-15,MAR,13970,6377,7593,8077,5893,ITI,ITI3,11,Marche
2021-05-05,UMB,7207,3298,3909,3903,3304,ITI,ITI2,10,Umbria
2021-05-06,MOL,2679,1214,1465,2081,598,ITF,ITF2,14,Molise
2021-06-11,VDA,1047,483,564,764,283,ITC,ITC2,2,Valle d'Aosta / Vallée d'Aoste
2021-04-18,LAZ,23808,10577,13231,16158,7650,ITI,ITI4,12,Lazio
2021-03-20,BAS,1294,573,721,281,1013,ITF,ITF5,17,Basilicata
2021-01-25,SIC,7420,3675,3745,292,7128,ITG,ITG1,19,Sicilia
2021-06-10,LIG,18163,9368,8795,12542,5621,ITC,ITC3,7,Liguria
2021-02-19,MAR,1990,730,1260,1855,135,ITI,ITI3,11,Marche
2021-04-30,FVG,7333,3236,4097,3696,3637,ITH,ITH4,6,Friuli-Venezia Giulia
2021-06-13,ABR,9692,4859,4833,7856,1836,ITF,ITF1,13,Abruzzo
2021-06-28,BAS,3603,1724,1879,2094,1509,ITF,ITF5,17,Basilicata
2021-01-25,UMB,648,323,325,5,643,ITI,ITI2,10,Umbria
2021-05-05,SIC,26275,12180,14095,16648,9627,ITG,ITG1,19,Sicilia
2021-03-19,LIG,5296,2234,3062,2150,3146,ITC,ITC3,7,Liguria
2021-05-19,SIC,42679,20656,22023,28320,14359,ITG,ITG1,19,Sicilia
2021-02-04,PIE,10206,3341,6865,588,9618,ITC,ITC1,1,Piemonte
2021-03-02,LIG,4074,1689,2385,3764,310,ITC,ITC3,7,Liguria
2021-03-26,PAT,3230,1256,1974,2620,610,ITH,ITH2,4,Provincia Autonoma Trento
2021-01-11,CAM,4070,1871,2199,4070,0,ITF,ITF3,15,Campania
2021-03-31,PAB,1832,694,1138,821,1011,ITH,ITH1,4,Provincia Autonoma Bolzano / Bozen
2020-12-28,LOM,107,47,60,107,0,ITC,ITC4,3,Lombardia
2021-03-02,CAL,4365,2489,1876,3610,755,ITF,ITF6,18,Calabria
2021-05-24,VEN,33020,16404,16616,8025,24995,ITH,ITH3,5,Veneto
2021-06-24,LIG,10837,5279,5558,6580,4257,ITC,ITC3,7,Liguria
2021-03-16,CAL,3855,1891,1964,2194,1661,ITF,ITF6,18,Calabria
2021-03-06,BAS,1357,536,821,760,597,ITF,ITF5,17,Basilicata
2021-04-02,LIG,11789,5219,6570,9302,2487,ITC,ITC3,7,Liguria
2021-05-12,SAR,11137,5262,5875,7997,3140,ITG,ITG2,20,Sardegna
2021-04-21,LOM,71761,32532,39229,57150,14611,ITC,ITC4,3,Lombardia
2021-05-23,VDA,999,465,534,658,341,ITC,ITC2,2,Valle d'Aosta / Vallée d'Aoste
2021-01-11,LOM,16261,5378,10883,16261,0,ITC,ITC4,3,Lombardia
2021-02-25,EMR,9250,3499,5751,8296,954,ITH,ITH5,8,Emilia-Romagna
2021-03-07,TOS,5647,2357,3290,2104,3543,ITI,ITI1,9,Toscana
2021-06-19,PAT,3097,1695,1402,255,2842,ITH,ITH2,4,Provincia Autonoma Trento
2021-01-28,LOM,12223,3703,8520,801,11422,ITC,ITC4,3,Lombardia
2021-01-29,VDA,318,138,180,2,316,ITC,ITC2,2,Valle d'Aosta / Vallée d'Aoste
2021-04-30,PIE,31846,14329,17517,18511,13335,ITC,ITC1,1,Piemonte
2021-05-19,LAZ,47121,21631,25490,37019,10102,ITI,ITI4,12,Lazio
2021-06-19,EMR,35986,18012,17974,16648,19338,ITH,ITH5,8,Emilia-Romagna
2021-04-04,UMB,57,20,37,22,35,ITI,ITI2,10,Umbria
2021-01-29,ABR,1387,449,938,74,1313,ITF,ITF1,13,Abruzzo
2021-03-11,EMR,17453,7306,10147,11602,5851,ITH,ITH5,8,Emilia-Romagna
2021-04-22,VDA,1068,450,618,685,383,ITC,ITC2,2,Valle d'Aosta / Vallée d'Aoste
2021-06-07,UMB,6941,3425,3516,6248,693,ITI,ITI2,10,Umbria
2021-05-09,VDA,574,287,287,444,130,ITC,ITC2,2,Valle d'Aosta / Vallée d'Aoste
2021-01-04,LAZ,7485,2909,4576,7485,0,ITI,ITI4,12,Lazio
2021-02-06,EMR,7581,2401,5180,2110,5471,ITH,ITH5,8,Emilia-Romagna
2021-03-16,UMB,3538,1454,2084,1911,1627,ITI,ITI2,10,Umbria
2021-03-17,MOL,908,385,523,576,332,ITF,ITF2,14,Molise
2021-05-27,PUG,40568,19149,21419,23352,17216,ITF,ITF4,16,Puglia
2021-06-24,LAZ,62605,29604,33001,28920,33685,ITI,ITI4,12,Lazio
2021-06-07,LAZ,62122,29010,33112,33011,29111,ITI,ITI4,12,Lazio
2021-06-25,MOL,3410,1680,1730,1513,1897,ITF,ITF2,14,Molise
2021-02-27,UMB,1658,354,1304,1642,16,ITI,ITI2,10,Umbria
2021-04-21,LIG,14247,6433,7814,8920,5327,ITC,ITC3,7,Liguria
2020-12-28,SAR,65,25,40,65,0,ITG,ITG2,20,Sardegna
2020-12-31,MAR,391,183,208,391,0,ITI,ITI3,11,Marche
2021-05-13,PAB,2994,1355,1639,1064,1930,ITH,ITH1,4,Provincia Autonoma Bolzano / Bozen
2021-01-11,SIC,5823,2571,3252,5823,0,ITG,ITG1,19,Sicilia
2021-01-30,VEN,8747,2672,6075,693,8054,ITH,ITH3,5,Veneto
2021-04-10,ABR,8774,4058,4716,6266,2508,ITF,ITF1,13,Abruzzo
2021-01-25,LAZ,8111,3246,4865,770,7341,ITI,ITI4,12,Lazio
2021-06-17,LOM,107735,52318,55417,53481,54254,ITC,ITC4,3,Lombardia
2021-05-05,LAZ,46781,21461,25320,30951,15830,ITI,ITI4,12,Lazio
2021-03-09,LOM,33216,12861,20355,25821,7395,ITC,ITC4,3,Lombardia
2021-05-05,LOM,87917,41917,46000,72610,15307,ITC,ITC4,3,Lombardia
2021-07-01,LOM,79905,39794,40111,37155,42750,ITC,ITC4,3,Lombardia
2021-03-13,VDA,147,88,59,147,0,ITC,ITC2,2,Valle d'Aosta / Vallée d'Aoste
2021-03-28,TOS,6212,2808,3404,5958,254,ITI,ITI1,9,Toscana
2021-05-29,PAT,2236,1167,1069,840,1396,ITH,ITH2,4,Provincia Autonoma Trento
2021-06-26,EMR,35920,18200,17720,20467,15453,ITH,ITH5,8,Emilia-Romagna
2021-02-11,FVG,1930,664,1266,1738,192,ITH,ITH4,6,Friuli-Venezia Giulia
2021-03-02,LAZ,17188,7606,9582,13253,3935,ITI,ITI4,12,Lazio
2021-03-12,MAR,4642,1973,2669,3402,1240,ITI,ITI3,11,Marche
2021-01-30,TOS,4622,1622,3000,197,4425,ITI,ITI1,9,Toscana
2021-04-02,PAT,2845,1157,1688,2170,675,ITH,ITH2,4,Provincia Autonoma Trento
2021-01-14,MAR,2010,692,1318,2010,0,ITI,ITI3,11,Marche
2021-04-09,FVG,7901,3653,4248,6655,1246,ITH,ITH4,6,Friuli-Venezia Giulia
2021-05-23,BAS,4517,2302,2215,1533,2984,ITF,ITF5,17,Basilicata
2021-06-20,MAR,10964,5445,5519,5980,4984,ITI,ITI3,11,Marche
2021-04-16,PAT,2866,1360,1506,2721,145,ITH,ITH2,4,Provincia Autonoma Trento
2021-05-10,TOS,26184,12383,13801,15567,10617,ITI,ITI1,9,Toscana
2021-01-18,LAZ,6267,2557,3710,5289,978,ITI,ITI4,12,Lazio
2021-04-25,UMB,4357,1684,2673,4275,82,ITI,ITI2,10,Umbria
2021-01-15,VDA,218,82,136,218,0,ITC,ITC2,2,Valle d'Aosta / Vallée d'Aoste
2021-02-18,PAT,1208,426,782,1146,62,ITH,ITH2,4,Provincia Autonoma Trento
2021-03-14,TOS,7174,2569,4605,3239,3935,ITI,ITI1,9,Toscana
2021-03-31,PUG,14553,6818,7735,8993,5560,ITF,ITF4,16,Puglia
2021-04-28,LAZ,32927,15026,17901,21357,11570,ITI,ITI4,12,Lazio
2021-03-07,VEN,4493,1768,2725,3932,561,ITH,ITH3,5,Veneto
2021-04-29,PAB,2632,1351,1281,1938,694,ITH,ITH1,4,Provincia Autonoma Bolzano / Bozen
2021-05-19,CAL,18320,9074,9246,11352,6968,ITF,ITF6,18,Calabria
2021-01-14,LIG,2981,1055,1926,2981,0,ITC,ITC3,7,Liguria
2021-02-02,PUG,4344,1846,2498,592,3752,ITF,ITF4,16,Puglia
2021-05-12,CAM,40885,19949,20936,31730,9155,ITF,ITF3,15,Campania
2021-01-19,PAB,853,371,482,723,130,ITH,ITH1,4,Provincia Autonoma Bolzano / Bozen
2021-03-03,MOL,672,316,356,590,82,ITF,ITF2,14,Molise
2021-03-23,CAL,5245,2460,2785,3436,1809,ITF,ITF6,18,Calabria
2021-05-03,VEN,40689,19805,20884,34226,6463,ITH,ITH3,5,Veneto
2021-06-25,PAB,4070,2246,1824,1064,3006,ITH,ITH1,4,Provincia Autonoma Bolzano / Bozen
2021-05-13,PUG,38669,17243,21426,21509,17160,ITF,ITF4,16,Puglia
2021-06-21,UMB,7491,3925,3566,5154,2337,ITI,ITI2,10,Umbria
2021-01-05,MOL,449,180,269,449,0,ITF,ITF2,14,Molise
2020-12-30,FVG,626,244,382,626,0,ITH,ITH4,6,Friuli-Venezia Giulia
2021-03-17,PUG,10345,4701,5644,4171,6174,ITF,ITF4,16,Puglia
2021-03-27,BAS,2248,860,1388,1820,428,ITF,ITF5,17,Basilicata
2021-04-21,SAR,12077,5559,6518,6543,5534,ITG,ITG2,20,Sardegna
2021-04-24,MAR,12127,5346,6781,7663,4464,ITI,ITI3,11,Marche
2021-06-05,FVG,10288,5317,4971,8740,1548,ITH,ITH4,6,Friuli-Venezia Giulia
2021-01-11,SAR,1183,505,678,1183,0,ITG,ITG2,20,Sardegna
2021-02-25,FVG,3165,1652,1513,3136,29,ITH,ITH4,6,Friuli-Venezia Giulia
2021-02-26,MAR,3660,1514,2146,3184,476,ITI,ITI3,11,Marche
2021-03-12,LIG,6216,2873,3343,3745,2471,ITC,ITC3,7,Liguria
2021-06-17,SAR,18448,8525,9923,10034,8414,ITG,ITG2,20,Sardegna
2021-03-27,LAZ,26325,10663,15662,19850,6475,ITI,ITI4,12,Lazio
2021-07-01,LIG,12928,6191,6737,7182,5746,ITC,ITC3,7,Liguria
2021-02-09,PAB,317,126,191,1,316,ITH,ITH1,4,Provincia Autonoma Bolzano / Bozen
2021-03-31,VDA,555,302,253,529,26,ITC,ITC2,2,Valle d'Aosta / Vallée d'Aoste
2021-04-17,ABR,7357,3401,3956,4304,3053,ITF,ITF1,13,Abruzzo
2021-05-19,LIG,13571,5962,7609,10452,3119,ITC,ITC3,7,Liguria
2021-06-16,FVG,12024,5839,6185,4064,7960,ITH,ITH4,6,Friuli-Venezia Giulia
2021-01-25,SAR,591,214,377,22,569,ITG,ITG2,20,Sardegna
2021-02-19,ABR,3300,1551,1749,3200,100,ITF,ITF1,13,Abruzzo
2021-03-23,LIG,9268,4218,5050,6059,3209,ITC,ITC3,7,Liguria
2021-05-23,LAZ,47085,22841,24244,39705,7380,ITI,ITI4,12,Lazio
2021-05-27,VDA,1089,497,592,586,503,ITC,ITC2,2,Valle d'Aosta / Vallée d'Aoste
2021-05-13,VDA,1139,556,583,540,599,ITC,ITC2,2,Valle d'Aosta / Vallée d'Aoste
2021-05-12,MAR,10425,4687,5738,4924,5501,ITI,ITI3,11,Marche
2021-05-28,VEN,46668,22857,23811,24844,21824,ITH,ITH3,5,Veneto
2021-01-07,BAS,641,319,322,641,0,ITF,ITF5,17,Basilicata
2021-01-06,PAT,42,13,29,42,0,ITH,ITH2,4,Provincia Autonoma Trento
2021-01-18,LOM,9202,2972,6230,8227,975,ITC,ITC4,3,Lombardia
2021-02-02,VDA,272,70,202,2,270,ITC,ITC2,2,Valle d'Aosta / Vallée d'Aoste
2021-05-09,LAZ,37541,17259,20282,26269,11272,ITI,ITI4,12,Lazio
2021-05-16,SAR,8222,3831,4391,6062,2160,ITG,ITG2,20,Sardegna
2021-06-25,VDA,977,445,532,324,653,ITC,ITC2,2,Valle d'Aosta / Vallée d'Aoste
2021-01-13,PIE,10085,3226,6859,10085,0,ITC,ITC1,1,Piemonte
2021-06-16,PIE,40329,20217,20112,24088,16241,ITC,ITC1,1,Piemonte
2021-05-10,MOL,2890,1285,1605,2517,373,ITF,ITF2,14,Molise
2021-06-29,MOL,2453,1143,1310,399,2054,ITF,ITF2,14,Molise
2021-03-23,LOM,42571,15466,27105,29712,12859,ITC,ITC4,3,Lombardia
2021-05-03,MOL,2485,1165,1320,2322,163,ITF,ITF2,14,Molise
2021-05-16,SIC,33141,16138,17003,21815,11326,ITG,ITG1,19,Sicilia
2021-02-15,CAL,1147,543,604,997,150,ITF,ITF6,18,Calabria
2021-03-06,UMB,4304,1146,3158,4166,138,ITI,ITI2,10,Umbria
2021-03-25,EMR,21481,9417,12064,14492,6989,ITH,ITH5,8,Emilia-Romagna
2021-02-19,BAS,1623,738,885,1561,62,ITF,ITF5,17,Basilicata
2021-05-21,EMR,39257,17530,21727,22235,17022,ITH,ITH5,8,Emilia-Romagna
2021-01-22,UMB,276,105,171,32,244,ITI,ITI2,10,Umbria
2021-05-02,SIC,24601,11427,13174,18000,6601,ITG,ITG1,19,Sicilia
2021-06-28,UMB,9654,4774,4880,3759,5895,ITI,ITI2,10,Umbria
2021-02-10,EMR,4022,1385,2637,2766,1256,ITH,ITH5,8,Emilia-Romagna
2021-01-07,ABR,1605,553,1052,1605,0,ITF,ITF1,13,Abruzzo
2021-05-02,UMB,3780,1866,1914,1326,2454,ITI,ITI2,10,Umbria
2021-05-24,CAL,17709,8837,8872,10014,7695,ITF,ITF6,18,Calabria
2021-06-26,CAM,61838,30165,31673,14002,47836,ITF,ITF3,15,Campania
2021-01-09,LIG,1335,481,854,1335,0,ITC,ITC3,7,Liguria
2021-02-15,VDA,264,136,128,229,35,ITC,ITC2,2,Valle d'Aosta / Vallée d'Aoste
2021-03-18,UMB,2965,1171,1794,1703,1262,ITI,ITI2,10,Umbria
2021-06-02,EMR,24080,12054,12026,19114,4966,ITH,ITH5,8,Emilia-Romagna
2021-04-19,LIG,12829,5615,7214,9000,3829,ITC,ITC3,7,Liguria
2021-05-01,PAB,2104,1067,1037,1944,160,ITH,ITH1,4,Provincia Autonoma Bolzano / Bozen
2021-05-07,CAL,16117,7593,8524,9733,6384,ITF,ITF6,18,Calabria
2021-05-08,PUG,54248,22965,31283,24524,29724,ITF,ITF4,16,Puglia
2021-06-26,UMB,9288,4720,4568,5674,3614,ITI,ITI2,10,Umbria
2021-02-18,TOS,8822,3285,5537,7926,896,ITI,ITI1,9,Toscana
2021-04-04,CAM,7967,4018,3949,6920,1047,ITF,ITF3,15,Campania
2021-01-02,MAR,456,141,315,456,0,ITI,ITI3,11,Marche
2021-02-13,CAL,1398,604,794,1033,365,ITF,ITF6,18,Calabria
2021-05-11,BAS,2653,1353,1300,1620,1033,ITF,ITF5,17,Basilicata
2021-05-29,TOS,31546,15252,16294,23393,8153,ITI,ITI1,9,Toscana
2021-06-10,VEN,51749,26741,25008,42536,9213,ITH,ITH3,5,Veneto
2021-06-12,SAR,14744,7187,7557,10044,4700,ITG,ITG2,20,Sardegna
2021-02-17,ABR,2071,948,1123,1789,282,ITF,ITF1,13,Abruzzo
2021-03-04,SAR,4365,2293,2072,3109,1256,ITG,ITG2,20,Sardegna
2021-04-02,VEN,24056,10602,13454,17728,6328,ITH,ITH3,5,Veneto
2021-04-16,SIC,28525,14327,14198,20256,8269,ITG,ITG1,19,Sicilia
2021-05-17,PIE,30916,14600,16316,17761,13155,ITC,ITC1,1,Piemonte
2021-06-12,CAM,60464,29730,30734,53254,7210,ITF,ITF3,15,Campania
2021-02-06,PIE,7995,2666,5329,400,7595,ITC,ITC1,1,Piemonte
2021-01-23,SIC,4431,2279,2152,206,4225,ITG,ITG1,19,Sicilia
2021-02-23,PIE,9234,3713,5521,8653,581,ITC,ITC1,1,Piemonte
2021-03-04,CAM,14707,5396,9311,8813,5894,ITF,ITF3,15,Campania
2021-03-12,PAB,1664,734,930,1251,413,ITH,ITH1,4,Provincia Autonoma Bolzano / Bozen
2021-03-21,SAR,4030,1809,2221,2590,1440,ITG,ITG2,20,Sardegna
2021-06-11,ABR,11544,5751,5793,8796,2748,ITF,ITF1,13,Abruzzo
2021-01-06,SIC,6240,3284,2956,6240,0,ITG,ITG1,19,Sicilia
2021-03-29,PAB,1171,499,672,412,759,ITH,ITH1,4,Provincia Autonoma Bolzano / Bozen
2021-05-31,PIE,29097,14054,15043,20523,8574,ITC,ITC1,1,Piemonte
2021-06-17,PIE,40958,20567,20391,24662,16296,ITC,ITC1,1,Piemonte
2021-01-18,PAT,643,154,489,588,55,ITH,ITH2,4,Provincia Autonoma Trento
2021-06-12,LOM,88518,47650,40868,85451,3067,ITC,ITC4,3,Lombardia
2021-03-09,PIE,14064,5515,8549,11721,2343,ITC,ITC1,1,Piemonte
2021-06-29,LOM,102264,50689,51575,54792,47472,ITC,ITC4,3,Lombardia
2021-03-21,LOM,23511,8493,15018,18318,5193,ITC,ITC4,3,Lombardia
2021-05-11,ABR,10751,5113,5638,5906,4845,ITF,ITF1,13,Abruzzo
2021-04-02,SIC,13876,6540,7336,9143,4733,ITG,ITG1,19,Sicilia
2021-02-10,SIC,4355,1777,2578,3973,382,ITG,ITG1,19,Sicilia
2021-03-23,TOS,9399,4375,5024,7125,2274,ITI,ITI1,9,Toscana
2021-06-24,MOL,3300,1540,1760,468,2832,ITF,ITF2,14,Molise
2021-03-07,MAR,5181,2107,3074,4427,754,ITI,ITI3,11,Marche
2021-03-13,EMR,16137,6362,9775,10824,5313,ITH,ITH5,8,Emilia-Romagna
2021-05-21,SIC,48559,23021,25538,26975,21584,ITG,ITG1,19,Sicilia
2021-03-02,MOL,667,383,284,509,158,ITF,ITF2,14,Molise
2021-06-09,VEN,42370,21746,20624,34956,7414,ITH,ITH3,5,Veneto
2021-06-11,CAL,17319,8510,8809,14735,2584,ITF,ITF6,18,Calabria
2021-02-13,LOM,6418,2441,3977,4942,1476,ITC,ITC4,3,Lombardia
2021-04-20,UMB,5443,2359,3084,3496,1947,ITI,ITI2,10,Umbria
2021-06-10,MOL,2571,1182,1389,1270,1301,ITF,ITF2,14,Molise
2021-01-08,CAL,2167,1034,1133,2167,0,ITF,ITF6,18,Calabria
2021-04-05,BAS,724,233,491,422,302,ITF,ITF5,17,Basilicata
2021-01-27,UMB,840,330,510,13,827,ITI,ITI2,10,Umbria
2021-03-27,EMR,21661,9059,12602,14753,6908,ITH,ITH5,8,Emilia-Romagna
2021-05-07,CAM,59761,29203,30558,43815,15946,ITF,ITF3,15,Campania
2021-03-18,CAL,4418,2063,2355,2356,2062,ITF,ITF6,18,Calabria
2020-12-30,TOS,327,104,223,327,0,ITI,ITI1,9,Toscana
2021-01-10,UMB,1065,274,791,1065,0,ITI,ITI2,10,Umbria
2021-01-27,CAM,7738,3820,3918,162,7576,ITF,ITF3,15,Campania
2021-04-13,EMR,23720,11128,12592,19378,4342,ITH,ITH5,8,Emilia-Romagna
2021-06-04,FVG,12030,6176,5854,10646,1384,ITH,ITH4,6,Friuli-Venezia Giulia
2021-05-21,UMB,8970,3668,5302,4141,4829,ITI,ITI2,10,Umbria
2021-01-03,EMR,2763,943,1820,2763,0,ITH,ITH5,8,Emilia-Romagna
2021-03-22,BAS,1187,535,652,639,548,ITF,ITF5,17,Basilicata
2021-05-04,UMB,5535,2544,2991,2412,3123,ITI,ITI2,10,Umbria
2021-04-01,LAZ,29625,14032,15593,22484,7141,ITI,ITI4,12,Lazio
2021-01-13,SAR,573,178,395,573,0,ITG,ITG2,20,Sardegna
2021-06-28,VEN,46624,23619,23005,18222,28402,ITH,ITH3,5,Veneto
2021-04-01,UMB,4372,1837,2535,2363,2009,ITI,ITI2,10,Umbria
2021-05-24,LIG,11817,5557,6260,9333,2484,ITC,ITC3,7,Liguria
2021-06-21,FVG,9017,4407,4610,1811,7206,ITH,ITH4,6,Friuli-Venezia Giulia
2021-01-21,PAB,953,442,511,139,814,ITH,ITH1,4,Provincia Autonoma Bolzano / Bozen
2021-05-25,VDA,1115,530,585,541,574,ITC,ITC2,2,Valle d'Aosta / Vallée d'Aoste
2021-03-13,FVG,2942,1124,1818,1670,1272,ITH,ITH4,6,Friuli-Venezia Giulia
2021-01-25,VEN,6468,2075,4393,159,6309,ITH,ITH3,5,Veneto
2021-02-14,VDA,48,16,32,1,47,ITC,ITC2,2,Valle d'Aosta / Vallée d'Aoste
2021-04-05,ABR,2692,1147,1545,1813,879,ITF,ITF1,13,Abruzzo
2021-05-07,LIG,13589,6037,7552,5798,7791,ITC,ITC3,7,Liguria
2021-01-01,PIE,1038,395,643,1038,0,ITC,ITC1,1,Piemonte
2021-05-08,VDA,904,540,364,526,378,ITC,ITC2,2,Valle d'Aosta / Vallée d'Aoste
2021-01-13,LOM,26432,8072,18360,26432,0,ITC,ITC4,3,Lombardia
2021-02-13,LIG,1080,508,572,800,280,ITC,ITC3,7,Liguria
2021-06-12,PUG,33811,16862,16949,25000,8811,ITF,ITF4,16,Puglia
2021-03-03,BAS,1747,817,930,1188,559,ITF,ITF5,17,Basilicata
2021-04-02,MOL,1455,709,746,678,777,ITF,ITF2,14,Molise
2021-05-02,PAT,3514,1955,1559,3477,37,ITH,ITH2,4,Provincia Autonoma Trento
2021-06-07,LIG,15683,7655,8028,8672,7011,ITC,ITC3,7,Liguria
2021-06-23,LAZ,61748,29039,32709,28720,33028,ITI,ITI4,12,Lazio
2021-01-16,MAR,2034,732,1302,2034,0,ITI,ITI3,11,Marche
2021-02-27,CAL,4002,2060,1942,3620,382,ITF,ITF6,18,Calabria
2021-05-25,BAS,4195,2112,2083,874,3321,ITF,ITF5,17,Basilicata
2021-04-01,SIC,14235,6613,7622,9571,4664,ITG,ITG1,19,Sicilia
2021-01-19,MOL,173,63,110,162,11,ITF,ITF2,14,Molise
2021-04-21,PIE,25756,11841,13915,20416,5340,ITC,ITC1,1,Piemonte
2021-05-17,SAR,12815,6258,6557,9271,3544,ITG,ITG2,20,Sardegna
2021-02-04,VEN,7386,2025,5361,551,6835,ITH,ITH3,5,Veneto
2021-04-15,ABR,7819,3679,4140,5979,1840,ITF,ITF1,13,Abruzzo
2021-04-16,LOM,53661,23917,29744,39318,14343,ITC,ITC4,3,Lombardia
2021-05-08,MAR,12269,5476,6793,5023,7246,ITI,ITI3,11,Marche
2021-06-19,CAL,15570,7293,8277,8314,7256,ITF,ITF6,18,Calabria
2021-01-11,PIE,8745,2981,5764,8745,0,ITC,ITC1,1,Piemonte
2021-02-06,SAR,1971,698,1273,569,1402,ITG,ITG2,20,Sardegna
2021-04-29,MOL,2238,1145,1093,891,1347,ITF,ITF2,14,Molise
2021-05-03,LOM,83687,39749,43938,71565,12122,ITC,ITC4,3,Lombardia
2021-04-23,FVG,7466,3377,4089,3602,3864,ITH,ITH4,6,Friuli-Venezia Giulia
2021-01-11,EMR,9347,3273,6074,9347,0,ITH,ITH5,8,Emilia-Romagna
2021-01-23,LOM,1115,357,758,916,199,ITC,ITC4,3,Lombardia
2021-02-23,SAR,1537,1026,511,1285,252,ITG,ITG2,20,Sardegna
2021-04-12,MOL,1299,557,742,1048,251,ITF,ITF2,14,Molise
2021-06-10,TOS,26305,13485,12820,25792,513,ITI,ITI1,9,Toscana
2021-05-24,TOS,33706,16697,17009,24139,9567,ITI,ITI1,9,Toscana
2021-06-17,LIG,16274,7719,8555,10515,5759,ITC,ITC3,7,Liguria
2021-01-19,PUG,1221,452,769,1211,10,ITF,ITF4,16,Puglia
2021-06-29,PAB,1852,996,856,238,1614,ITH,ITH1,4,Provincia Autonoma Bolzano / Bozen
2021-02-15,LAZ,8026,3540,4486,7395,631,ITI,ITI4,12,Lazio
2021-01-25,TOS,5126,1895,3231,247,4879,ITI,ITI1,9,Toscana
2021-01-29,LAZ,8043,3080,4963,813,7230,ITI,ITI4,12,Lazio
2021-03-18,PAT,2320,957,1363,1240,1080,ITH,ITH2,4,Provincia Autonoma Trento
2021-03-21,PAB,768,285,483,14,754,ITH,ITH1,4,Provincia Autonoma Bolzano / Bozen
2021-01-09,MAR,1713,606,1107,1713,0,ITI,ITI3,11,Marche
2021-06-28,PIE,38260,18981,19279,15634,22626,ITC,ITC1,1,Piemonte
2021-04-30,VEN,49987,23475,26512,34324,15663,ITH,ITH3,5,Veneto
2021-06-12,PAB,4907,2659,2248,1619,3288,ITH,ITH1,4,Provincia Autonoma Bolzano / Bozen
2021-04-06,PIE,20249,8815,11434,15053,5196,ITC,ITC1,1,Piemonte
2021-05-02,SAR,5887,2670,3217,5306,581,ITG,ITG2,20,Sardegna
2021-05-30,UMB,5982,2999,2983,5780,202,ITI,ITI2,10,Umbria
2021-01-20,VEN,1038,368,670,386,652,ITH,ITH3,5,Veneto
2021-04-18,TOS,8341,4083,4258,7328,1013,ITI,ITI1,9,Toscana
2020-12-27,PIE,913,369,544,913,0,ITC,ITC1,1,Piemonte
2021-04-02,MAR,6887,2984,3903,6148,739,ITI,ITI3,11,Marche
2021-05-14,CAL,19923,9574,10349,13052,6871,ITF,ITF6,18,Calabria
2021-03-08,UMB,3696,1822,1874,2335,1361,ITI,ITI2,10,Umbria
2021-06-09,PAT,6235,3076,3159,2164,4071,ITH,ITH2,4,Provincia Autonoma Trento
2021-06-16,SIC,39720,18471,21249,21064,18656,ITG,ITG1,19,Sicilia
2021-01-14,PAB,1946,575,1371,1946,0,ITH,ITH1,4,Provincia Autonoma Bolzano / Bozen
2021-02-08,SAR,1470,533,937,856,614,ITG,ITG2,20,Sardegna
2021-03-16,MAR,3473,1486,1987,290,3183,ITI,ITI3,11,Marche
2021-04-27,CAL,9956,4893,5063,8010,1946,ITF,ITF6,18,Calabria
2021-06-16,UMB,6312,3091,3221,3219,3093,ITI,ITI2,10,Umbria
2021-01-19,VDA,256,77,179,256,0,ITC,ITC2,2,Valle d'Aosta / Vallée d'Aoste
2021-03-25,SIC,20354,9460,10894,14889,5465,ITG,ITG1,19,Sicilia
2021-06-22,ABR,10245,4802,5443,5400,4845,ITF,ITF1,13,Abruzzo
2021-06-26,PAT,1384,720,664,672,712,ITH,ITH2,4,Provincia Autonoma Trento
2021-04-07,PAB,1798,823,975,1258,540,ITH,ITH1,4,Provincia Autonoma Bolzano / Bozen
2021-02-03,CAL,2812,1449,1363,574,2238,ITF,ITF6,18,Calabria
2021-03-25,UMB,3898,1698,2200,2835,1063,ITI,ITI2,10,Umbria
2021-06-02,LIG,8530,4342,4188,5363,3167,ITC,ITC3,7,Liguria
2021-01-04,PUG,4508,2016,2492,4508,0,ITF,ITF4,16,Puglia
2021-06-21,LOM,111595,57179,54416,80767,30828,ITC,ITC4,3,Lombardia
2021-04-12,VDA,486,186,300,323,163,ITC,ITC2,2,Valle d'Aosta / Vallée d'Aoste
2021-04-29,VDA,1291,634,657,757,534,ITC,ITC2,2,Valle d'Aosta / Vallée d'Aoste
2021-06-02,CAM,42778,20117,22661,38118,4660,ITF,ITF3,15,Campania
2021-06-19,LIG,7155,3648,3507,5655,1500,ITC,ITC3,7,Liguria
2021-06-28,PAT,6741,3479,3262,2944,3797,ITH,ITH2,4,Provincia Autonoma Trento
2021-02-17,LAZ,9187,4608,4579,8310,877,ITI,ITI4,12,Lazio
2021-02-22,CAM,10682,3294,7388,10419,263,ITF,ITF3,15,Campania
2021-03-02,PAB,695,200,495,693,2,ITH,ITH1,4,Provincia Autonoma Bolzano / Bozen
2021-03-07,MOL,1132,501,631,1130,2,ITF,ITF2,14,Molise
2021-04-06,PAT,2261,950,1311,1496,765,ITH,ITH2,4,Provincia Autonoma Trento
2021-04-17,BAS,3461,1655,1806,2199,1262,ITF,ITF5,17,Basilicata
2021-06-24,MAR,13668,6595,7073,6298,7370,ITI,ITI3,11,Marche
2021-05-28,LAZ,56784,26302,30482,43695,13089,ITI,ITI4,12,Lazio
2021-06-15,MOL,2215,1042,1173,764,1451,ITF,ITF2,14,Molise
2021-06-30,EMR,32692,16500,16192,17226,15466,ITH,ITH5,8,Emilia-Romagna
2021-03-11,CAM,17998,9056,8942,10719,7279,ITF,ITF3,15,Campania
2021-03-19,PAB,1906,773,1133,799,1107,ITH,ITH1,4,Provincia Autonoma Bolzano / Bozen
2021-06-02,LOM,84628,43573,41055,78297,6331,ITC,ITC4,3,Lombardia
2021-03-06,SIC,12638,5058,7580,9856,2782,ITG,ITG1,19,Sicilia
2021-06-09,FVG,11151,5871,5280,9772,1379,ITH,ITH4,6,Friuli-Venezia Giulia
2021-03-11,LOM,36214,13476,22738,26307,9907,ITC,ITC4,3,Lombardia
2021-05-16,CAM,51145,23225,27920,33573,17572,ITF,ITF3,15,Campania
2021-06-11,EMR,44876,23307,21569,38386,6490,ITH,ITH5,8,Emilia-Romagna
2021-02-20,CAM,8573,3080,5493,8270,303,ITF,ITF3,15,Campania
2021-03-29,BAS,2434,880,1554,2147,287,ITF,ITF5,17,Basilicata
2021-03-27,UMB,4251,1513,2738,3911,340,ITI,ITI2,10,Umbria
2021-06-17,MOL,2307,1017,1290,938,1369,ITF,ITF2,14,Molise
2021-06-28,EMR,37392,18252,19140,17941,19451,ITH,ITH5,8,Emilia-Romagna
2021-06-14,SIC,42385,20155,22230,27633,14752,ITG,ITG1,19,Sicilia
2021-01-05,BAS,946,409,537,946,0,ITF,ITF5,17,Basilicata
2021-03-01,FVG,2957,1041,1916,2905,52,ITH,ITH4,6,Friuli-Venezia Giulia
2021-03-20,EMR,16085,6829,9256,9121,6964,ITH,ITH5,8,Emilia-Romagna
2021-03-18,FVG,3372,1421,1951,1691,1681,ITH,ITH4,6,Friuli-Venezia Giulia
2021-03-26,PUG,11998,5837,6161,7353,4645,ITF,ITF4,16,Puglia
2021-05-28,SIC,51221,22955,28266,24730,26491,ITG,ITG1,19,Sicilia
2021-06-16,VEN,47135,23250,23885,25943,21192,ITH,ITH3,5,Veneto
2021-03-09,PUG,13602,6074,7528,11593,2009,ITF,ITF4,16,Puglia
2021-04-06,EMR,24747,11174,13573,20005,4742,ITH,ITH5,8,Emilia-Romagna
2021-01-01,VEN,1528,471,1057,1528,0,ITH,ITH3,5,Veneto
2021-01-13,PAT,421,123,298,421,0,ITH,ITH2,4,Provincia Autonoma Trento
2021-05-31,EMR,29727,13749,15978,18261,11466,ITH,ITH5,8,Emilia-Romagna
2021-03-14,FVG,1398,550,848,1146,252,ITH,ITH4,6,Friuli-Venezia Giulia
2021-02-04,SIC,6746,3073,3673,1452,5294,ITG,ITG1,19,Sicilia
2021-02-20,EMR,5318,2094,3224,5055,263,ITH,ITH5,8,Emilia-Romagna
2021-03-02,TOS,10599,3799,6800,7155,3444,ITI,ITI1,9,Toscana
2021-06-12,VEN,47788,24070,23718,37048,10740,ITH,ITH3,5,Veneto
2021-06-24,PAT,5912,3097,2815,3730,2182,ITH,ITH2,4,Provincia Autonoma Trento
2021-04-04,SAR,1,0,1,0,1,ITG,ITG2,20,Sardegna
2021-06-18,BAS,4451,2058,2393,2193,2258,ITF,ITF5,17,Basilicata
2021-01-04,TOS,5066,1895,3171,5066,0,ITI,ITI1,9,Toscana
2021-04-08,VDA,584,282,302,441,143,ITC,ITC2,2,Valle d'Aosta / Vallée d'Aoste
2021-05-24,LAZ,43928,20132,23796,34169,9759,ITI,ITI4,12,Lazio
2021-05-26,UMB,9645,4563,5082,8395,1250,ITI,ITI2,10,Umbria
2021-04-14,TOS,20176,8342,11834,15069,5107,ITI,ITI1,9,Toscana
2021-05-12,PAT,3302,1492,1810,2115,1187,ITH,ITH2,4,Provincia Autonoma Trento
2021-02-18,CAM,9080,3813,5267,8373,707,ITF,ITF3,15,Campania
2021-02-28,PUG,6057,1806,4251,5871,186,ITF,ITF4,16,Puglia
2021-06-03,MAR,14634,7478,7156,12378,2256,ITI,ITI3,11,Marche
2021-03-16,PAT,1391,506,885,608,783,ITH,ITH2,4,Provincia Autonoma Trento
2021-05-25,MOL,1963,887,1076,1333,630,ITF,ITF2,14,Molise
2021-06-08,PAB,4149,2118,2031,832,3317,ITH,ITH1,4,Provincia Autonoma Bolzano / Bozen
2021-01-15,EMR,7750,2404,5346,7750,0,ITH,ITH5,8,Emilia-Romagna
2021-05-14,PAT,5319,2542,2777,3934,1385,ITH,ITH2,4,Provincia Autonoma Trento
2021-02-02,ABR,1763,668,1095,222,1541,ITF,ITF1,13,Abruzzo
2021-05-13,ABR,11146,5042,6104,7187,3959,ITF,ITF1,13,Abruzzo
2021-06-13,VDA,851,399,452,373,478,ITC,ITC2,2,Valle d'Aosta / Vallée d'Aoste
2021-02-08,PIE,6918,2356,4562,666,6252,ITC,ITC1,1,Piemonte
2021-01-03,LAZ,5255,1973,3282,5255,0,ITI,ITI4,12,Lazio
2021-05-12,PUG,36547,16307,20240,24065,12482,ITF,ITF4,16,Puglia
2021-06-14,TOS,31763,16307,15456,27671,4092,ITI,ITI1,9,Toscana
2021-01-04,MOL,314,131,183,314,0,ITF,ITF2,14,Molise
2021-04-25,CAM,30732,15170,15562,25336,5396,ITF,ITF3,15,Campania
2021-01-01,SIC,817,437,380,817,0,ITG,ITG1,19,Sicilia
2021-03-31,ABR,6712,2938,3774,4643,2069,ITF,ITF1,13,Abruzzo
2021-04-13,LAZ,25754,11935,13819,18038,7716,ITI,ITI4,12,Lazio
2021-04-14,MOL,1806,767,1039,1145,661,ITF,ITF2,14,Molise
2021-04-08,FVG,7437,3207,4230,5515,1922,ITH,ITH4,6,Friuli-Venezia Giulia
2021-06-23,CAL,16823,7676,9147,7894,8929,ITF,ITF6,18,Calabria
2021-02-16,MOL,156,70,86,150,6,ITF,ITF2,14,Molise
2021-04-20,SIC,18978,8977,10001,13735,5243,ITG,ITG1,19,Sicilia
2021-02-18,MAR,2134,777,1357,1848,286,ITI,ITI3,11,Marche
2021-05-27,MOL,2834,1348,1486,1998,836,ITF,ITF2,14,Molise
2021-04-23,LIG,14671,6637,8034,8551,6120,ITC,ITC3,7,Liguria
2021-05-21,FVG,11200,5010,6190,8233,2967,ITH,ITH4,6,Friuli-Venezia Giulia
2021-06-09,EMR,42347,21541,20806,35991,6356,ITH,ITH5,8,Emilia-Romagna
2021-05-29,MAR,12788,6194,6594,8260,4528,ITI,ITI3,11,Marche
2021-01-24,BAS,842,305,537,58,784,ITF,ITF5,17,Basilicata
2021-02-10,FVG,1352,496,856,1266,86,ITH,ITH4,6,Friuli-Venezia Giulia
2021-03-01,EMR,10095,3582,6513,7837,2258,ITH,ITH5,8,Emilia-Romagna
2021-05-02,VEN,37233,17262,19971,26904,10329,ITH,ITH3,5,Veneto
2021-05-15,ABR,11427,5177,6250,6127,5300,ITF,ITF1,13,Abruzzo
2021-02-01,FVG,2097,688,1409,16,2081,ITH,ITH4,6,Friuli-Venezia Giulia
2021-03-11,LIG,6397,3088,3309,4387,2010,ITC,ITC3,7,Liguria
2021-05-28,UMB,9582,4434,5148,7287,2295,ITI,ITI2,10,Umbria
2021-01-13,LIG,2757,1013,1744,2757,0,ITC,ITC3,7,Liguria
2021-05-13,BAS,5985,2967,3018,3389,2596,ITF,ITF5,17,Basilicata
2021-06-08,VDA,712,356,356,679,33,ITC,ITC2,2,Valle d'Aosta / Vallée d'Aoste
2021-05-04,EMR,29271,13704,15567,15612,13659,ITH,ITH5,8,Emilia-Romagna
2021-06-14,VEN,42390,21430,20960,27114,15276,ITH,ITH3,5,Veneto
2021-01-08,LAZ,7730,2895,4835,7730,0,ITI,ITI4,12,Lazio
2021-01-13,CAM,8020,3666,4354,8020,0,ITF,ITF3,15,Campania
2021-04-15,UMB,7634,3493,4141,5747,1887,ITI,ITI2,10,Umbria
2021-06-16,SAR,17628,8274,9354,12327,5301,ITG,ITG2,20,Sardegna
2021-02-08,PAT,1152,319,833,342,810,ITH,ITH2,4,Provincia Autonoma Trento
2021-03-04,TOS,17846,6949,10897,14764,3082,ITI,ITI1,9,Toscana
2021-03-06,VEN,10667,4356,6311,7405,3262,ITH,ITH3,5,Veneto
2021-04-28,PAB,2464,1302,1162,2459,5,ITH,ITH1,4,Provincia Autonoma Bolzano / Bozen
2021-02-17,UMB,1618,748,870,1267,351,ITI,ITI2,10,Umbria
2021-05-21,PIE,36063,16747,19316,20431,15632,ITC,ITC1,1,Piemonte
2021-01-04,LIG,2615,855,1760,2615,0,ITC,ITC3,7,Liguria
2021-01-23,PUG,3039,1294,1745,886,2153,ITF,ITF4,16,Puglia
2021-05-29,MOL,2350,1223,1127,1960,390,ITF,ITF2,14,Molise
2021-03-13,CAL,6940,3019,3921,5958,982,ITF,ITF6,18,Calabria
2021-05-03,PUG,33292,14880,18412,22667,10625,ITF,ITF4,16,Puglia
2021-02-27,EMR,10961,3998,6963,9223,1738,ITH,ITH5,8,Emilia-Romagna
2021-03-07,PUG,4983,2000,2983,4412,571,ITF,ITF4,16,Puglia
2020-12-30,VEN,699,245,454,699,0,ITH,ITH3,5,Veneto
2021-04-25,EMR,22350,10240,12110,14840,7510,ITH,ITH5,8,Emilia-Romagna
2021-01-01,SAR,32,17,15,32,0,ITG,ITG2,20,Sardegna
2021-02-16,MAR,1290,477,813,1260,30,ITI,ITI3,11,Marche
2021-02-26,VDA,207,58,149,122,85,ITC,ITC2,2,Valle d'Aosta / Vallée d'Aoste
2021-04-13,UMB,7675,3396,4279,6007,1668,ITI,ITI2,10,Umbria
2021-05-14,FVG,10749,5353,5396,8160,2589,ITH,ITH4,6,Friuli-Venezia Giulia
2021-06-21,LIG,14444,6843,7601,9244,5200,ITC,ITC3,7,Liguria
2021-02-25,MAR,3540,1452,2088,3360,180,ITI,ITI3,11,Marche
2021-02-27,SAR,1921,647,1274,1366,555,ITG,ITG2,20,Sardegna
2021-02-03,FVG,2647,791,1856,23,2624,ITH,ITH4,6,Friuli-Venezia Giulia
2021-02-15,UMB,1367,692,675,1366,1,ITI,ITI2,10,Umbria
2021-06-21,TOS,31116,15426,15690,18376,12740,ITI,ITI1,9,Toscana
2021-02-01,PIE,8645,3055,5590,579,8066,ITC,ITC1,1,Piemonte
2021-04-18,CAM,27219,13284,13935,18319,8900,ITF,ITF3,15,Campania
2021-05-08,BAS,4835,2399,2436,3429,1406,ITF,ITF5,17,Basilicata
2021-06-05,MAR,13933,7006,6927,11874,2059,ITI,ITI3,11,Marche
2021-01-15,CAL,2802,1259,1543,2802,0,ITF,ITF6,18,Calabria
2021-04-10,VDA,404,190,214,399,5,ITC,ITC2,2,Valle d'Aosta / Vallée d'Aoste
2021-01-08,CAM,10454,4967,5487,10454,0,ITF,ITF3,15,Campania
2021-01-16,PAB,2840,1265,1575,2840,0,ITH,ITH1,4,Provincia Autonoma Bolzano / Bozen
2021-05-12,UMB,6488,3024,3464,4343,2145,ITI,ITI2,10,Umbria
2021-06-22,PUG,41197,19942,21255,18744,22453,ITF,ITF4,16,Puglia
2021-06-23,ABR,10822,5207,5615,5529,5293,ITF,ITF1,13,Abruzzo
2021-04-18,EMR,17501,8395,9106,12583,4918,ITH,ITH5,8,Emilia-Romagna
2021-04-28,PAT,4250,1976,2274,4112,138,ITH,ITH2,4,Provincia Autonoma Trento
2021-04-26,PUG,26257,12027,14230,23024,3233,ITF,ITF4,16,Puglia
2021-05-05,PIE,32199,15099,17100,19179,13020,ITC,ITC1,1,Piemonte
2021-05-31,SAR,11365,5408,5957,8256,3109,ITG,ITG2,20,Sardegna
2021-02-18,VEN,5828,2455,3373,5764,64,ITH,ITH3,5,Veneto
2021-03-25,VDA,389,154,235,379,10,ITC,ITC2,2,Valle d'Aosta / Vallée d'Aoste
2021-04-12,PAB,2105,946,1159,2098,7,ITH,ITH1,4,Provincia Autonoma Bolzano / Bozen
2021-06-14,EMR,40556,20945,19611,27521,13035,ITH,ITH5,8,Emilia-Romagna
2021-01-16,FVG,1230,360,870,1230,0,ITH,ITH4,6,Friuli-Venezia Giulia
2021-03-28,LAZ,19124,7770,11354,13814,5310,ITI,ITI4,12,Lazio
2021-03-30,UMB,3976,1729,2247,2436,1540,ITI,ITI2,10,Umbria
2021-07-01,PIE,41308,20667,20641,20421,20887,ITC,ITC1,1,Piemonte
2021-02-16,TOS,9280,3340,5940,8559,721,ITI,ITI1,9,Toscana
2021-04-16,VEN,24442,10491,13951,12555,11887,ITH,ITH3,5,Veneto
2021-05-21,VDA,917,433,484,531,386,ITC,ITC2,2,Valle d'Aosta / Vallée d'Aoste
2021-04-18,SAR,5127,2225,2902,2258,2869,ITG,ITG2,20,Sardegna
2021-06-12,MAR,13398,7128,6270,12132,1266,ITI,ITI3,11,Marche
2020-12-27,UMB,84,44,40,84,0,ITI,ITI2,10,Umbria
2021-04-17,VDA,638,407,231,636,2,ITC,ITC2,2,Valle d'Aosta / Vallée d'Aoste
2021-05-02,TOS,11166,4931,6235,9203,1963,ITI,ITI1,9,Toscana
2021-01-08,SAR,3258,1184,2074,3258,0,ITG,ITG2,20,Sardegna
2021-04-16,MAR,10083,4703,5380,9558,525,ITI,ITI3,11,Marche
2021-01-07,VDA,276,111,165,276,0,ITC,ITC2,2,Valle d'Aosta / Vallée d'Aoste
2021-03-25,FVG,5528,2420,3108,3392,2136,ITH,ITH4,6,Friuli-Venezia Giulia
2021-06-14,LIG,14656,7099,7557,9237,5419,ITC,ITC3,7,Liguria
2021-02-27,CAM,13948,4473,9475,12306,1642,ITF,ITF3,15,Campania
2021-03-07,PAB,114,13,101,9,105,ITH,ITH1,4,Provincia Autonoma Bolzano / Bozen
2021-04-01,PAT,2905,1231,1674,1811,1094,ITH,ITH2,4,Provincia Autonoma Trento
2021-06-04,SIC,57613,26635,30978,45814,11799,ITG,ITG1,19,Sicilia
2021-03-06,CAL,8444,4349,4095,7649,795,ITF,ITF6,18,Calabria
2021-06-09,LAZ,69940,33001,36939,36374,33566,ITI,ITI4,12,Lazio
2021-02-19,VDA,292,102,190,268,24,ITC,ITC2,2,Valle d'Aosta / Vallée d'Aoste
2021-02-22,UMB,1889,807,1082,1803,86,ITI,ITI2,10,Umbria
2021-03-16,PUG,9872,4688,5184,3512,6360,ITF,ITF4,16,Puglia
2021-04-11,LOM,32216,13942,18274,24825,7391,ITC,ITC4,3,Lombardia
2021-06-16,CAM,30387,14367,16020,19639,10748,ITF,ITF3,15,Campania
2021-01-01,LOM,24,7,17,24,0,ITC,ITC4,3,Lombardia
2021-02-25,TOS,10633,4306,6327,9635,998,ITI,ITI1,9,Toscana
2021-06-07,LOM,98517,50194,48323,85215,13302,ITC,ITC4,3,Lombardia
2021-06-24,PUG,50583,24312,26271,23052,27531,ITF,ITF4,16,Puglia
2021-04-18,VEN,17512,7253,10259,9947,7565,ITH,ITH3,5,Veneto
2021-02-27,LOM,13946,5871,8075,13305,641,ITC,ITC4,3,Lombardia
2021-04-21,PAB,3013,1468,1545,2165,848,ITH,ITH1,4,Provincia Autonoma Bolzano / Bozen
2021-04-28,PUG,19798,8876,10922,15028,4770,ITF,ITF4,16,Puglia
2021-06-27,BAS,2951,1449,1502,2335,616,ITF,ITF5,17,Basilicata
2021-03-17,ABR,4539,1873,2666,2799,1740,ITF,ITF1,13,Abruzzo
2021-03-31,MOL,2193,919,1274,1374,819,ITF,ITF2,14,Molise
2021-02-25,LIG,3457,1349,2108,3327,130,ITC,ITC3,7,Liguria
2021-06-02,SAR,9784,4689,5095,8144,1640,ITG,ITG2,20,Sardegna
2021-06-28,TOS,37549,18030,19519,8583,28966,ITI,ITI1,9,Toscana
2021-01-10,EMR,7171,2684,4487,7171,0,ITH,ITH5,8,Emilia-Romagna
2021-06-16,EMR,45125,23047,22078,25282,19843,ITH,ITH5,8,Emilia-Romagna
2021-06-24,PAB,3800,1962,1838,1611,2189,ITH,ITH1,4,Provincia Autonoma Bolzano / Bozen
2021-04-06,SIC,17747,8479,9268,13463,4284,ITG,ITG1,19,Sicilia
2021-01-20,TOS,1331,637,694,1083,248,ITI,ITI1,9,Toscana
2021-03-08,EMR,12201,5094,7107,9542,2659,ITH,ITH5,8,Emilia-Romagna
2021-03-23,PAT,2448,944,1504,1708,740,ITH,ITH2,4,Provincia Autonoma Trento
2021-01-04,MAR,1510,570,940,1510,0,ITI,ITI3,11,Marche
2021-03-30,FVG,7221,3250,3971,6298,923,ITH,ITH4,6,Friuli-Venezia Giulia
2021-04-20,SAR,10997,4994,6003,7781,3216,ITG,ITG2,20,Sardegna
2020-12-30,LOM,114,42,72,114,0,ITC,ITC4,3,Lombardia
2021-01-08,VEN,9407,2835,6572,9407,0,ITH,ITH3,5,Veneto
2021-04-30,TOS,40132,17759,22373,20290,19842,ITI,ITI1,9,Toscana
2021-02-22,SIC,7891,4094,3797,7398,493,ITG,ITG1,19,Sicilia
2021-01-05,VDA,150,54,96,150,0,ITC,ITC2,2,Valle d'Aosta / Vallée d'Aoste
2020-12-27,SIC,92,55,37,92,0,ITG,ITG1,19,Sicilia
2021-06-02,SIC,35247,16288,18959,27475,7772,ITG,ITG1,19,Sicilia
2021-05-09,CAL,9619,4483,5136,6085,3534,ITF,ITF6,18,Calabria
2021-04-27,LAZ,30705,13860,16845,19857,10848,ITI,ITI4,12,Lazio
2021-04-29,BAS,4831,2385,2446,4410,421,ITF,ITF5,17,Basilicata
2021-05-02,CAM,43492,21539,21953,32137,11355,ITF,ITF3,15,Campania
2021-01-09,PAB,612,326,286,612,0,ITH,ITH1,4,Provincia Autonoma Bolzano / Bozen
2021-05-28,PAT,3718,1735,1983,1492,2226,ITH,ITH2,4,Provincia Autonoma Trento
2021-01-22,CAM,1525,776,749,673,852,ITF,ITF3,15,Campania
2021-03-01,LAZ,17115,7367,9748,13230,3885,ITI,ITI4,12,Lazio
2021-06-11,UMB,6902,3465,3437,6137,765,ITI,ITI2,10,Umbria
2021-01-14,VDA,237,69,168,237,0,ITC,ITC2,2,Valle d'Aosta / Vallée d'Aoste
2021-01-25,PAT,818,215,603,24,794,ITH,ITH2,4,Provincia Autonoma Trento
2021-03-17,BAS,1455,610,845,28,1427,ITF,ITF5,17,Basilicata
2021-04-14,MAR,10216,4563,5653,9844,372,ITI,ITI3,11,Marche
2021-01-29,CAL,2075,996,1079,228,1847,ITF,ITF6,18,Calabria
2021-01-09,PUG,4887,2250,2637,4887,0,ITF,ITF4,16,Puglia
2021-01-19,BAS,199,84,115,199,0,ITF,ITF5,17,Basilicata
2021-06-16,LOM,98611,50088,48523,50660,47951,ITC,ITC4,3,Lombardia
2021-06-25,BAS,3275,1552,1723,2445,830,ITF,ITF5,17,Basilicata
2021-03-25,PAT,2875,1105,1770,1826,1049,ITH,ITH2,4,Provincia Autonoma Trento
2021-03-24,ABR,6383,2784,3599,4132,2251,ITF,ITF1,13,Abruzzo
2021-04-24,VDA,722,400,322,555,167,ITC,ITC2,2,Valle d'Aosta / Vallée d'Aoste
2020-12-30,MAR,17,5,12,17,0,ITI,ITI3,11,Marche
2021-01-13,VEN,5985,1606,4379,5985,0,ITH,ITH3,5,Veneto
2021-02-22,LAZ,11458,4990,6468,10956,502,ITI,ITI4,12,Lazio
2021-04-25,TOS,11051,5247,5804,8914,2137,ITI,ITI1,9,Toscana
2021-07-01,PUG,42309,19739,22570,10639,31670,ITF,ITF4,16,Puglia
2021-06-20,PUG,21184,10675,10509,14062,7122,ITF,ITF4,16,Puglia
2021-05-25,PAB,3838,1991,1847,2953,885,ITH,ITH1,4,Provincia Autonoma Bolzano / Bozen
2021-01-23,SAR,60,22,38,0,60,ITG,ITG2,20,Sardegna
2021-05-13,MOL,3039,1410,1629,2582,457,ITF,ITF2,14,Molise
2021-02-14,PAB,297,130,167,297,0,ITH,ITH1,4,Provincia Autonoma Bolzano / Bozen
2021-02-18,SIC,5279,3102,2177,4847,432,ITG,ITG1,19,Sicilia
2021-06-18,VDA,998,443,555,599,399,ITC,ITC2,2,Valle d'Aosta / Vallée d'Aoste
2021-04-30,CAM,42316,20189,22127,25824,16492,ITF,ITF3,15,Campania
2021-05-08,PAB,4427,2382,2045,3764,663,ITH,ITH1,4,Provincia Autonoma Bolzano / Bozen
2021-01-30,LAZ,7013,2895,4118,808,6205,ITI,ITI4,12,Lazio
2021-02-01,UMB,1284,341,943,48,1236,ITI,ITI2,10,Umbria
2021-02-04,CAM,7943,3429,4514,1308,6635,ITF,ITF3,15,Campania
2021-05-12,SIC,36769,17315,19454,21860,14909,ITG,ITG1,19,Sicilia
2021-03-13,BAS,1798,890,908,753,1045,ITF,ITF5,17,Basilicata
2021-02-18,UMB,1496,582,914,1030,466,ITI,ITI2,10,Umbria
2021-03-03,PAB,1180,394,786,1167,13,ITH,ITH1,4,Provincia Autonoma Bolzano / Bozen
2021-05-17,LOM,94621,45347,49274,30224,64397,ITC,ITC4,3,Lombardia
2021-01-27,FVG,1272,425,847,450,822,ITH,ITH4,6,Friuli-Venezia Giulia
2021-02-07,BAS,375,159,216,49,326,ITF,ITF5,17,Basilicata
2021-01-01,CAM,919,506,413,919,0,ITF,ITF3,15,Campania
2021-04-28,MOL,1693,923,770,476,1217,ITF,ITF2,14,Molise
2021-05-14,VEN,46701,22208,24493,25839,20862,ITH,ITH3,5,Veneto
2021-05-18,BAS,5898,2858,3040,3406,2492,ITF,ITF5,17,Basilicata
2021-02-04,PUG,5928,2365,3563,1193,4735,ITF,ITF4,16,Puglia
2021-05-09,EMR,25609,12252,13357,18642,6967,ITH,ITH5,8,Emilia-Romagna
2021-01-29,EMR,10414,3496,6918,290,10124,ITH,ITH5,8,Emilia-Romagna
2021-04-08,SIC,16682,8239,8443,8215,8467,ITG,ITG1,19,Sicilia
2021-05-07,FVG,10608,4852,5756,7099,3509,ITH,ITH4,6,Friuli-Venezia Giulia
2021-01-15,LAZ,6582,2708,3874,6582,0,ITI,ITI4,12,Lazio
2021-02-20,VEN,6424,2014,4410,6353,71,ITH,ITH3,5,Veneto
2021-03-04,PAT,2361,794,1567,1583,778,ITH,ITH2,4,Provincia Autonoma Trento
2020-12-30,LIG,12,5,7,12,0,ITC,ITC3,7,Liguria
2021-02-15,EMR,2904,851,2053,2779,125,ITH,ITH5,8,Emilia-Romagna
2021-04-25,LAZ,24522,11249,13273,16705,7817,ITI,ITI4,12,Lazio
2021-04-20,PIE,25489,11667,13822,19143,6346,ITC,ITC1,1,Piemonte
2021-03-25,CAM,20321,9653,10668,16818,3503,ITF,ITF3,15,Campania
2021-05-01,BAS,4704,2137,2567,3953,751,ITF,ITF5,17,Basilicata
2021-01-19,ABR,111,55,56,91,20,ITF,ITF1,13,Abruzzo
2021-03-18,TOS,9980,3984,5996,6008,3972,ITI,ITI1,9,Toscana
2021-05-09,FVG,7355,3301,4054,3498,3857,ITH,ITH4,6,Friuli-Venezia Giulia
2021-02-07,ABR,778,307,471,201,577,ITF,ITF1,13,Abruzzo
2021-02-22,SAR,1639,949,690,1411,228,ITG,ITG2,20,Sardegna
2021-03-02,MAR,4990,1959,3031,4424,566,ITI,ITI3,11,Marche
2021-04-13,CAL,6900,3381,3519,5587,1313,ITF,ITF6,18,Calabria
2021-05-07,PIE,33074,15644,17430,18949,14125,ITC,ITC1,1,Piemonte
2021-06-26,TOS,34492,16735,17757,10211,24281,ITI,ITI1,9,Toscana
2021-01-27,EMR,8361,2947,5414,462,7899,ITH,ITH5,8,Emilia-Romagna
2021-01-27,PIE,4196,1453,2743,999,3197,ITC,ITC1,1,Piemonte
2021-05-19,LOM,82851,39576,43275,33815,49036,ITC,ITC4,3,Lombardia
2021-06-10,MAR,14674,7564,7110,12661,2013,ITI,ITI3,11,Marche
2021-01-20,CAL,1403,627,776,1402,1,ITF,ITF6,18,Calabria
2021-02-13,PIE,4153,1334,2819,2931,1222,ITC,ITC1,1,Piemonte
2021-03-11,SAR,6428,3092,3336,5226,1202,ITG,ITG2,20,Sardegna
2021-02-08,LOM,10081,2918,7163,2130,7951,ITC,ITC4,3,Lombardia
2021-05-17,PUG,32823,15203,17620,20968,11855,ITF,ITF4,16,Puglia
2021-06-09,TOS,34719,17501,17218,34297,422,ITI,ITI1,9,Toscana
2021-02-25,LOM,15292,6348,8944,13721,1571,ITC,ITC4,3,Lombardia
2021-01-03,CAL,6,3,3,6,0,ITF,ITF6,18,Calabria
2021-04-11,LIG,4246,1929,2317,3997,249,ITC,ITC3,7,Liguria
2021-06-02,VEN,20305,10232,10073,15960,4345,ITH,ITH3,5,Veneto
2021-02-21,MOL,574,227,347,572,2,ITF,ITF2,14,Molise
2021-03-29,VDA,493,233,260,453,40,ITC,ITC2,2,Valle d'Aosta / Vallée d'Aoste
2021-01-21,ABR,157,47,110,157,0,ITF,ITF1,13,Abruzzo
2021-03-27,CAL,8726,3965,4761,4692,4034,ITF,ITF6,18,Calabria
2021-05-16,UMB,5218,2492,2726,5169,49,ITI,ITI2,10,Umbria
2021-06-20,VDA,1131,545,586,487,644,ITC,ITC2,2,Valle d'Aosta / Vallée d'Aoste
2021-02-04,MOL,758,295,463,77,681,ITF,ITF2,14,Molise
2021-04-04,TOS,13921,6608,7313,13668,253,ITI,ITI1,9,Toscana
2021-05-26,FVG,13413,6700,6713,9980,3433,ITH,ITH4,6,Friuli-Venezia Giulia
2021-03-12,VDA,531,175,356,305,226,ITC,ITC2,2,Valle d'Aosta / Vallée d'Aoste
2021-05-01,ABR,10734,5042,5692,5760,4974,ITF,ITF1,13,Abruzzo
2021-05-24,MAR,10800,5113,5687,8121,2679,ITI,ITI3,11,Marche
2021-02-15,FVG,2454,911,1543,2200,254,ITH,ITH4,6,Friuli-Venezia Giulia
2021-05-15,MOL,2980,1398,1582,2596,384,ITF,ITF2,14,Molise
2021-02-06,LOM,15255,5537,9718,1015,14240,ITC,ITC4,3,Lombardia
2021-02-20,SIC,7140,3692,3448,6896,244,ITG,ITG1,19,Sicilia
2021-04-06,LAZ,24389,11111,13278,17275,7114,ITI,ITI4,12,Lazio
2021-05-20,ABR,12746,5902,6844,7488,5258,ITF,ITF1,13,Abruzzo
2021-05-10,PAB,3018,1300,1718,1413,1605,ITH,ITH1,4,Provincia Autonoma Bolzano / Bozen
2021-05-09,PIE,27134,12928,14206,13513,13621,ITC,ITC1,1,Piemonte
2021-06-04,SAR,14473,6926,7547,9921,4552,ITG,ITG2,20,Sardegna
2021-01-18,LIG,2141,746,1395,1984,157,ITC,ITC3,7,Liguria
2021-01-27,PAT,807,278,529,93,714,ITH,ITH2,4,Provincia Autonoma Trento
2021-02-03,SIC,5921,2780,3141,722,5199,ITG,ITG1,19,Sicilia
2021-03-16,TOS,4899,1882,3017,2648,2251,ITI,ITI1,9,Toscana
2021-06-21,SAR,14006,6727,7279,5190,8816,ITG,ITG2,20,Sardegna
2020-12-27,LAZ,274,132,142,274,0,ITI,ITI4,12,Lazio
2021-02-13,PAT,537,333,204,172,365,ITH,ITH2,4,Provincia Autonoma Trento
2021-02-27,TOS,1984,756,1228,1082,902,ITI,ITI1,9,Toscana
2021-03-11,VEN,19827,8888,10939,14256,5571,ITH,ITH3,5,Veneto
2021-03-13,SAR,2755,1076,1679,2474,281,ITG,ITG2,20,Sardegna
2021-05-26,PIE,32738,15101,17637,15664,17074,ITC,ITC1,1,Piemonte
2021-01-20,CAM,1257,650,607,1257,0,ITF,ITF3,15,Campania
2021-04-27,SIC,26305,12656,13649,15521,10784,ITG,ITG1,19,Sicilia
2021-02-15,PIE,4432,1597,2835,3227,1205,ITC,ITC1,1,Piemonte
2021-05-22,MAR,11939,5719,6220,7491,4448,ITI,ITI3,11,Marche
2021-03-04,PIE,14535,5770,8765,11587,2948,ITC,ITC1,1,Piemonte
2021-02-11,CAL,2338,1043,1295,1084,1254,ITF,ITF6,18,Calabria
2021-05-09,BAS,4683,2339,2344,2989,1694,ITF,ITF5,17,Basilicata
2021-06-08,MOL,2885,1593,1292,2189,696,ITF,ITF2,14,Molise
2021-03-16,SIC,9559,4278,5281,3623,5936,ITG,ITG1,19,Sicilia
2021-06-19,FVG,8411,4382,4029,1296,7115,ITH,ITH4,6,Friuli-Venezia Giulia
2021-01-05,PAB,830,286,544,830,0,ITH,ITH1,4,Provincia Autonoma Bolzano / Bozen
2021-02-04,PAT,976,304,672,422,554,ITH,ITH2,4,Provincia Autonoma Trento
2021-02-15,BAS,622,232,390,580,42,ITF,ITF5,17,Basilicata
2021-05-08,LIG,7526,3333,4193,2314,5212,ITC,ITC3,7,Liguria
2021-01-09,VEN,7928,2539,5389,7928,0,ITH,ITH3,5,Veneto
2021-01-29,BAS,617,231,386,63,554,ITF,ITF5,17,Basilicata
2021-05-26,CAM,52662,25829,26833,21568,31094,ITF,ITF3,15,Campania
2021-01-23,PAB,197,117,80,0,197,ITH,ITH1,4,Provincia Autonoma Bolzano / Bozen
2021-01-25,LIG,2725,889,1836,476,2249,ITC,ITC3,7,Liguria
2021-04-03,UMB,2097,712,1385,1045,1052,ITI,ITI2,10,Umbria
2021-03-18,VEN,12612,5138,7474,7384,5228,ITH,ITH3,5,Veneto
2021-05-05,LIG,13709,6133,7576,5291,8418,ITC,ITC3,7,Liguria
2021-06-14,SAR,13735,6634,7101,10126,3609,ITG,ITG2,20,Sardegna
2021-03-06,SAR,2638,1079,1559,858,1780,ITG,ITG2,20,Sardegna
2021-02-27,SIC,12236,5501,6735,11032,1204,ITG,ITG1,19,Sicilia
2021-03-11,FVG,3475,1516,1959,1724,1751,ITH,ITH4,6,Friuli-Venezia Giulia
2021-05-27,ABR,13308,6092,7216,8487,4821,ITF,ITF1,13,Abruzzo
2021-05-03,PAB,1830,847,983,417,1413,ITH,ITH1,4,Provincia Autonoma Bolzano / Bozen
2021-06-26,VEN,47448,24219,23229,13654,33794,ITH,ITH3,5,Veneto
2021-03-05,BAS,1855,857,998,1109,746,ITF,ITF5,17,Basilicata
2021-06-02,PIE,26531,12998,13533,22062,4469,ITC,ITC1,1,Piemonte
2021-06-21,LAZ,61228,28380,32848,28860,32368,ITI,ITI4,12,Lazio
2021-06-28,SAR,15011,7040,7971,3158,11853,ITG,ITG2,20,Sardegna
2021-02-23,PAB,769,324,445,763,6,ITH,ITH1,4,Provincia Autonoma Bolzano / Bozen
2021-02-04,MAR,2383,841,1542,112,2271,ITI,ITI3,11,Marche
2021-02-22,PIE,8483,3472,5011,7893,590,ITC,ITC1,1,Piemonte
2021-06-13,BAS,3009,1437,1572,2701,308,ITF,ITF5,17,Basilicata
2021-04-13,PAT,2556,1059,1497,2049,507,ITH,ITH2,4,Provincia Autonoma Trento
2021-01-20,PAT,292,73,219,280,12,ITH,ITH2,4,Provincia Autonoma Trento
2021-05-17,PAB,3139,1516,1623,2445,694,ITH,ITH1,4,Provincia Autonoma Bolzano / Bozen
2021-03-02,PUG,16388,6091,10297,15086,1302,ITF,ITF4,16,Puglia
2021-04-06,SAR,7464,3125,4339,5035,2429,ITG,ITG2,20,Sardegna
2021-04-25,LOM,51497,23613,27884,46754,4743,ITC,ITC4,3,Lombardia
2021-03-13,LAZ,21753,8685,13068,15859,5894,ITI,ITI4,12,Lazio
2021-03-17,VDA,433,185,248,273,160,ITC,ITC2,2,Valle d'Aosta / Vallée d'Aoste
2021-04-30,PAT,4928,2403,2525,4777,151,ITH,ITH2,4,Provincia Autonoma Trento
2020-12-27,SAR,65,34,31,65,0,ITG,ITG2,20,Sardegna
2021-03-11,PIE,13821,5118,8703,10724,3097,ITC,ITC1,1,Piemonte
2021-06-03,PAB,4721,2565,2156,3775,946,ITH,ITH1,4,Provincia Autonoma Bolzano / Bozen
2021-06-10,PUG,46669,22912,23757,29738,16931,ITF,ITF4,16,Puglia
2021-03-03,VDA,255,118,137,187,68,ITC,ITC2,2,Valle d'Aosta / Vallée d'Aoste
2021-04-06,CAM,24511,11562,12949,19987,4524,ITF,ITF3,15,Campania
2021-05-19,PAT,5100,2457,2643,3845,1255,ITH,ITH2,4,Provincia Autonoma Trento
2021-06-28,LOM,102599,52312,50287,71923,30676,ITC,ITC4,3,Lombardia
2021-04-04,PUG,5967,2963,3004,5962,5,ITF,ITF4,16,Puglia
2020-12-27,CAM,720,422,298,720,0,ITF,ITF3,15,Campania
2021-03-19,ABR,5793,2584,3209,2773,3020,ITF,ITF1,13,Abruzzo
2021-05-23,CAL,11389,5553,5836,7040,4349,ITF,ITF6,18,Calabria
2021-02-08,SIC,3883,1679,2204,2129,1754,ITG,ITG1,19,Sicilia
2021-01-18,MAR,696,237,459,547,149,ITI,ITI3,11,Marche
2021-03-01,CAL,2728,1548,1180,2273,455,ITF,ITF6,18,Calabria
2021-03-25,PIE,17071,7209,9862,8432,8639,ITC,ITC1,1,Piemonte
2021-05-27,BAS,3604,1857,1747,1073,2531,ITF,ITF5,17,Basilicata
2021-01-08,UMB,1187,344,843,1187,0,ITI,ITI2,10,Umbria
2021-01-09,MOL,450,152,298,450,0,ITF,ITF2,14,Molise
2021-04-20,CAM,32035,15500,16535,20722,11313,ITF,ITF3,15,Campania
2021-03-21,PUG,2694,1227,1467,590,2104,ITF,ITF4,16,Puglia
2021-04-06,LOM,43062,17585,25477,25128,17934,ITC,ITC4,3,Lombardia
2021-04-28,MAR,10878,4954,5924,6147,4731,ITI,ITI3,11,Marche
2021-06-09,CAL,17492,8212,9280,15256,2236,ITF,ITF6,18,Calabria
2021-03-05,ABR,5349,1958,3391,4652,697,ITF,ITF1,13,Abruzzo
2021-04-19,MOL,1827,842,985,1049,778,ITF,ITF2,14,Molise
2021-02-20,TOS,4640,1789,2851,4127,513,ITI,ITI1,9,Toscana
2021-04-13,FVG,7364,3288,4076,5761,1603,ITH,ITH4,6,Friuli-Venezia Giulia
2021-06-29,PUG,42881,20417,22464,14695,28186,ITF,ITF4,16,Puglia
2021-01-03,FVG,312,122,190,312,0,ITH,ITH4,6,Friuli-Venezia Giulia
2021-05-31,TOS,30261,14595,15666,19443,10818,ITI,ITI1,9,Toscana
2021-06-28,CAM,44784,21793,22991,19520,25264,ITF,ITF3,15,Campania
2021-06-27,ABR,8192,4210,3982,4976,3216,ITF,ITF1,13,Abruzzo
2021-03-20,CAM,13986,6526,7460,10247,3739,ITF,ITF3,15,Campania
2021-06-04,EMR,45495,22911,22584,37377,8118,ITH,ITH5,8,Emilia-Romagna
2021-01-22,SIC,1278,636,642,262,1016,ITG,ITG1,19,Sicilia
2021-05-14,TOS,33297,15397,17900,20646,12651,ITI,ITI1,9,Toscana
2021-05-07,VEN,48525,23250,25275,39858,8667,ITH,ITH3,5,Veneto
2021-03-16,LIG,6083,2731,3352,2350,3733,ITC,ITC3,7,Liguria
2021-05-23,UMB,5068,1854,3214,652,4416,ITI,ITI2,10,Umbria
2021-01-27,VEN,7140,2064,5076,241,6899,ITH,ITH3,5,Veneto
2021-02-08,LAZ,9739,4152,5587,4507,5232,ITI,ITI4,12,Lazio
2021-04-25,SAR,4497,2269,2228,3718,779,ITG,ITG2,20,Sardegna
2021-01-08,SIC,8110,3781,4329,8110,0,ITG,ITG1,19,Sicilia
2021-01-20,FVG,748,320,428,13,735,ITH,ITH4,6,Friuli-Venezia Giulia
2021-04-07,ABR,7222,3333,3889,4438,2784,ITF,ITF1,13,Abruzzo
2021-01-15,SAR,1563,573,990,1563,0,ITG,ITG2,20,Sardegna
2021-06-22,PAB,2451,1409,1042,335,2116,ITH,ITH1,4,Provincia Autonoma Bolzano / Bozen
2021-04-18,SIC,19706,9849,9857,15345,4361,ITG,ITG1,19,Sicilia
2021-03-14,PAB,758,336,422,25,733,ITH,ITH1,4,Provincia Autonoma Bolzano / Bozen
2021-02-01,SAR,1524,605,919,225,1299,ITG,ITG2,20,Sardegna
2021-04-14,PAB,3593,1645,1948,3502,91,ITH,ITH1,4,Provincia Autonoma Bolzano / Bozen
2021-01-26,VDA,139,48,91,0,139,ITC,ITC2,2,Valle d'Aosta / Vallée d'Aoste
2021-04-24,BAS,4542,2197,2345,3529,1013,ITF,ITF5,17,Basilicata
2021-05-02,LAZ,32636,14339,18297,23273,9363,ITI,ITI4,12,Lazio
2021-05-09,SAR,6129,2874,3255,5203,926,ITG,ITG2,20,Sardegna
2021-01-27,LOM,8035,2674,5361,808,7227,ITC,ITC4,3,Lombardia
2021-02-17,CAL,1865,824,1041,1654,211,ITF,ITF6,18,Calabria
2021-05-29,PUG,30356,14301,16055,20975,9381,ITF,ITF4,16,Puglia
2021-02-10,CAM,6905,3413,3492,6728,177,ITF,ITF3,15,Campania
2021-03-19,MOL,1184,482,702,757,427,ITF,ITF2,14,Molise
2021-05-02,PIE,25097,11276,13821,14352,10745,ITC,ITC1,1,Piemonte
2021-03-25,LOM,42817,16012,26805,30136,12681,ITC,ITC4,3,Lombardia
2021-04-02,PUG,12841,5999,6842,8317,4524,ITF,ITF4,16,Puglia
2021-05-28,CAL,20982,10197,10785,11521,9461,ITF,ITF6,18,Calabria
2021-01-21,MOL,6,2,4,6,0,ITF,ITF2,14,Molise
2021-04-08,CAM,28385,13743,14642,22542,5843,ITF,ITF3,15,Campania
2021-05-21,LOM,93802,45226,48576,29135,64667,ITC,ITC4,3,Lombardia
2021-01-23,MAR,557,190,367,123,434,ITI,ITI3,11,Marche
2021-02-20,PAT,407,245,162,123,284,ITH,ITH2,4,Provincia Autonoma Trento
2021-06-01,BAS,6136,2926,3210,3060,3076,ITF,ITF5,17,Basilicata
2021-06-04,CAM,74227,35665,38562,65171,9056,ITF,ITF3,15,Campania
2021-06-29,MAR,13298,6569,6729,5038,8260,ITI,ITI3,11,Marche
2021-04-15,CAL,7697,3771,3926,5996,1701,ITF,ITF6,18,Calabria
2021-05-03,MAR,10322,4654,5668,4914,5408,ITI,ITI3,11,Marche
2021-02-27,FVG,3530,1200,2330,3529,1,ITH,ITH4,6,Friuli-Venezia Giulia
2021-02-28,ABR,1702,508,1194,1700,2,ITF,ITF1,13,Abruzzo
2021-05-07,SIC,36556,17259,19297,24938,11618,ITG,ITG1,19,Sicilia
2021-06-02,TOS,27566,13604,13962,22061,5505,ITI,ITI1,9,Toscana
2021-01-02,ABR,552,220,332,552,0,ITF,ITF1,13,Abruzzo
2021-03-11,SIC,15338,6620,8718,12968,2370,ITG,ITG1,19,Sicilia
2021-04-06,TOS,22222,9821,12401,18507,3715,ITI,ITI1,9,Toscana
2021-04-25,FVG,2365,990,1375,2354,11,ITH,ITH4,6,Friuli-Venezia Giulia
2021-05-23,EMR,25478,11859,13619,13887,11591,ITH,ITH5,8,Emilia-Romagna
2021-06-08,ABR,12687,6523,6164,10490,2197,ITF,ITF1,13,Abruzzo
2021-02-08,TOS,4097,1360,2737,3638,459,ITI,ITI1,9,Toscana
2021-04-01,CAL,8673,3946,4727,4195,4478,ITF,ITF6,18,Calabria
2021-06-30,UMB,10387,5260,5127,3755,6632,ITI,ITI2,10,Umbria
2021-01-27,SIC,7283,3710,3573,178,7105,ITG,ITG1,19,Sicilia
2021-04-26,ABR,8561,4065,4496,7347,1214,ITF,ITF1,13,Abruzzo
2021-05-19,TOS,27925,13561,14364,18885,9040,ITI,ITI1,9,Toscana
2021-05-21,CAM,63707,29604,34103,43181,20526,ITF,ITF3,15,Campania
2021-01-30,LIG,1661,567,1094,24,1637,ITC,ITC3,7,Liguria
2021-03-23,VEN,22210,10239,11971,17498,4712,ITH,ITH3,5,Veneto
2021-05-15,PAB,7002,3689,3313,6708,294,ITH,ITH1,4,Provincia Autonoma Bolzano / Bozen
2021-02-03,LAZ,6488,2488,4000,964,5524,ITI,ITI4,12,Lazio
2021-02-04,PAB,1958,593,1365,8,1950,ITH,ITH1,4,Provincia Autonoma Bolzano / Bozen
2021-05-19,VEN,32917,15071,17846,17005,15912,ITH,ITH3,5,Veneto
2021-01-13,SIC,5175,2437,2738,5175,0,ITG,ITG1,19,Sicilia
2021-01-15,FVG,2021,605,1416,2021,0,ITH,ITH4,6,Friuli-Venezia Giulia
2021-06-01,ABR,10994,4881,6113,6627,4367,ITF,ITF1,13,Abruzzo
2021-03-28,LIG,1141,511,630,390,751,ITC,ITC3,7,Liguria
2021-05-07,SAR,14472,6632,7840,9949,4523,ITG,ITG2,20,Sardegna
2021-04-13,TOS,8487,3506,4981,6030,2457,ITI,ITI1,9,Toscana
2021-01-20,LAZ,4809,1945,2864,3266,1543,ITI,ITI4,12,Lazio
2021-01-27,SAR,1413,497,916,79,1334,ITG,ITG2,20,Sardegna
2021-03-28,MAR,4125,1739,2386,2434,1691,ITI,ITI3,11,Marche
2021-01-08,PAT,1450,314,1136,1450,0,ITH,ITH2,4,Provincia Autonoma Trento
2021-01-31,VDA,291,91,200,58,233,ITC,ITC2,2,Valle d'Aosta / Vallée d'Aoste
2021-06-14,PAT,5741,2968,2773,2117,3624,ITH,ITH2,4,Provincia Autonoma Trento
2021-01-30,MAR,1905,668,1237,27,1878,ITI,ITI3,11,Marche
2021-02-27,PIE,12691,4851,7840,12346,345,ITC,ITC1,1,Piemonte
2021-03-25,SAR,9116,3973,5143,7809,1307,ITG,ITG2,20,Sardegna
2021-06-08,BAS,4578,2187,2391,4220,358,ITF,ITF5,17,Basilicata
2021-04-18,PAT,1855,845,1010,1846,9,ITH,ITH2,4,Provincia Autonoma Trento
2021-04-16,PUG,35981,16907,19074,32700,3281,ITF,ITF4,16,Puglia
2021-04-25,PIE,20233,9305,10928,17732,2501,ITC,ITC1,1,Piemonte
2021-05-14,LAZ,51459,23512,27947,33163,18296,ITI,ITI4,12,Lazio
2021-05-21,SAR,22637,11205,11432,16542,6095,ITG,ITG2,20,Sardegna
2021-02-08,VEN,5003,1559,3444,1929,3074,ITH,ITH3,5,Veneto
2021-04-02,PAB,2077,837,1240,720,1357,ITH,ITH1,4,Provincia Autonoma Bolzano / Bozen
2021-01-15,PIE,9114,3012,6102,9114,0,ITC,ITC1,1,Piemonte
2021-02-18,PUG,4378,1846,2532,3773,605,ITF,ITF4,16,Puglia
2021-03-18,LAZ,14225,6078,8147,7834,6391,ITI,ITI4,12,Lazio
2021-05-07,LOM,92279,43694,48585,69903,22376,ITC,ITC4,3,Lombardia
2021-06-21,PIE,38187,19047,19140,17530,20657,ITC,ITC1,1,Piemonte
2021-03-06,PAT,786,277,509,635,151,ITH,ITH2,4,Provincia Autonoma Trento
2021-04-06,VEN,28952,13325,15627,23910,5042,ITH,ITH3,5,Veneto
2021-05-29,PAB,7134,3768,3366,3994,3140,ITH,ITH1,4,Provincia Autonoma Bolzano / Bozen
2021-01-28,MOL,613,217,396,17,596,ITF,ITF2,14,Molise
2021-03-13,PIE,13047,4723,8324,11602,1445,ITC,ITC1,1,Piemonte
2021-04-01,CAM,24680,12010,12670,20547,4133,ITF,ITF3,15,Campania
2021-03-18,LOM,27387,10953,16434,16153,11234,ITC,ITC4,3,Lombardia
2021-04-08,CAL,9274,4372,4902,5767,3507,ITF,ITF6,18,Calabria
2021-04-09,PUG,22048,9502,12546,17425,4623,ITF,ITF4,16,Puglia
2021-05-28,CAM,73013,35289,37724,26900,46113,ITF,ITF3,15,Campania
2021-02-10,CAL,2511,1080,1431,883,1628,ITF,ITF6,18,Calabria
2021-02-11,PUG,3697,1401,2296,2419,1278,ITF,ITF4,16,Puglia
2021-05-14,LOM,85899,41367,44532,55634,30265,ITC,ITC4,3,Lombardia
2021-03-12,MOL,1459,637,822,1423,36,ITF,ITF2,14,Molise
2021-04-11,PAT,2340,1135,1205,2249,91,ITH,ITH2,4,Provincia Autonoma Trento
2021-04-12,BAS,2170,1050,1120,1682,488,ITF,ITF5,17,Basilicata
2021-05-10,MAR,9448,4336,5112,4897,4551,ITI,ITI3,11,Marche
2021-05-22,PUG,34591,15840,18751,24210,10381,ITF,ITF4,16,Puglia
2021-01-14,MOL,646,239,407,646,0,ITF,ITF2,14,Molise
2021-03-14,MAR,2499,1032,1467,1907,592,ITI,ITI3,11,Marche
2021-06-04,CAL,17365,8074,9291,12830,4535,ITF,ITF6,18,Calabria
2021-01-20,SIC,955,506,449,691,264,ITG,ITG1,19,Sicilia
2021-04-18,FVG,6038,2800,3238,5631,407,ITH,ITH4,6,Friuli-Venezia Giulia
2021-04-19,ABR,6226,2858,3368,3854,2372,ITF,ITF1,13,Abruzzo
2021-01-08,FVG,2321,746,1575,2321,0,ITH,ITH4,6,Friuli-Venezia Giulia
2021-02-21,ABR,1218,550,668,1217,1,ITF,ITF1,13,Abruzzo
2021-05-26,TOS,35574,17097,18477,20382,15192,ITI,ITI1,9,Toscana
2021-04-08,EMR,31212,14333,16879,25909,5303,ITH,ITH5,8,Emilia-Romagna
2021-03-20,SIC,18576,8968,9608,13437,5139,ITG,ITG1,19,Sicilia
2021-02-08,CAM,5113,2449,2664,4310,803,ITF,ITF3,15,Campania
2021-03-20,UMB,2319,845,1474,2294,25,ITI,ITI2,10,Umbria
2021-06-28,SIC,31204,14483,16721,14589,16615,ITG,ITG1,19,Sicilia
2021-02-06,TOS,4527,1550,2977,1294,3233,ITI,ITI1,9,Toscana
2021-02-02,PAB,1745,506,1239,8,1737,ITH,ITH1,4,Provincia Autonoma Bolzano / Bozen
2021-06-23,FVG,11902,5761,6141,2038,9864,ITH,ITH4,6,Friuli-Venezia Giulia
2021-05-16,LAZ,50928,24521,26407,37442,13486,ITI,ITI4,12,Lazio
2021-02-01,LIG,2558,922,1636,90,2468,ITC,ITC3,7,Liguria
2021-05-20,VDA,807,363,444,367,440,ITC,ITC2,2,Valle d'Aosta / Vallée d'Aoste
2021-04-27,FVG,8101,3718,4383,3626,4475,ITH,ITH4,6,Friuli-Venezia Giulia
2021-05-12,LIG,12030,5448,6582,6683,5347,ITC,ITC3,7,Liguria
2021-01-06,PIE,3116,1111,2005,3116,0,ITC,ITC1,1,Piemonte
2021-05-26,LIG,16653,8408,8245,12280,4373,ITC,ITC3,7,Liguria
2021-07-01,MAR,14690,7366,7324,4970,9720,ITI,ITI3,11,Marche
2021-03-24,VDA,515,230,285,258,257,ITC,ITC2,2,Valle d'Aosta / Vallée d'Aoste
2021-03-30,LIG,12210,5425,6785,8822,3388,ITC,ITC3,7,Liguria
2021-05-17,MOL,2228,1092,1136,1732,496,ITF,ITF2,14,Molise
2021-06-16,PAT,6207,3343,2864,2044,4163,ITH,ITH2,4,Provincia Autonoma Trento
2021-03-21,MOL,1246,542,704,479,767,ITF,ITF2,14,Molise
2021-05-21,VEN,44739,22009,22730,20992,23747,ITH,ITH3,5,Veneto
2021-01-25,LOM,7013,2367,4646,473,6540,ITC,ITC4,3,Lombardia
2021-05-06,VDA,1063,509,554,679,384,ITC,ITC2,2,Valle d'Aosta / Vallée d'Aoste
2021-05-31,PUG,37643,18110,19533,23571,14072,ITF,ITF4,16,Puglia
2021-06-28,LAZ,58201,27687,30514,27778,30423,ITI,ITI4,12,Lazio
2021-02-01,LOM,16065,5322,10743,309,15756,ITC,ITC4,3,Lombardia
2021-02-12,BAS,775,332,443,744,31,ITF,ITF5,17,Basilicata
2021-03-14,MOL,596,240,356,17,579,ITF,ITF2,14,Molise
2020-12-27,CAL,311,170,141,311,0,ITF,ITF6,18,Calabria
2021-03-18,EMR,13675,5806,7869,5675,8000,ITH,ITH5,8,Emilia-Romagna
2021-06-22,MOL,2959,1368,1591,685,2274,ITF,ITF2,14,Molise
2021-06-23,PIE,39577,19631,19946,16792,22785,ITC,ITC1,1,Piemonte
2021-05-14,EMR,37242,17164,20078,27644,9598,ITH,ITH5,8,Emilia-Romagna
2021-02-03,EMR,9338,2989,6349,965,8373,ITH,ITH5,8,Emilia-Romagna
2021-04-10,BAS,1033,378,655,950,83,ITF,ITF5,17,Basilicata
2021-04-01,EMR,23947,10770,13177,19401,4546,ITH,ITH5,8,Emilia-Romagna
2021-03-13,UMB,1735,524,1211,1486,249,ITI,ITI2,10,Umbria
2021-06-21,SIC,39579,18319,21260,18180,21399,ITG,ITG1,19,Sicilia
2021-01-15,UMB,695,213,482,695,0,ITI,ITI2,10,Umbria
2021-02-01,CAM,3984,1813,2171,110,3874,ITF,ITF3,15,Campania
2021-02-26,ABR,3924,1680,2244,2955,969,ITF,ITF1,13,Abruzzo
2021-02-17,EMR,6538,2764,3774,5766,772,ITH,ITH5,8,Emilia-Romagna
2021-04-06,CAL,8015,3640,4375,4439,3576,ITF,ITF6,18,Calabria
2021-01-29,UMB,1230,348,882,79,1151,ITI,ITI2,10,Umbria
2021-03-30,CAM,22050,10575,11475,19092,2958,ITF,ITF3,15,Campania
2021-05-09,SIC,28076,13136,14940,19807,8269,ITG,ITG1,19,Sicilia
2021-02-08,CAL,1856,737,1119,663,1193,ITF,ITF6,18,Calabria
2021-05-09,UMB,5753,2752,3001,5362,391,ITI,ITI2,10,Umbria
2021-02-16,VDA,326,53,273,320,6,ITC,ITC2,2,Valle d'Aosta / Vallée d'Aoste
2021-05-04,FVG,9536,4298,5238,6182,3354,ITH,ITH4,6,Friuli-Venezia Giulia
2021-06-01,EMR,27135,13086,14049,17246,9889,ITH,ITH5,8,Emilia-Romagna
2021-02-15,MAR,967,412,555,954,13,ITI,ITI3,11,Marche
2021-03-15,PAT,1411,545,866,947,464,ITH,ITH2,4,Provincia Autonoma Trento
2021-06-24,BAS,4122,1950,2172,2219,1903,ITF,ITF5,17,Basilicata
2021-01-24,FVG,305,119,186,1,304,ITH,ITH4,6,Friuli-Venezia Giulia
2021-06-11,TOS,29663,15425,14238,25057,4606,ITI,ITI1,9,Toscana
2021-06-30,FVG,12055,6148,5907,1387,10668,ITH,ITH4,6,Friuli-Venezia Giulia
2021-01-17,PAT,251,195,56,251,0,ITH,ITH2,4,Provincia Autonoma Trento
2021-04-28,BAS,4704,2158,2546,4263,441,ITF,ITF5,17,Basilicata
2021-05-26,MAR,11810,5920,5890,8626,3184,ITI,ITI3,11,Marche
2021-06-23,PAT,6509,3450,3059,4639,1870,ITH,ITH2,4,Provincia Autonoma Trento
2021-02-12,LAZ,6848,2849,3999,6432,416,ITI,ITI4,12,Lazio
2021-04-15,TOS,24314,10161,14153,15799,8515,ITI,ITI1,9,Toscana
2021-02-17,TOS,8176,3170,5006,7424,752,ITI,ITI1,9,Toscana
2021-03-08,FVG,4120,1642,2478,2034,2086,ITH,ITH4,6,Friuli-Venezia Giulia
2021-04-25,PUG,11308,5236,6072,10150,1158,ITF,ITF4,16,Puglia
2021-05-11,PAT,3700,1750,1950,2850,850,ITH,ITH2,4,Provincia Autonoma Trento
2021-02-27,PUG,14221,4818,9403,12996,1225,ITF,ITF4,16,Puglia
2021-04-06,LIG,13246,5902,7344,10986,2260,ITC,ITC3,7,Liguria
2021-04-24,CAL,19298,9606,9692,15806,3492,ITF,ITF6,18,Calabria
2021-04-17,CAM,36182,17510,18672,24670,11512,ITF,ITF3,15,Campania
2021-01-01,PUG,148,61,87,148,0,ITF,ITF4,16,Puglia
2021-02-08,LIG,1977,741,1236,306,1671,ITC,ITC3,7,Liguria
2021-02-26,CAL,3079,1641,1438,2626,453,ITF,ITF6,18,Calabria
2021-05-31,PAB,2987,1464,1523,2120,867,ITH,ITH1,4,Provincia Autonoma Bolzano / Bozen
2021-06-07,PUG,44056,21512,22544,30858,13198,ITF,ITF4,16,Puglia
2021-02-17,VEN,6022,2772,3250,5928,94,ITH,ITH3,5,Veneto
2021-03-28,MOL,1626,747,879,524,1102,ITF,ITF2,14,Molise
2021-06-13,CAM,41845,20397,21448,37118,4727,ITF,ITF3,15,Campania
2021-03-22,FVG,3658,1445,2213,1704,1954,ITH,ITH4,6,Friuli-Venezia Giulia
2021-04-11,PUG,16463,7252,9211,14805,1658,ITF,ITF4,16,Puglia
2021-01-30,MOL,461,158,303,12,449,ITF,ITF2,14,Molise
2021-03-02,BAS,797,384,413,661,136,ITF,ITF5,17,Basilicata
2021-03-30,MAR,7468,3073,4395,4645,2823,ITI,ITI3,11,Marche
2021-04-27,PAT,3912,1880,2032,3843,69,ITH,ITH2,4,Provincia Autonoma Trento
2020-12-27,LIG,135,56,79,135,0,ITC,ITC3,7,Liguria
2021-02-05,SAR,1897,749,1148,433,1464,ITG,ITG2,20,Sardegna
2021-06-20,CAL,6498,3076,3422,3689,2809,ITF,ITF6,18,Calabria
2021-02-01,MAR,1362,479,883,98,1264,ITI,ITI3,11,Marche
2021-04-01,VEN,25318,11153,14165,18908,6410,ITH,ITH3,5,Veneto
2021-06-10,BAS,4529,2174,2355,3942,587,ITF,ITF5,17,Basilicata
2021-02-05,SIC,6740,2979,3761,2127,4613,ITG,ITG1,19,Sicilia
2021-03-08,PIE,14020,5359,8661,11306,2714,ITC,ITC1,1,Piemonte
2021-04-03,SAR,4669,1806,2863,2702,1967,ITG,ITG2,20,Sardegna
2021-01-18,ABR,125,51,74,46,79,ITF,ITF1,13,Abruzzo
2021-06-24,ABR,10724,5336,5388,5687,5037,ITF,ITF1,13,Abruzzo
2021-05-02,EMR,25578,11651,13927,13588,11990,ITH,ITH5,8,Emilia-Romagna
2021-05-12,TOS,34158,15559,18599,14146,20012,ITI,ITI1,9,Toscana
2021-05-08,MOL,2974,1455,1519,1730,1244,ITF,ITF2,14,Molise
2021-01-22,EMR,1829,477,1352,1088,741,ITH,ITH5,8,Emilia-Romagna
2021-03-01,UMB,1504,774,730,1390,114,ITI,ITI2,10,Umbria
2021-01-18,TOS,1119,636,483,1021,98,ITI,ITI1,9,Toscana
2021-04-20,VEN,22430,9495,12935,8431,13999,ITH,ITH3,5,Veneto
2021-04-21,MOL,1864,789,1075,969,895,ITF,ITF2,14,Molise
2021-06-19,MAR,14459,7284,7175,7788,6671,ITI,ITI3,11,Marche
2021-02-08,EMR,5231,1534,3697,2318,2913,ITH,ITH5,8,Emilia-Romagna
2021-02-14,BAS,151,48,103,151,0,ITF,ITF5,17,Basilicata
2021-06-09,UMB,8061,3907,4154,7340,721,ITI,ITI2,10,Umbria
2021-05-16,EMR,25845,12168,13677,18733,7112,ITH,ITH5,8,Emilia-Romagna
2021-06-23,UMB,11185,5713,5472,7789,3396,ITI,ITI2,10,Umbria
2021-01-27,CAL,1465,738,727,397,1068,ITF,ITF6,18,Calabria
2021-01-28,PUG,5474,2277,3197,471,5003,ITF,ITF4,16,Puglia
2021-01-12,ABR,1805,667,1138,1805,0,ITF,ITF1,13,Abruzzo
2021-03-18,CAM,12175,5380,6795,5986,6189,ITF,ITF3,15,Campania
2021-04-15,LAZ,31935,14309,17626,21122,10813,ITI,ITI4,12,Lazio
2021-01-31,BAS,77,24,53,0,77,ITF,ITF5,17,Basilicata
2021-02-22,EMR,7482,3091,4391,7210,272,ITH,ITH5,8,Emilia-Romagna
2021-03-15,UMB,4594,1938,2656,2828,1766,ITI,ITI2,10,Umbria
2021-06-23,SIC,43758,20351,23407,17566,26192,ITG,ITG1,19,Sicilia
2021-02-01,TOS,5509,1958,3551,521,4988,ITI,ITI1,9,Toscana
2021-05-25,ABR,11419,5324,6095,8282,3137,ITF,ITF1,13,Abruzzo
2021-06-26,LIG,7057,3286,3771,4505,2552,ITC,ITC3,7,Liguria
2021-02-10,LAZ,8191,3402,4789,4849,3342,ITI,ITI4,12,Lazio
2021-02-10,UMB,714,348,366,699,15,ITI,ITI2,10,Umbria
2021-03-13,PAT,834,383,451,786,48,ITH,ITH2,4,Provincia Autonoma Trento
2021-05-09,VEN,35034,16114,18920,24979,10055,ITH,ITH3,5,Veneto
2021-05-21,LAZ,51802,24858,26944,37856,13946,ITI,ITI4,12,Lazio
2021-05-31,MAR,11781,5943,5838,8852,2929,ITI,ITI3,11,Marche
2021-04-05,VDA,464,223,241,458,6,ITC,ITC2,2,Valle d'Aosta / Vallée d'Aoste
2021-06-04,LAZ,61300,29856,31444,43722,17578,ITI,ITI4,12,Lazio
2021-05-02,FVG,6898,3248,3650,3939,2959,ITH,ITH4,6,Friuli-Venezia Giulia
2021-02-20,PIE,3834,1254,2580,3660,174,ITC,ITC1,1,Piemonte
2021-05-17,MAR,11865,5572,6293,7690,4175,ITI,ITI3,11,Marche
2021-06-27,VDA,1250,607,643,322,928,ITC,ITC2,2,Valle d'Aosta / Vallée d'Aoste
2021-01-12,BAS,217,88,129,217,0,ITF,ITF5,17,Basilicata
2021-02-11,MOL,293,133,160,257,36,ITF,ITF2,14,Molise
2021-06-05,PAB,6068,3022,3046,4973,1095,ITH,ITH1,4,Provincia Autonoma Bolzano / Bozen
2021-03-04,LOM,29315,12107,17208,20257,9058,ITC,ITC4,3,Lombardia
2021-04-04,LIG,756,366,390,507,249,ITC,ITC3,7,Liguria
2021-04-23,PUG,29488,13706,15782,24232,5256,ITF,ITF4,16,Puglia
2021-01-31,ABR,1521,493,1028,288,1233,ITF,ITF1,13,Abruzzo
2021-05-04,LAZ,39868,18342,21526,26348,13520,ITI,ITI4,12,Lazio
2021-05-22,MOL,1315,712,603,1231,84,ITF,ITF2,14,Molise
2021-06-21,PAT,6128,3308,2820,3731,2397,ITH,ITH2,4,Provincia Autonoma Trento
2021-04-18,LIG,2613,1164,1449,2145,468,ITC,ITC3,7,Liguria
2021-05-16,FVG,9987,4779,5208,8588,1399,ITH,ITH4,6,Friuli-Venezia Giulia
2021-05-26,VEN,31045,15177,15868,14586,16459,ITH,ITH3,5,Veneto
2021-05-28,SAR,17946,8691,9255,13670,4276,ITG,ITG2,20,Sardegna
2021-05-10,ABR,10103,4780,5323,5454,4649,ITF,ITF1,13,Abruzzo
2021-02-17,SAR,1407,577,830,1333,74,ITG,ITG2,20,Sardegna
2021-04-30,PAB,3338,1592,1746,1562,1776,ITH,ITH1,4,Provincia Autonoma Bolzano / Bozen
2021-04-29,PIE,48475,21979,26496,35857,12618,ITC,ITC1,1,Piemonte
2021-05-25,SAR,15137,7701,7436,8661,6476,ITG,ITG2,20,Sardegna
2021-01-08,LIG,2927,999,1928,2927,0,ITC,ITC3,7,Liguria
2021-01-20,PAB,617,252,365,409,208,ITH,ITH1,4,Provincia Autonoma Bolzano / Bozen
2021-01-24,SIC,4317,2256,2061,134,4183,ITG,ITG1,19,Sicilia
2021-04-23,ABR,7382,3388,3994,5080,2302,ITF,ITF1,13,Abruzzo
2021-04-30,MAR,14076,6161,7915,5533,8543,ITI,ITI3,11,Marche
2021-01-06,PAB,59,18,41,59,0,ITH,ITH1,4,Provincia Autonoma Bolzano / Bozen
2021-02-14,CAL,468,214,254,438,30,ITF,ITF6,18,Calabria
2021-06-11,SAR,14771,7015,7756,9240,5531,ITG,ITG2,20,Sardegna
2021-06-30,LOM,101488,50194,51294,53623,47865,ITC,ITC4,3,Lombardia
2021-01-30,ABR,1511,568,943,69,1442,ITF,ITF1,13,Abruzzo
2021-03-01,VEN,9395,3716,5679,7573,1822,ITH,ITH3,5,Veneto
2021-04-05,CAM,11638,5542,6096,9214,2424,ITF,ITF3,15,Campania
2021-03-03,SAR,4120,2282,1838,2821,1299,ITG,ITG2,20,Sardegna
2021-03-22,LOM,40334,14300,26034,29779,10555,ITC,ITC4,3,Lombardia
2021-05-16,PIE,28145,12780,15365,15080,13065,ITC,ITC1,1,Piemonte
2021-05-25,CAL,16376,8003,8373,10290,6086,ITF,ITF6,18,Calabria
2021-04-08,LOM,52354,21761,30593,35896,16458,ITC,ITC4,3,Lombardia
2021-02-05,PIE,9604,3139,6465,659,8945,ITC,ITC1,1,Piemonte
2020-12-29,LOM,106,45,61,106,0,ITC,ITC4,3,Lombardia
2021-02-24,LAZ,12049,5209,6840,11055,994,ITI,ITI4,12,Lazio
2021-01-24,UMB,258,106,152,1,257,ITI,ITI2,10,Umbria
2021-05-04,SIC,26829,12470,14359,17535,9294,ITG,ITG1,19,Sicilia
2021-04-22,LOM,73894,33383,40511,57569,16325,ITC,ITC4,3,Lombardia
2021-03-17,CAM,11590,5100,6490,5009,6581,ITF,ITF3,15,Campania
2021-04-29,PAT,4642,2241,2401,4434,208,ITH,ITH2,4,Provincia Autonoma Trento
2021-05-10,BAS,4804,2382,2422,2762,2042,ITF,ITF5,17,Basilicata
2021-03-03,LOM,26970,11515,15455,19689,7281,ITC,ITC4,3,Lombardia
2021-04-27,TOS,10347,4911,5436,3864,6483,ITI,ITI1,9,Toscana
2021-06-18,FVG,10486,5118,5368,3231,7255,ITH,ITH4,6,Friuli-Venezia Giulia
2021-03-18,PUG,9475,4291,5184,3329,6146,ITF,ITF4,16,Puglia
2021-04-11,MAR,7117,3115,4002,6831,286,ITI,ITI3,11,Marche
2021-01-22,PAT,1670,433,1237,329,1341,ITH,ITH2,4,Provincia Autonoma Trento
2021-01-26,CAL,1833,873,960,277,1556,ITF,ITF6,18,Calabria
2021-03-10,FVG,3584,1696,1888,1790,1794,ITH,ITH4,6,Friuli-Venezia Giulia
2021-06-26,PUG,30669,15407,15262,15656,15013,ITF,ITF4,16,Puglia
2021-01-27,LIG,1744,603,1141,141,1603,ITC,ITC3,7,Liguria
2021-02-05,PAT,802,272,530,283,519,ITH,ITH2,4,Provincia Autonoma Trento
2021-02-24,FVG,2523,1087,1436,2505,18,ITH,ITH4,6,Friuli-Venezia Giulia
2021-03-29,LAZ,25205,11885,13320,18168,7037,ITI,ITI4,12,Lazio
2021-05-01,EMR,28402,12774,15628,15626,12776,ITH,ITH5,8,Emilia-Romagna
2020-12-27,EMR,972,373,599,972,0,ITH,ITH5,8,Emilia-Romagna
2021-02-18,LIG,2768,1126,1642,2434,334,ITC,ITC3,7,Liguria
2021-03-06,LAZ,18359,7084,11275,14102,4257,ITI,ITI4,12,Lazio
2021-03-25,VEN,25952,11055,14897,19853,6099,ITH,ITH3,5,Veneto
2021-06-09,PIE,38554,20322,18232,35843,2711,ITC,ITC1,1,Piemonte
2021-02-03,CAM,8903,4003,4900,878,8025,ITF,ITF3,15,Campania
2021-04-11,VEN,21011,8876,12135,14702,6309,ITH,ITH3,5,Veneto
2021-06-20,BAS,4004,1879,2125,1968,2036,ITF,ITF5,17,Basilicata
2021-01-11,MAR,1176,411,765,1176,0,ITI,ITI3,11,Marche
2021-02-22,CAL,2053,1042,1011,1495,558,ITF,ITF6,18,Calabria
2021-03-18,PIE,11759,4805,6954,4029,7730,ITC,ITC1,1,Piemonte
2021-04-14,PUG,31926,15069,16857,28619,3307,ITF,ITF4,16,Puglia
2021-05-07,TOS,32075,14669,17406,11973,20102,ITI,ITI1,9,Toscana
2021-06-28,FVG,9637,4826,4811,2055,7582,ITH,ITH4,6,Friuli-Venezia Giulia
2021-03-28,PUG,3540,1654,1886,1214,2326,ITF,ITF4,16,Puglia
2021-03-29,ABR,5709,2599,3110,3070,2639,ITF,ITF1,13,Abruzzo
2021-03-30,LOM,39620,15588,24032,24842,14778,ITC,ITC4,3,Lombardia
2021-04-21,MAR,10782,4967,5815,9588,1194,ITI,ITI3,11,Marche
2021-06-02,CAL,12084,5797,6287,8818,3266,ITF,ITF6,18,Calabria
2021-03-20,FVG,3401,1409,1992,1310,2091,ITH,ITH4,6,Friuli-Venezia Giulia
2021-07-01,PAB,4531,2248,2283,1371,3160,ITH,ITH1,4,Provincia Autonoma Bolzano / Bozen
2021-05-14,LIG,13107,5838,7269,8780,4327,ITC,ITC3,7,Liguria
2021-01-20,SAR,210,77,133,208,2,ITG,ITG2,20,Sardegna
2021-01-28,MAR,2087,725,1362,165,1922,ITI,ITI3,11,Marche
2021-05-18,VDA,970,484,486,353,617,ITC,ITC2,2,Valle d'Aosta / Vallée d'Aoste
2021-06-18,UMB,4759,2349,2410,1607,3152,ITI,ITI2,10,Umbria
2021-01-06,LOM,7060,2493,4567,7060,0,ITC,ITC4,3,Lombardia
2021-05-31,LIG,14639,7328,7311,9125,5514,ITC,ITC3,7,Liguria
2021-06-19,PUG,33905,16969,16936,22178,11727,ITF,ITF4,16,Puglia
2021-02-07,VDA,292,120,172,190,102,ITC,ITC2,2,Valle d'Aosta / Vallée d'Aoste
2021-04-13,VEN,14031,6324,7707,8545,5486,ITH,ITH3,5,Veneto
2021-06-03,ABR,13179,6278,6901,9406,3773,ITF,ITF1,13,Abruzzo
2021-01-13,FVG,2650,834,1816,2650,0,ITH,ITH4,6,Friuli-Venezia Giulia
2021-02-13,TOS,7786,2361,5425,7559,227,ITI,ITI1,9,Toscana
2021-03-09,LIG,5930,2753,3177,4499,1431,ITC,ITC3,7,Liguria
2021-04-06,FVG,6665,3123,3542,5515,1150,ITH,ITH4,6,Friuli-Venezia Giulia
2021-03-12,ABR,6014,1987,4027,4432,1582,ITF,ITF1,13,Abruzzo
2021-04-04,MAR,3824,1792,2032,2655,1169,ITI,ITI3,11,Marche
2021-05-16,CAL,13785,6725,7060,9974,3811,ITF,ITF6,18,Calabria
2020-12-27,FVG,262,149,113,262,0,ITH,ITH4,6,Friuli-Venezia Giulia
2021-03-26,MOL,2575,1045,1530,1933,642,ITF,ITF2,14,Molise
2021-02-20,LIG,1335,637,698,1334,1,ITC,ITC3,7,Liguria
2021-05-01,VDA,940,563,377,456,484,ITC,ITC2,2,Valle d'Aosta / Vallée d'Aoste
2021-06-20,ABR,8315,4178,4137,5389,2926,ITF,ITF1,13,Abruzzo
2021-03-03,PIE,12120,4644,7476,11301,819,ITC,ITC1,1,Piemonte
2021-03-29,SAR,4725,1829,2896,4136,589,ITG,ITG2,20,Sardegna
2021-05-13,UMB,5914,2657,3257,3831,2083,ITI,ITI2,10,Umbria
2021-03-14,ABR,1873,731,1142,1207,666,ITF,ITF1,13,Abruzzo
2021-04-14,VDA,941,430,511,717,224,ITC,ITC2,2,Valle d'Aosta / Vallée d'Aoste
2021-05-18,CAM,52174,23229,28945,32521,19653,ITF,ITF3,15,Campania
2021-04-15,SAR,11847,5541,6306,6889,4958,ITG,ITG2,20,Sardegna
2021-01-03,VEN,5157,1562,3595,5157,0,ITH,ITH3,5,Veneto
2021-02-19,UMB,743,293,450,526,217,ITI,ITI2,10,Umbria
2021-06-21,PUG,40838,19890,20948,21400,19438,ITF,ITF4,16,Puglia
2021-01-05,SAR,1327,446,881,1327,0,ITG,ITG2,20,Sardegna
2021-01-08,TOS,5947,1643,4304,5947,0,ITI,ITI1,9,Toscana
2021-03-20,PIE,11922,4899,7023,6024,5898,ITC,ITC1,1,Piemonte
2021-06-09,MAR,14043,7304,6739,12174,1869,ITI,ITI3,11,Marche
2021-03-04,PAB,1715,1005,710,1486,229,ITH,ITH1,4,Provincia Autonoma Bolzano / Bozen
2021-01-22,SAR,83,47,36,55,28,ITG,ITG2,20,Sardegna
2021-02-12,PAT,1011,340,671,590,421,ITH,ITH2,4,Provincia Autonoma Trento
2021-01-17,CAL,896,430,466,801,95,ITF,ITF6,18,Calabria
2021-05-16,LIG,3705,1862,1843,2145,1560,ITC,ITC3,7,Liguria
2021-05-18,LOM,88191,42153,46038,32630,55561,ITC,ITC4,3,Lombardia
2021-02-19,SIC,4906,2647,2259,4343,563,ITG,ITG1,19,Sicilia
2021-06-04,LOM,104410,54209,50201,94790,9620,ITC,ITC4,3,Lombardia
2021-02-22,LIG,3343,1476,1867,3201,142,ITC,ITC3,7,Liguria
2021-02-24,LOM,14720,5957,8763,13766,954,ITC,ITC4,3,Lombardia
2021-02-25,ABR,3052,1340,1712,2524,528,ITF,ITF1,13,Abruzzo
2021-03-01,PAT,1237,454,783,942,295,ITH,ITH2,4,Provincia Autonoma Trento
2021-03-08,SIC,13393,5866,7527,10780,2613,ITG,ITG1,19,Sicilia
2021-06-05,ABR,14581,6841,7740,10533,4048,ITF,ITF1,13,Abruzzo
2021-06-07,MAR,13162,6500,6662,10712,2450,ITI,ITI3,11,Marche
2021-01-31,LAZ,4460,1854,2606,477,3983,ITI,ITI4,12,Lazio
2021-02-05,CAM,7260,3463,3797,2132,5128,ITF,ITF3,15,Campania
2021-03-20,PAT,874,403,471,671,203,ITH,ITH2,4,Provincia Autonoma Trento
2021-03-24,CAL,7808,3571,4237,4534,3274,ITF,ITF6,18,Calabria
2021-03-03,PAT,1659,622,1037,1141,518,ITH,ITH2,4,Provincia Autonoma Trento
2021-03-14,BAS,1010,477,533,541,469,ITF,ITF5,17,Basilicata
2021-01-02,VDA,6,5,1,6,0,ITC,ITC2,2,Valle d'Aosta / Vallée d'Aoste
2021-05-11,LAZ,48268,22166,26102,31731,16537,ITI,ITI4,12,Lazio
2021-06-13,EMR,27255,14238,13017,22999,4256,ITH,ITH5,8,Emilia-Romagna
2021-03-26,VDA,498,204,294,491,7,ITC,ITC2,2,Valle d'Aosta / Vallée d'Aoste
2021-05-16,LOM,68675,32497,36178,36497,32178,ITC,ITC4,3,Lombardia
2021-05-30,SIC,35767,16169,19598,17719,18048,ITG,ITG1,19,Sicilia
2021-03-05,EMR,17850,5839,12011,14396,3454,ITH,ITH5,8,Emilia-Romagna
2021-02-05,LOM,25702,7456,18246,2428,23274,ITC,ITC4,3,Lombardia
2021-02-27,MAR,3383,1449,1934,3174,209,ITI,ITI3,11,Marche
2021-04-10,CAL,11598,5244,6354,6744,4854,ITF,ITF6,18,Calabria
2021-04-17,SAR,10086,4503,5583,5487,4599,ITG,ITG2,20,Sardegna
2021-02-18,MOL,319,74,245,306,13,ITF,ITF2,14,Molise
2021-03-31,BAS,3094,1258,1836,2312,782,ITF,ITF5,17,Basilicata
2021-05-13,SIC,47275,22161,25114,30739,16536,ITG,ITG1,19,Sicilia
2021-02-12,FVG,1193,428,765,1146,47,ITH,ITH4,6,Friuli-Venezia Giulia
2021-03-22,EMR,17650,7815,9835,10786,6864,ITH,ITH5,8,Emilia-Romagna
2021-06-17,VDA,775,422,353,626,149,ITC,ITC2,2,Valle d'Aosta / Vallée d'Aoste
2021-04-01,TOS,27023,11210,15813,16394,10629,ITI,ITI1,9,Toscana
2021-03-30,PIE,16917,7056,9861,9044,7873,ITC,ITC1,1,Piemonte
2021-02-09,ABR,909,312,597,500,409,ITF,ITF1,13,Abruzzo
2021-06-02,LAZ,43235,21482,21753,31736,11499,ITI,ITI4,12,Lazio
2021-02-23,MOL,582,223,359,363,219,ITF,ITF2,14,Molise
2021-03-06,CAM,16371,6814,9557,10702,5669,ITF,ITF3,15,Campania
2021-05-04,CAL,16439,7576,8863,11739,4700,ITF,ITF6,18,Calabria
2021-06-11,LAZ,69036,32375,36661,36896,32140,ITI,ITI4,12,Lazio
2021-06-03,MOL,3291,1566,1725,2737,554,ITF,ITF2,14,Molise
2021-03-01,SIC,12694,6015,6679,11038,1656,ITG,ITG1,19,Sicilia
2021-04-07,MOL,1688,847,841,1413,275,ITF,ITF2,14,Molise
2021-03-04,LIG,4738,2118,2620,3891,847,ITC,ITC3,7,Liguria
2021-03-06,LOM,21322,9092,12230,16810,4512,ITC,ITC4,3,Lombardia
2021-04-01,FVG,6391,3052,3339,5376,1015,ITH,ITH4,6,Friuli-Venezia Giulia
2021-04-09,MAR,9568,4191,5377,9368,200,ITI,ITI3,11,Marche
2021-04-20,EMR,22621,10405,12216,14268,8353,ITH,ITH5,8,Emilia-Romagna
2021-05-28,FVG,10525,5038,5487,6419,4106,ITH,ITH4,6,Friuli-Venezia Giulia
2021-06-12,LIG,10114,4909,5205,7892,2222,ITC,ITC3,7,Liguria
2021-04-08,UMB,5858,2509,3349,4069,1789,ITI,ITI2,10,Umbria
2021-03-30,PAT,2388,973,1415,1751,637,ITH,ITH2,4,Provincia Autonoma Trento
2021-03-24,BAS,1897,724,1173,1499,398,ITF,ITF5,17,Basilicata
2021-04-19,VDA,751,325,426,542,209,ITC,ITC2,2,Valle d'Aosta / Vallée d'Aoste
2021-04-30,LIG,14416,6439,7977,5848,8568,ITC,ITC3,7,Liguria
2021-06-23,EMR,37288,18651,18637,18510,18778,ITH,ITH5,8,Emilia-Romagna
2021-06-09,SIC,49373,23495,25878,42244,7129,ITG,ITG1,19,Sicilia
2021-01-13,TOS,4062,1398,2664,4062,0,ITI,ITI1,9,Toscana
2021-04-25,VEN,18316,8149,10167,13481,4835,ITH,ITH3,5,Veneto
2021-06-17,PAB,1736,967,769,658,1078,ITH,ITH1,4,Provincia Autonoma Bolzano / Bozen
2021-04-01,PIE,19348,8083,11265,11228,8120,ITC,ITC1,1,Piemonte
2021-06-04,UMB,8904,4401,4503,7710,1194,ITI,ITI2,10,Umbria
2021-06-05,MOL,2964,1503,1461,2810,154,ITF,ITF2,14,Molise
2021-04-23,TOS,25597,11394,14203,9330,16267,ITI,ITI1,9,Toscana
2021-06-21,VEN,43756,21893,21863,20843,22913,ITH,ITH3,5,Veneto
2021-03-14,PUG,3327,1433,1894,2511,816,ITF,ITF4,16,Puglia
2021-05-28,PIE,35028,16592,18436,19051,15977,ITC,ITC1,1,Piemonte
2021-01-06,VEN,8134,2386,5748,8134,0,ITH,ITH3,5,Veneto
2021-01-22,CAL,659,275,384,657,2,ITF,ITF6,18,Calabria
2021-01-16,PUG,2506,1033,1473,2506,0,ITF,ITF4,16,Puglia
2021-06-09,LOM,102757,51779,50978,88308,14449,ITC,ITC4,3,Lombardia
2021-05-02,CAL,12513,5841,6672,10667,1846,ITF,ITF6,18,Calabria
2021-01-08,EMR,10866,3580,7286,10866,0,ITH,ITH5,8,Emilia-Romagna
2021-01-25,PIE,6215,1938,4277,983,5232,ITC,ITC1,1,Piemonte
2021-02-20,SAR,2041,855,1186,1707,334,ITG,ITG2,20,Sardegna
2021-01-02,PAB,91,48,43,91,0,ITH,ITH1,4,Provincia Autonoma Bolzano / Bozen
2021-03-06,EMR,20900,5935,14965,18169,2731,ITH,ITH5,8,Emilia-Romagna
2021-01-06,MAR,2204,801,1403,2204,0,ITI,ITI3,11,Marche
2021-03-06,LIG,3304,1842,1462,2599,705,ITC,ITC3,7,Liguria
2021-03-08,LOM,29742,11183,18559,22668,7074,ITC,ITC4,3,Lombardia
2021-03-29,CAL,5738,2468,3270,3978,1760,ITF,ITF6,18,Calabria
2021-06-23,VEN,48205,23898,24307,15098,33107,ITH,ITH3,5,Veneto
2021-01-31,CAL,1112,555,557,154,958,ITF,ITF6,18,Calabria
2021-05-04,LOM,86812,41074,45738,72425,14387,ITC,ITC4,3,Lombardia
2021-05-06,LAZ,48739,22695,26044,31192,17547,ITI,ITI4,12,Lazio
2021-06-26,PAB,4499,2306,2193,1427,3072,ITH,ITH1,4,Provincia Autonoma Bolzano / Bozen
2021-01-22,LIG,1819,604,1215,1333,486,ITC,ITC3,7,Liguria
2021-01-24,LOM,1199,457,742,536,663,ITC,ITC4,3,Lombardia
2021-02-19,FVG,3252,1290,1962,2825,427,ITH,ITH4,6,Friuli-Venezia Giulia
2021-03-04,MAR,6500,2879,3621,5107,1393,ITI,ITI3,11,Marche
2021-05-02,LIG,3978,1836,2142,511,3467,ITC,ITC3,7,Liguria
2021-03-13,MAR,5766,2656,3110,1805,3961,ITI,ITI3,11,Marche
2021-06-13,UMB,6763,3556,3207,6533,230,ITI,ITI2,10,Umbria
2021-01-16,VDA,237,80,157,237,0,ITC,ITC2,2,Valle d'Aosta / Vallée d'Aoste
2021-04-29,SAR,11123,5111,6012,6765,4358,ITG,ITG2,20,Sardegna
2021-06-22,VDA,1189,666,523,541,648,ITC,ITC2,2,Valle d'Aosta / Vallée d'Aoste
2021-03-08,CAM,14685,6846,7839,9910,4775,ITF,ITF3,15,Campania
2021-06-21,MAR,12450,6106,6344,5576,6874,ITI,ITI3,11,Marche
2021-02-11,ABR,816,262,554,773,43,ITF,ITF1,13,Abruzzo
2021-03-14,VDA,392,200,192,392,0,ITC,ITC2,2,Valle d'Aosta / Vallée d'Aoste
2021-06-25,SAR,16482,7796,8686,3942,12540,ITG,ITG2,20,Sardegna
2021-03-15,VEN,16666,7327,9339,11458,5208,ITH,ITH3,5,Veneto
2021-05-01,UMB,5370,2638,2732,2140,3230,ITI,ITI2,10,Umbria
2021-05-04,CAM,48478,23345,25133,39577,8901,ITF,ITF3,15,Campania
2021-06-06,PAT,2228,1061,1167,445,1783,ITH,ITH2,4,Provincia Autonoma Trento
2021-03-18,PAB,1302,531,771,226,1076,ITH,ITH1,4,Provincia Autonoma Bolzano / Bozen
2021-03-20,TOS,6586,2977,3609,5450,1136,ITI,ITI1,9,Toscana
2021-05-11,CAL,15055,7284,7771,10283,4772,ITF,ITF6,18,Calabria
2021-05-20,EMR,40267,18311,21956,18897,21370,ITH,ITH5,8,Emilia-Romagna
2021-05-30,PIE,27701,13187,14514,18377,9324,ITC,ITC1,1,Piemonte
2021-01-24,CAM,4122,2119,2003,377,3745,ITF,ITF3,15,Campania
2021-03-05,UMB,4619,1402,3217,3963,656,ITI,ITI2,10,Umbria
2021-05-09,MAR,8864,4020,4844,3637,5227,ITI,ITI3,11,Marche
2021-01-22,TOS,2866,1064,1802,528,2338,ITI,ITI1,9,Toscana
2021-02-19,PIE,5535,2175,3360,5034,501,ITC,ITC1,1,Piemonte
2021-04-26,VDA,715,327,388,545,170,ITC,ITC2,2,Valle d'Aosta / Vallée d'Aoste
2021-05-14,PAB,5134,2320,2814,3097,2037,ITH,ITH1,4,Provincia Autonoma Bolzano / Bozen
2021-05-21,PUG,38959,18500,20459,28944,10015,ITF,ITF4,16,Puglia
2021-03-04,MOL,850,417,433,526,324,ITF,ITF2,14,Molise
2021-03-16,PAB,1290,532,758,124,1166,ITH,ITH1,4,Provincia Autonoma Bolzano / Bozen
2021-05-13,CAM,55448,24827,30621,39445,16003,ITF,ITF3,15,Campania
2021-01-19,SIC,1498,662,836,1276,222,ITG,ITG1,19,Sicilia
2021-06-12,MOL,3400,1748,1652,3290,110,ITF,ITF2,14,Molise
2021-05-04,LIG,13647,6084,7563,5419,8228,ITC,ITC3,7,Liguria
2021-01-10,SAR,2183,750,1433,2183,0,ITG,ITG2,20,Sardegna
2021-07-01,VDA,961,472,489,341,620,ITC,ITC2,2,Valle d'Aosta / Vallée d'Aoste
2021-02-17,PAT,1112,425,687,1021,91,ITH,ITH2,4,Provincia Autonoma Trento
2021-03-03,UMB,4431,1770,2661,3721,710,ITI,ITI2,10,Umbria
2021-06-11,SIC,48306,23021,25285,40715,7591,ITG,ITG1,19,Sicilia
2021-05-24,ABR,12268,5856,6412,8918,3350,ITF,ITF1,13,Abruzzo
2021-03-08,CAL,5430,2914,2516,4364,1066,ITF,ITF6,18,Calabria
2021-03-30,SAR,8778,3591,5187,6502,2276,ITG,ITG2,20,Sardegna
2021-04-27,UMB,5663,2401,3262,3085,2578,ITI,ITI2,10,Umbria
2021-02-26,BAS,2150,904,1246,2070,80,ITF,ITF5,17,Basilicata
2021-02-03,UMB,724,174,550,67,657,ITI,ITI2,10,Umbria
2021-03-10,VDA,438,183,255,225,213,ITC,ITC2,2,Valle d'Aosta / Vallée d'Aoste
2021-03-20,LAZ,19089,7552,11537,13204,5885,ITI,ITI4,12,Lazio
2021-05-07,PAT,5997,3085,2912,5156,841,ITH,ITH2,4,Provincia Autonoma Trento
2021-05-14,SIC,52064,24404,27660,36369,15695,ITG,ITG1,19,Sicilia
2021-02-16,PAB,530,205,325,530,0,ITH,ITH1,4,Provincia Autonoma Bolzano / Bozen
2021-02-23,PUG,9364,4421,4943,8876,488,ITF,ITF4,16,Puglia
2021-04-20,PAT,2879,1377,1502,2843,36,ITH,ITH2,4,Provincia Autonoma Trento
2021-05-02,LOM,83503,38335,45168,61041,22462,ITC,ITC4,3,Lombardia
2021-01-06,SAR,1615,549,1066,1615,0,ITG,ITG2,20,Sardegna
2021-02-11,MAR,1987,657,1330,1598,389,ITI,ITI3,11,Marche
2021-03-25,CAL,7434,3492,3942,4577,2857,ITF,ITF6,18,Calabria
2021-01-28,PAB,871,308,563,9,862,ITH,ITH1,4,Provincia Autonoma Bolzano / Bozen
2021-02-02,MOL,539,176,363,216,323,ITF,ITF2,14,Molise
2021-02-21,VDA,18,3,15,0,18,ITC,ITC2,2,Valle d'Aosta / Vallée d'Aoste
2021-05-09,PAT,2324,1210,1114,1980,344,ITH,ITH2,4,Provincia Autonoma Trento
2021-05-20,BAS,5855,2964,2891,2890,2965,ITF,ITF5,17,Basilicata
2021-06-30,LAZ,61719,28854,32865,30027,31692,ITI,ITI4,12,Lazio
2021-01-16,MOL,420,166,254,420,0,ITF,ITF2,14,Molise
2021-04-13,CAM,26605,12684,13921,21072,5533,ITF,ITF3,15,Campania
2021-05-05,MAR,11677,5315,6362,5248,6429,ITI,ITI3,11,Marche
2021-06-16,CAL,17899,8253,9646,11809,6090,ITF,ITF6,18,Calabria
2021-01-03,CAM,3836,2009,1827,3836,0,ITF,ITF3,15,Campania
2021-02-15,PAT,534,188,346,420,114,ITH,ITH2,4,Provincia Autonoma Trento
2021-04-26,MOL,1157,521,636,826,331,ITF,ITF2,14,Molise
2021-06-06,BAS,4502,2070,2432,3723,779,ITF,ITF5,17,Basilicata
2021-06-01,VDA,871,469,402,518,353,ITC,ITC2,2,Valle d'Aosta / Vallée d'Aoste
2021-04-08,LAZ,26732,12242,14490,19036,7696,ITI,ITI4,12,Lazio
2021-05-26,PAT,3917,1843,2074,1225,2692,ITH,ITH2,4,Provincia Autonoma Trento
2021-04-09,MOL,2324,1251,1073,2133,191,ITF,ITF2,14,Molise
2021-04-13,LOM,47661,21277,26384,33585,14076,ITC,ITC4,3,Lombardia
2021-06-07,TOS,34812,17055,17757,31205,3607,ITI,ITI1,9,Toscana
2021-06-23,SAR,20526,9659,10867,6276,14250,ITG,ITG2,20,Sardegna
2021-01-15,SIC,5200,2281,2919,5200,0,ITG,ITG1,19,Sicilia
2021-04-20,FVG,7112,3061,4051,3209,3903,ITH,ITH4,6,Friuli-Venezia Giulia
2021-05-28,EMR,41166,18927,22239,17844,23322,ITH,ITH5,8,Emilia-Romagna
2021-04-25,SIC,21351,10184,11167,16375,4976,ITG,ITG1,19,Sicilia
2021-05-21,TOS,28868,13449,15419,17461,11407,ITI,ITI1,9,Toscana
2021-04-30,LOM,117246,54791,62455,89759,27487,ITC,ITC4,3,Lombardia
2021-02-01,SIC,5905,2625,3280,294,5611,ITG,ITG1,19,Sicilia
2021-01-20,LOM,5666,1377,4289,5552,114,ITC,ITC4,3,Lombardia
2021-01-18,MOL,114,48,66,114,0,ITF,ITF2,14,Molise
2021-04-27,VEN,28135,12757,15378,21221,6914,ITH,ITH3,5,Veneto
2021-03-22,SIC,16579,7833,8746,11216,5363,ITG,ITG1,19,Sicilia
2021-04-22,EMR,29049,13450,15599,14971,14078,ITH,ITH5,8,Emilia-Romagna
2021-06-19,ABR,10311,5080,5231,6481,3830,ITF,ITF1,13,Abruzzo
2021-01-17,VEN,1933,781,1152,1584,349,ITH,ITH3,5,Veneto
2021-02-05,UMB,780,234,546,18,762,ITI,ITI2,10,Umbria
2021-01-12,EMR,9476,3124,6352,9476,0,ITH,ITH5,8,Emilia-Romagna
2021-06-30,SIC,32042,14802,17240,11302,20740,ITG,ITG1,19,Sicilia
2020-12-29,SIC,243,152,91,243,0,ITG,ITG1,19,Sicilia
2021-01-10,FVG,2940,918,2022,2940,0,ITH,ITH4,6,Friuli-Venezia Giulia
2021-03-28,ABR,2415,1015,1400,2043,372,ITF,ITF1,13,Abruzzo
2021-06-25,PIE,45183,22507,22676,20801,24382,ITC,ITC1,1,Piemonte
2021-04-11,MOL,1196,591,605,1182,14,ITF,ITF2,14,Molise
2021-01-18,PUG,1845,771,1074,1496,349,ITF,ITF4,16,Puglia
2021-04-14,BAS,2040,998,1042,1366,674,ITF,ITF5,17,Basilicata
2021-04-05,FVG,2895,1438,1457,2880,15,ITH,ITH4,6,Friuli-Venezia Giulia
2021-04-03,PIE,19434,8159,11275,10887,8547,ITC,ITC1,1,Piemonte
2021-01-21,BAS,30,10,20,30,0,ITF,ITF5,17,Basilicata
2021-02-03,VEN,5945,1667,4278,480,5465,ITH,ITH3,5,Veneto
2021-01-10,PIE,5214,2275,2939,5214,0,ITC,ITC1,1,Piemonte
2021-06-13,SIC,33481,16638,16843,29994,3487,ITG,ITG1,19,Sicilia
2021-01-04,BAS,607,271,336,607,0,ITF,ITF5,17,Basilicata
2021-01-22,LOM,3142,868,2274,3073,69,ITC,ITC4,3,Lombardia
2021-06-16,LIG,15719,7559,8160,10191,5528,ITC,ITC3,7,Liguria
2021-01-12,FVG,2260,713,1547,2260,0,ITH,ITH4,6,Friuli-Venezia Giulia
2021-04-25,PAB,3073,1497,1576,2401,672,ITH,ITH1,4,Provincia Autonoma Bolzano / Bozen
2021-01-29,FVG,2412,813,1599,264,2148,ITH,ITH4,6,Friuli-Venezia Giulia
2021-02-06,PUG,4549,1931,2618,1592,2957,ITF,ITF4,16,Puglia
2021-03-01,TOS,4474,1734,2740,833,3641,ITI,ITI1,9,Toscana
2021-04-29,VEN,50261,23379,26882,37077,13184,ITH,ITH3,5,Veneto
2021-01-20,PUG,1548,542,1006,1540,8,ITF,ITF4,16,Puglia
2021-03-08,LIG,5623,2458,3165,3934,1689,ITC,ITC3,7,Liguria
2021-04-30,PUG,34916,15640,19276,22949,11967,ITF,ITF4,16,Puglia
2021-04-22,FVG,6781,3084,3697,3093,3688,ITH,ITH4,6,Friuli-Venezia Giulia
2021-02-05,VEN,8377,2534,5843,1417,6960,ITH,ITH3,5,Veneto
2021-04-14,ABR,6591,2949,3642,4473,2118,ITF,ITF1,13,Abruzzo
2021-05-07,MAR,12839,5807,7032,3659,9180,ITI,ITI3,11,Marche
2021-06-18,CAL,18439,8572,9867,10955,7484,ITF,ITF6,18,Calabria
2021-06-27,EMR,27884,14040,13844,15244,12640,ITH,ITH5,8,Emilia-Romagna
2021-04-12,UMB,7085,3081,4004,5368,1717,ITI,ITI2,10,Umbria
2021-02-22,VEN,7014,3041,3973,6627,387,ITH,ITH3,5,Veneto
2021-03-25,LIG,9761,4229,5532,6369,3392,ITC,ITC3,7,Liguria
2021-04-13,PUG,28722,13624,15098,25321,3401,ITF,ITF4,16,Puglia
2021-02-13,MAR,1094,462,632,1012,82,ITI,ITI3,11,Marche
2021-01-19,UMB,102,23,79,102,0,ITI,ITI2,10,Umbria
2021-02-23,VDA,216,123,93,216,0,ITC,ITC2,2,Valle d'Aosta / Vallée d'Aoste
2021-01-01,LIG,144,55,89,144,0,ITC,ITC3,7,Liguria
2021-04-05,EMR,14847,6801,8046,11955,2892,ITH,ITH5,8,Emilia-Romagna
2021-05-16,VEN,28411,14005,14406,21333,7078,ITH,ITH3,5,Veneto
2021-01-04,ABR,1403,576,827,1403,0,ITF,ITF1,13,Abruzzo
2021-01-27,MAR,2119,780,1339,121,1998,ITI,ITI3,11,Marche
2021-01-04,PAB,508,201,307,508,0,ITH,ITH1,4,Provincia Autonoma Bolzano / Bozen
2021-01-11,PUG,3754,1588,2166,3754,0,ITF,ITF4,16,Puglia
2021-02-12,VDA,263,96,167,217,46,ITC,ITC2,2,Valle d'Aosta / Vallée d'Aoste
2021-06-02,PAT,2838,1359,1479,944,1894,ITH,ITH2,4,Provincia Autonoma Trento
2021-06-14,LOM,94255,47894,46361,49745,44510,ITC,ITC4,3,Lombardia
2021-03-26,MAR,6333,2607,3726,3525,2808,ITI,ITI3,11,Marche
2021-04-13,PIE,25952,11619,14333,22493,3459,ITC,ITC1,1,Piemonte
2021-04-21,PUG,23092,10662,12430,19359,3733,ITF,ITF4,16,Puglia
2021-05-26,SAR,15533,8188,7345,9885,5648,ITG,ITG2,20,Sardegna
2021-02-13,VEN,3266,1473,1793,3246,20,ITH,ITH3,5,Veneto
2021-01-20,PIE,6617,2089,4528,5899,718,ITC,ITC1,1,Piemonte
2021-02-15,SAR,958,349,609,927,31,ITG,ITG2,20,Sardegna
2021-01-22,LAZ,4006,1636,2370,491,3515,ITI,ITI4,12,Lazio
2021-03-11,PAT,2298,851,1447,1474,824,ITH,ITH2,4,Provincia Autonoma Trento
2021-01-20,EMR,1325,270,1055,1324,1,ITH,ITH5,8,Emilia-Romagna
2021-05-24,PUG,36051,17008,19043,25067,10984,ITF,ITF4,16,Puglia
2021-06-17,MAR,14908,7422,7486,8851,6057,ITI,ITI3,11,Marche
2021-02-15,CAM,5471,2516,2955,5297,174,ITF,ITF3,15,Campania
2021-01-12,VDA,302,72,230,302,0,ITC,ITC2,2,Valle d'Aosta / Vallée d'Aoste
2021-02-16,PUG,3382,1454,1928,2736,646,ITF,ITF4,16,Puglia
2021-05-08,ABR,10291,4870,5421,6459,3832,ITF,ITF1,13,Abruzzo
2021-01-10,CAL,933,526,407,933,0,ITF,ITF6,18,Calabria
2021-01-30,PUG,5531,2514,3017,410,5121,ITF,ITF4,16,Puglia
2021-02-03,PIE,10202,3304,6898,611,9591,ITC,ITC1,1,Piemonte
2021-02-27,LAZ,11448,4284,7164,10470,978,ITI,ITI4,12,Lazio
2021-05-26,LOM,93622,44635,48987,43621,50001,ITC,ITC4,3,Lombardia
2021-06-09,CAM,52420,25739,26681,41519,10901,ITF,ITF3,15,Campania
2021-02-15,LOM,8949,3137,5812,8532,417,ITC,ITC4,3,Lombardia
2021-03-09,MAR,5428,2290,3138,4547,881,ITI,ITI3,11,Marche
2021-04-20,CAL,7847,3957,3890,6120,1727,ITF,ITF6,18,Calabria
2021-05-10,PUG,37699,16654,21045,19759,17940,ITF,ITF4,16,Puglia
2021-02-28,MOL,832,334,498,790,42,ITF,ITF2,14,Molise
2021-03-01,CAM,12129,4247,7882,8017,4112,ITF,ITF3,15,Campania
2021-01-01,TOS,2369,787,1582,2369,0,ITI,ITI1,9,Toscana
2021-02-22,FVG,2485,1193,1292,2067,418,ITH,ITH4,6,Friuli-Venezia Giulia
2021-04-24,ABR,8724,3975,4749,7195,1529,ITF,ITF1,13,Abruzzo
2021-04-11,TOS,3645,1680,1965,3490,155,ITI,ITI1,9,Toscana
2021-03-30,SIC,14535,6756,7779,9772,4763,ITG,ITG1,19,Sicilia
2021-05-09,CAM,43199,20285,22914,32104,11095,ITF,ITF3,15,Campania
2021-01-11,LIG,2652,990,1662,2652,0,ITC,ITC3,7,Liguria
2021-04-15,EMR,29343,13979,15364,19668,9675,ITH,ITH5,8,Emilia-Romagna
2021-06-02,FVG,9405,4950,4455,9126,279,ITH,ITH4,6,Friuli-Venezia Giulia
2021-01-14,ABR,530,189,341,530,0,ITF,ITF1,13,Abruzzo
2021-03-13,SIC,12210,5386,6824,7718,4492,ITG,ITG1,19,Sicilia
2021-02-27,MOL,1366,568,798,1347,19,ITF,ITF2,14,Molise
2021-03-19,BAS,2296,995,1301,266,2030,ITF,ITF5,17,Basilicata
2021-03-06,TOS,7109,2852,4257,2914,4195,ITI,ITI1,9,Toscana
2021-03-17,UMB,3328,1313,2015,1856,1472,ITI,ITI2,10,Umbria
2021-05-24,VDA,1136,516,620,689,447,ITC,ITC2,2,Valle d'Aosta / Vallée d'Aoste
2021-06-07,MOL,1952,858,1094,1133,819,ITF,ITF2,14,Molise
2021-06-18,EMR,41770,20890,20880,16129,25641,ITH,ITH5,8,Emilia-Romagna
2021-03-10,EMR,18796,7741,11055,13152,5644,ITH,ITH5,8,Emilia-Romagna
2021-05-10,VDA,782,381,401,547,235,ITC,ITC2,2,Valle d'Aosta / Vallée d'Aoste
2021-05-20,LAZ,51495,24752,26743,37778,13717,ITI,ITI4,12,Lazio
2021-02-13,MOL,132,80,52,132,0,ITF,ITF2,14,Molise
2021-04-13,MAR,9839,4260,5579,9605,234,ITI,ITI3,11,Marche
2021-01-07,UMB,1300,387,913,1300,0,ITI,ITI2,10,Umbria
2021-01-10,CAM,8165,3736,4429,8165,0,ITF,ITF3,15,Campania
2021-02-07,FVG,1563,482,1081,385,1178,ITH,ITH4,6,Friuli-Venezia Giulia
2021-04-17,SIC,26017,13150,12867,18951,7066,ITG,ITG1,19,Sicilia
2021-01-03,PAT,492,160,332,492,0,ITH,ITH2,4,Provincia Autonoma Trento
2021-05-24,MOL,1964,853,1111,1298,666,ITF,ITF2,14,Molise
2021-03-20,SAR,5197,2076,3121,2919,2278,ITG,ITG2,20,Sardegna
2021-02-16,BAS,907,377,530,809,98,ITF,ITF5,17,Basilicata
2021-05-07,MOL,2643,1228,1415,2046,597,ITF,ITF2,14,Molise
2021-02-06,PAB,2626,1171,1455,19,2607,ITH,ITH1,4,Provincia Autonoma Bolzano / Bozen
2021-02-13,PUG,3727,1456,2271,3031,696,ITF,ITF4,16,Puglia
2021-05-18,FVG,10784,5395,5389,8709,2075,ITH,ITH4,6,Friuli-Venezia Giulia
2021-01-10,LIG,648,262,386,648,0,ITC,ITC3,7,Liguria
2021-02-12,CAL,1710,668,1042,947,763,ITF,ITF6,18,Calabria
2021-03-03,VEN,12096,4646,7450,8597,3499,ITH,ITH3,5,Veneto
2021-03-17,SIC,14983,7397,7586,9195,5788,ITG,ITG1,19,Sicilia
2021-03-20,LOM,32585,12161,20424,22735,9850,ITC,ITC4,3,Lombardia
2021-04-20,LIG,14224,6512,7712,9876,4348,ITC,ITC3,7,Liguria
2021-06-20,LAZ,49224,22418,26806,24333,24891,ITI,ITI4,12,Lazio
2021-04-03,CAM,21115,10315,10800,18734,2381,ITF,ITF3,15,Campania
2021-06-21,PAB,3137,1596,1541,270,2867,ITH,ITH1,4,Provincia Autonoma Bolzano / Bozen
2021-06-25,SIC,39132,18323,20809,17154,21978,ITG,ITG1,19,Sicilia
2021-06-01,FVG,10089,5104,4985,7968,2121,ITH,ITH4,6,Friuli-Venezia Giulia
2021-06-11,VEN,46913,24401,22512,35778,11135,ITH,ITH3,5,Veneto
2021-05-18,PIE,32114,14821,17293,19452,12662,ITC,ITC1,1,Piemonte
2021-06-06,LAZ,57912,27912,30000,35415,22497,ITI,ITI4,12,Lazio
2021-06-13,SAR,9495,4671,4824,6235,3260,ITG,ITG2,20,Sardegna
2020-12-27,LOM,718,414,304,718,0,ITC,ITC4,3,Lombardia
2021-05-18,EMR,29094,13246,15848,18571,10523,ITH,ITH5,8,Emilia-Romagna
2021-06-16,MAR,13522,6793,6729,9157,4365,ITI,ITI3,11,Marche
2021-02-16,ABR,1917,842,1075,1905,12,ITF,ITF1,13,Abruzzo
2021-02-03,TOS,4221,1452,2769,241,3980,ITI,ITI1,9,Toscana
2021-02-07,EMR,4785,1536,3249,1724,3061,ITH,ITH5,8,Emilia-Romagna
2021-03-02,ABR,3965,1675,2290,3281,684,ITF,ITF1,13,Abruzzo
2021-06-25,VEN,50802,25705,25097,15184,35618,ITH,ITH3,5,Veneto
2021-06-25,UMB,10073,5215,4858,5370,4703,ITI,ITI2,10,Umbria
2021-02-26,LAZ,13119,5728,7391,11724,1395,ITI,ITI4,12,Lazio
2021-02-24,EMR,9351,3566,5785,8467,884,ITH,ITH5,8,Emilia-Romagna
2021-04-21,VDA,868,410,458,620,248,ITC,ITC2,2,Valle d'Aosta / Vallée d'Aoste
2021-06-10,ABR,12557,6245,6312,10394,2163,ITF,ITF1,13,Abruzzo
2021-01-05,EMR,9361,3170,6191,9361,0,ITH,ITH5,8,Emilia-Romagna
2021-05-04,PIE,28586,13145,15441,16410,12176,ITC,ITC1,1,Piemonte
2021-05-30,SAR,9729,4839,4890,7372,2357,ITG,ITG2,20,Sardegna
2021-04-28,ABR,9513,4587,4926,7490,2023,ITF,ITF1,13,Abruzzo
2021-01-24,PIE,3153,959,2194,434,2719,ITC,ITC1,1,Piemonte
2021-02-19,SAR,1499,473,1026,1443,56,ITG,ITG2,20,Sardegna
2021-06-06,CAL,13382,6437,6945,11686,1696,ITF,ITF6,18,Calabria
2021-06-30,PIE,40924,19999,20925,19125,21799,ITC,ITC1,1,Piemonte
2021-01-01,PAB,6,5,1,6,0,ITH,ITH1,4,Provincia Autonoma Bolzano / Bozen
2021-04-15,VEN,20904,8633,12271,10081,10823,ITH,ITH3,5,Veneto
2021-05-12,ABR,9630,4600,5030,6050,3580,ITF,ITF1,13,Abruzzo
2021-05-30,CAM,52108,25418,26690,38796,13312,ITF,ITF3,15,Campania
2021-06-07,PAB,2901,1506,1395,2582,319,ITH,ITH1,4,Provincia Autonoma Bolzano / Bozen
2021-03-22,PIE,11523,4890,6633,3917,7606,ITC,ITC1,1,Piemonte
2021-04-03,SIC,16414,7815,8599,13579,2835,ITG,ITG1,19,Sicilia
2021-01-05,VEN,7331,2183,5148,7331,0,ITH,ITH3,5,Veneto
2021-02-19,CAM,9571,3559,6012,8921,650,ITF,ITF3,15,Campania
2021-02-27,PAB,2458,759,1699,2448,10,ITH,ITH1,4,Provincia Autonoma Bolzano / Bozen
2021-03-16,ABR,3484,1452,2032,1830,1654,ITF,ITF1,13,Abruzzo
2020-12-31,LAZ,5293,2121,3172,5293,0,ITI,ITI4,12,Lazio
2021-04-03,LOM,36237,14859,21378,26150,10087,ITC,ITC4,3,Lombardia
2021-05-28,TOS,30060,13907,16153,17622,12438,ITI,ITI1,9,Toscana
2021-04-10,LAZ,23925,10408,13517,16735,7190,ITI,ITI4,12,Lazio
2021-05-30,LOM,74364,35585,38779,34411,39953,ITC,ITC4,3,Lombardia
2021-05-04,PAT,4511,2448,2063,4417,94,ITH,ITH2,4,Provincia Autonoma Trento
2021-01-17,FVG,1716,523,1193,1716,0,ITH,ITH4,6,Friuli-Venezia Giulia
2021-02-05,LAZ,7309,2979,4330,1210,6099,ITI,ITI4,12,Lazio
2021-04-07,VDA,910,474,436,681,229,ITC,ITC2,2,Valle d'Aosta / Vallée d'Aoste
2021-04-12,EMR,19242,9005,10237,14795,4447,ITH,ITH5,8,Emilia-Romagna
2021-04-22,TOS,35592,15246,20346,18194,17398,ITI,ITI1,9,Toscana
2021-03-08,PAT,1411,434,977,1057,354,ITH,ITH2,4,Provincia Autonoma Trento
2021-04-06,MAR,8875,3693,5182,8065,810,ITI,ITI3,11,Marche
2021-02-24,TOS,10371,4467,5904,10174,197,ITI,ITI1,9,Toscana
2021-03-15,FVG,3951,1809,2142,1630,2321,ITH,ITH4,6,Friuli-Venezia Giulia
2021-06-08,EMR,44691,22878,21813,37246,7445,ITH,ITH5,8,Emilia-Romagna
2021-03-22,PAT,2306,973,1333,1431,875,ITH,ITH2,4,Provincia Autonoma Trento
2021-06-04,TOS,28249,13376,14873,20495,7754,ITI,ITI1,9,Toscana
2021-01-24,PAT,547,276,271,224,323,ITH,ITH2,4,Provincia Autonoma Trento
2021-05-20,UMB,9830,4585,5245,6180,3650,ITI,ITI2,10,Umbria
2021-06-30,PAT,6648,3417,3231,2656,3992,ITH,ITH2,4,Provincia Autonoma Trento
2021-02-09,VDA,251,84,167,68,183,ITC,ITC2,2,Valle d'Aosta / Vallée d'Aoste
2021-03-06,PUG,16147,6126,10021,14055,2092,ITF,ITF4,16,Puglia
2021-04-03,LAZ,24784,11183,13601,18084,6700,ITI,ITI4,12,Lazio
2021-04-08,TOS,29681,12555,17126,23294,6387,ITI,ITI1,9,Toscana
2020-12-31,CAM,1489,810,679,1489,0,ITF,ITF3,15,Campania
2021-02-10,VEN,4751,1588,3163,3697,1054,ITH,ITH3,5,Veneto
2021-03-23,MAR,5790,2530,3260,2262,3528,ITI,ITI3,11,Marche
2021-06-06,CAM,62321,30978,31343,61674,647,ITF,ITF3,15,Campania
2021-01-07,CAL,2193,1071,1122,2193,0,ITF,ITF6,18,Calabria
2021-01-08,PUG,5647,2368,3279,5647,0,ITF,ITF4,16,Puglia
2021-02-13,PAB,318,79,239,312,6,ITH,ITH1,4,Provincia Autonoma Bolzano / Bozen
2021-06-13,CAL,6594,3243,3351,5564,1030,ITF,ITF6,18,Calabria
2021-06-14,PUG,41648,20383,21265,29311,12337,ITF,ITF4,16,Puglia
2021-02-06,MOL,429,179,250,29,400,ITF,ITF2,14,Molise
2021-02-26,CAM,13335,4227,9108,12000,1335,ITF,ITF3,15,Campania
2021-04-08,VEN,32362,14365,17997,24487,7875,ITH,ITH3,5,Veneto
2021-04-11,PAB,2721,1292,1429,2544,177,ITH,ITH1,4,Provincia Autonoma Bolzano / Bozen
2021-04-17,CAL,10825,5074,5751,9047,1778,ITF,ITF6,18,Calabria
2021-04-18,PUG,22596,10807,11789,21533,1063,ITF,ITF4,16,Puglia
2021-02-08,MAR,834,258,576,372,462,ITI,ITI3,11,Marche
2021-04-24,CAM,36362,17526,18836,25114,11248,ITF,ITF3,15,Campania
2021-06-17,BAS,4421,2034,2387,2103,2318,ITF,ITF5,17,Basilicata
2021-02-20,PUG,2970,1079,1891,2713,257,ITF,ITF4,16,Puglia
2021-03-27,SAR,5736,2192,3544,5314,422,ITG,ITG2,20,Sardegna
2021-05-01,CAL,16662,7943,8719,12463,4199,ITF,ITF6,18,Calabria
2021-05-11,FVG,9029,4331,4698,7227,1802,ITH,ITH4,6,Friuli-Venezia Giulia
2021-04-21,BAS,3922,1835,2087,2272,1650,ITF,ITF5,17,Basilicata
2021-05-19,MAR,11478,5276,6202,8561,2917,ITI,ITI3,11,Marche
2021-01-31,FVG,2717,838,1879,385,2332,ITH,ITH4,6,Friuli-Venezia Giulia
2021-02-15,LIG,2262,839,1423,1865,397,ITC,ITC3,7,Liguria
2021-03-05,CAL,6236,3619,2617,5662,574,ITF,ITF6,18,Calabria
2021-05-23,SAR,9978,4815,5163,7733,2245,ITG,ITG2,20,Sardegna
2021-05-24,PAB,1444,762,682,1111,333,ITH,ITH1,4,Provincia Autonoma Bolzano / Bozen
2021-05-05,ABR,11643,5576,6067,6437,5206,ITF,ITF1,13,Abruzzo
2021-02-12,SAR,2237,933,1304,2178,59,ITG,ITG2,20,Sardegna
2021-03-27,SIC,15605,7356,8249,10753,4852,ITG,ITG1,19,Sicilia
2021-04-27,PIE,22608,10214,12394,17461,5147,ITC,ITC1,1,Piemonte
2021-03-09,ABR,5177,1805,3372,4239,938,ITF,ITF1,13,Abruzzo
2021-01-03,LIG,734,230,504,734,0,ITC,ITC3,7,Liguria
2021-01-17,PIE,3519,1168,2351,2871,648,ITC,ITC1,1,Piemonte
2021-01-29,SIC,9173,4254,4919,425,8748,ITG,ITG1,19,Sicilia
2021-04-10,SAR,10493,4750,5743,8556,1937,ITG,ITG2,20,Sardegna
2021-02-20,PAB,1802,540,1262,1784,18,ITH,ITH1,4,Provincia Autonoma Bolzano / Bozen
2021-06-04,VEN,49453,25740,23713,41359,8094,ITH,ITH3,5,Veneto
2021-02-12,SIC,4587,1811,2776,4320,267,ITG,ITG1,19,Sicilia
2021-03-15,PIE,10682,4184,6498,5062,5620,ITC,ITC1,1,Piemonte
2021-02-24,VEN,8616,3679,4937,8128,488,ITH,ITH3,5,Veneto
2021-04-10,CAM,28354,13493,14861,23440,4914,ITF,ITF3,15,Campania
2021-04-18,PAB,3110,1607,1503,2100,1010,ITH,ITH1,4,Provincia Autonoma Bolzano / Bozen
2021-07-01,ABR,12536,6151,6385,5747,6789,ITF,ITF1,13,Abruzzo
2021-05-11,PIE,32078,15458,16620,18866,13212,ITC,ITC1,1,Piemonte
2021-05-23,SIC,34089,16594,17495,20073,14016,ITG,ITG1,19,Sicilia
2021-01-31,PIE,4113,1753,2360,112,4001,ITC,ITC1,1,Piemonte
2021-05-23,LOM,60761,28926,31835,26807,33954,ITC,ITC4,3,Lombardia
2021-02-12,LOM,13963,4366,9597,9029,4934,ITC,ITC4,3,Lombardia
2021-02-19,LAZ,10043,5078,4965,9212,831,ITI,ITI4,12,Lazio
2021-06-17,ABR,10744,5380,5364,7301,3443,ITF,ITF1,13,Abruzzo
2021-04-10,LOM,52735,21836,30899,40780,11955,ITC,ITC4,3,Lombardia
2021-06-02,MAR,11898,5937,5961,11221,677,ITI,ITI3,11,Marche
2021-01-28,BAS,906,402,504,119,787,ITF,ITF5,17,Basilicata
2021-01-15,TOS,3878,1347,2531,3878,0,ITI,ITI1,9,Toscana
2021-01-26,UMB,815,389,426,17,798,ITI,ITI2,10,Umbria
2021-04-18,MOL,1083,483,600,149,934,ITF,ITF2,14,Molise
2021-06-20,FVG,6462,3199,3263,1534,4928,ITH,ITH4,6,Friuli-Venezia Giulia
2021-06-27,CAL,8232,3847,4385,4834,3398,ITF,ITF6,18,Calabria
2021-06-28,PUG,46652,22509,24143,21434,25218,ITF,ITF4,16,Puglia
2021-03-21,VDA,355,165,190,355,0,ITC,ITC2,2,Valle d'Aosta / Vallée d'Aoste
2021-04-29,EMR,44952,21134,23818,27403,17549,ITH,ITH5,8,Emilia-Romagna
2021-01-19,EMR,2046,505,1541,2029,17,ITH,ITH5,8,Emilia-Romagna
2021-02-22,MAR,3442,1518,1924,3367,75,ITI,ITI3,11,Marche
2021-02-12,UMB,670,224,446,664,6,ITI,ITI2,10,Umbria
2021-02-22,PAT,745,259,486,661,84,ITH,ITH2,4,Provincia Autonoma Trento
2021-04-04,MOL,253,141,112,238,15,ITF,ITF2,14,Molise
2021-02-26,UMB,660,253,407,652,8,ITI,ITI2,10,Umbria
2021-03-29,FVG,7019,3124,3895,5438,1581,ITH,ITH4,6,Friuli-Venezia Giulia
2021-06-06,SIC,49504,23909,25595,41682,7822,ITG,ITG1,19,Sicilia
2021-06-29,VDA,779,389,390,238,541,ITC,ITC2,2,Valle d'Aosta / Vallée d'Aoste
2021-01-29,SAR,2955,1069,1886,48,2907,ITG,ITG2,20,Sardegna
2021-03-18,MOL,1156,476,680,692,464,ITF,ITF2,14,Molise
2021-01-03,PIE,3063,967,2096,3063,0,ITC,ITC1,1,Piemonte
2021-03-28,PAB,569,212,357,11,558,ITH,ITH1,4,Provincia Autonoma Bolzano / Bozen
2021-06-26,MOL,3116,1527,1589,536,2580,ITF,ITF2,14,Molise
2021-05-23,LIG,2305,1119,1186,1182,1123,ITC,ITC3,7,Liguria
2021-01-14,BAS,969,413,556,969,0,ITF,ITF5,17,Basilicata
2021-02-26,SIC,11882,5810,6072,10202,1680,ITG,ITG1,19,Sicilia
2021-06-18,TOS,30733,16205,14528,25370,5363,ITI,ITI1,9,Toscana
2021-04-22,VEN,31993,13915,18078,16247,15746,ITH,ITH3,5,Veneto
2021-01-28,ABR,1434,495,939,12,1422,ITF,ITF1,13,Abruzzo
2021-03-01,LIG,3527,1444,2083,3404,123,ITC,ITC3,7,Liguria
2021-04-03,CAL,9359,4050,5309,4553,4806,ITF,ITF6,18,Calabria
2021-05-06,SIC,29333,13949,15384,18528,10805,ITG,ITG1,19,Sicilia
2021-05-23,CAM,58744,28638,30106,37849,20895,ITF,ITF3,15,Campania
2021-05-01,LAZ,37952,17083,20869,25989,11963,ITI,ITI4,12,Lazio
2021-05-09,LOM,69707,32884,36823,56440,13267,ITC,ITC4,3,Lombardia
2021-06-09,LIG,18668,9377,9291,12112,6556,ITC,ITC3,7,Liguria
2021-02-12,CAM,6531,2861,3670,6343,188,ITF,ITF3,15,Campania
2021-04-07,BAS,1211,552,659,1174,37,ITF,ITF5,17,Basilicata
2021-01-29,LOM,13481,4126,9355,686,12795,ITC,ITC4,3,Lombardia
2021-04-17,LAZ,32362,14203,18159,20387,11975,ITI,ITI4,12,Lazio
2021-05-18,PAT,4251,2010,2241,3407,844,ITH,ITH2,4,Provincia Autonoma Trento
2021-03-29,EMR,21424,9613,11811,16774,4650,ITH,ITH5,8,Emilia-Romagna
2021-03-29,PIE,15186,6405,8781,8574,6612,ITC,ITC1,1,Piemonte
2021-01-11,ABR,1553,557,996,1553,0,ITF,ITF1,13,Abruzzo
2021-05-06,UMB,9450,4313,5137,6136,3314,ITI,ITI2,10,Umbria
2021-06-10,VDA,1002,558,444,960,42,ITC,ITC2,2,Valle d'Aosta / Vallée d'Aoste
2021-03-25,TOS,23893,10376,13517,15542,8351,ITI,ITI1,9,Toscana
2021-01-29,CAM,10052,4812,5240,47,10005,ITF,ITF3,15,Campania
2021-03-02,VDA,339,166,173,336,3,ITC,ITC2,2,Valle d'Aosta / Vallée d'Aoste
2021-04-21,ABR,6388,3100,3288,4714,1674,ITF,ITF1,13,Abruzzo
2021-01-28,CAL,2255,1121,1134,83,2172,ITF,ITF6,18,Calabria
2021-04-25,BAS,2986,1457,1529,2934,52,ITF,ITF5,17,Basilicata
2021-05-09,PUG,30647,12561,18086,15034,15613,ITF,ITF4,16,Puglia
2021-06-13,LOM,75239,40181,35058,73114,2125,ITC,ITC4,3,Lombardia
2021-01-28,SAR,2972,1046,1926,69,2903,ITG,ITG2,20,Sardegna
2021-04-12,PIE,22952,10368,12584,19962,2990,ITC,ITC1,1,Piemonte
2021-04-12,TOS,2612,1183,1429,1958,654,ITI,ITI1,9,Toscana
2021-06-27,CAM,42292,20817,21475,13230,29062,ITF,ITF3,15,Campania
2021-02-21,EMR,4450,1708,2742,4010,440,ITH,ITH5,8,Emilia-Romagna
2021-03-05,LOM,28942,11936,17006,20527,8415,ITC,ITC4,3,Lombardia
2021-03-27,MAR,7383,3076,4307,5023,2360,ITI,ITI3,11,Marche
2021-05-08,CAL,18437,8389,10048,10609,7828,ITF,ITF6,18,Calabria
2021-01-02,PIE,3545,1134,2411,3545,0,ITC,ITC1,1,Piemonte
2021-03-19,CAM,11142,4973,6169,7270,3872,ITF,ITF3,15,Campania
2021-02-10,MOL,151,79,72,131,20,ITF,ITF2,14,Molise
2021-03-12,PAT,2516,939,1577,1710,806,ITH,ITH2,4,Provincia Autonoma Trento
2021-04-10,MAR,10916,4620,6296,10603,313,ITI,ITI3,11,Marche
2021-05-22,CAL,22178,10555,11623,14326,7852,ITF,ITF6,18,Calabria
2021-01-03,MAR,907,354,553,907,0,ITI,ITI3,11,Marche
2021-04-22,PUG,23011,10533,12478,18093,4918,ITF,ITF4,16,Puglia
2021-05-12,BAS,4724,2327,2397,2842,1882,ITF,ITF5,17,Basilicata
2021-05-21,MOL,2096,1050,1046,1774,322,ITF,ITF2,14,Molise
2021-06-20,PAT,1869,1034,835,32,1837,ITH,ITH2,4,Provincia Autonoma Trento
2021-06-27,LOM,86564,44595,41969,67747,18817,ITC,ITC4,3,Lombardia
2021-03-19,LOM,32426,12916,19510,19229,13197,ITC,ITC4,3,Lombardia
2021-05-13,TOS,35012,15437,19575,13835,21177,ITI,ITI1,9,Toscana
2021-01-27,MOL,674,251,423,8,666,ITF,ITF2,14,Molise
2021-03-31,SIC,14449,6692,7757,9517,4932,ITG,ITG1,19,Sicilia
2021-05-15,FVG,12655,6104,6551,7958,4697,ITH,ITH4,6,Friuli-Venezia Giulia
2021-06-28,ABR,9754,4671,5083,5225,4529,ITF,ITF1,13,Abruzzo
2021-04-03,LIG,5405,2498,2907,4463,942,ITC,ITC3,7,Liguria
2021-04-21,CAL,11544,5797,5747,8649,2895,ITF,ITF6,18,Calabria
2021-05-01,FVG,7194,3245,3949,6151,1043,ITH,ITH4,6,Friuli-Venezia Giulia
2021-06-10,UMB,7452,3715,3737,6679,773,ITI,ITI2,10,Umbria
2021-01-07,SIC,8923,4127,4796,8923,0,ITG,ITG1,19,Sicilia
2021-04-06,ABR,7678,3579,4099,5360,2318,ITF,ITF1,13,Abruzzo
2021-04-29,TOS,39275,17694,21581,19220,20055,ITI,ITI1,9,Toscana
2021-06-10,CAM,73362,35393,37969,66330,7032,ITF,ITF3,15,Campania
2021-01-21,FVG,896,345,551,1,895,ITH,ITH4,6,Friuli-Venezia Giulia
2021-03-12,LAZ,23892,10991,12901,17575,6317,ITI,ITI4,12,Lazio
2021-06-04,PAB,6467,3238,3229,4937,1530,ITH,ITH1,4,Provincia Autonoma Bolzano / Bozen
2021-02-24,PAB,1367,406,961,1355,12,ITH,ITH1,4,Provincia Autonoma Bolzano / Bozen
2021-06-08,VEN,43451,22474,20977,37345,6106,ITH,ITH3,5,Veneto
2021-01-02,PAT,502,143,359,502,0,ITH,ITH2,4,Provincia Autonoma Trento
2021-05-25,VEN,27744,13396,14348,11729,16015,ITH,ITH3,5,Veneto
2021-05-27,SAR,17828,9263,8565,12294,5534,ITG,ITG2,20,Sardegna
2021-06-14,FVG,10022,4840,5182,5228,4794,ITH,ITH4,6,Friuli-Venezia Giulia
2021-05-11,UMB,6224,2829,3395,4030,2194,ITI,ITI2,10,Umbria
2021-05-14,CAM,61028,27577,33451,36328,24700,ITF,ITF3,15,Campania
2021-03-30,TOS,17019,7643,9376,13456,3563,ITI,ITI1,9,Toscana
2021-05-21,CAL,21338,10865,10473,13975,7363,ITF,ITF6,18,Calabria
2021-02-20,FVG,2068,933,1135,1924,144,ITH,ITH4,6,Friuli-Venezia Giulia
2021-03-18,SIC,15286,7665,7621,9788,5498,ITG,ITG1,19,Sicilia
2021-06-15,ABR,11104,5475,5629,8686,2418,ITF,ITF1,13,Abruzzo
2021-01-22,FVG,90,30,60,0,90,ITH,ITH4,6,Friuli-Venezia Giulia
2021-02-01,VEN,8561,2502,6059,160,8401,ITH,ITH3,5,Veneto
2021-03-26,PAB,1657,733,924,523,1134,ITH,ITH1,4,Provincia Autonoma Bolzano / Bozen
2021-04-12,ABR,6208,2945,3263,5034,1174,ITF,ITF1,13,Abruzzo
2021-02-06,LIG,1892,768,1124,145,1747,ITC,ITC3,7,Liguria
2021-03-06,FVG,3500,1196,2304,3175,325,ITH,ITH4,6,Friuli-Venezia Giulia
2021-03-18,SAR,7257,3071,4186,5652,1605,ITG,ITG2,20,Sardegna
2021-02-15,VEN,4389,1824,2565,4149,240,ITH,ITH3,5,Veneto
2021-02-27,PAT,1030,457,573,609,421,ITH,ITH2,4,Provincia Autonoma Trento
2021-04-09,PAB,2937,1301,1636,2207,730,ITH,ITH1,4,Provincia Autonoma Bolzano / Bozen
2021-04-19,BAS,4167,1914,2253,2528,1639,ITF,ITF5,17,Basilicata
2021-05-14,SAR,14587,6876,7711,10939,3648,ITG,ITG2,20,Sardegna
2021-01-01,PAT,214,50,164,214,0,ITH,ITH2,4,Provincia Autonoma Trento
2021-06-07,PAT,5789,2880,2909,2806,2983,ITH,ITH2,4,Provincia Autonoma Trento
2021-02-03,SAR,1119,419,700,426,693,ITG,ITG2,20,Sardegna
2021-03-21,MAR,4504,1873,2631,1629,2875,ITI,ITI3,11,Marche
2021-04-18,PIE,22973,10822,12151,20217,2756,ITC,ITC1,1,Piemonte
2021-03-30,VEN,35958,15293,20665,30717,5241,ITH,ITH3,5,Veneto
2021-05-22,PAB,6821,3553,3268,4655,2166,ITH,ITH1,4,Provincia Autonoma Bolzano / Bozen
2021-01-08,PIE,5533,1762,3771,5533,0,ITC,ITC1,1,Piemonte
2021-02-25,PUG,11969,5062,6907,10796,1173,ITF,ITF4,16,Puglia
2021-03-25,LAZ,28987,13348,15639,22380,6607,ITI,ITI4,12,Lazio
2021-04-01,SAR,10165,4072,6093,7150,3015,ITG,ITG2,20,Sardegna
2021-06-14,PIE,37905,19530,18375,30817,7088,ITC,ITC1,1,Piemonte
2021-02-11,PAB,1094,432,662,239,855,ITH,ITH1,4,Provincia Autonoma Bolzano / Bozen
2021-03-22,VDA,560,205,355,333,227,ITC,ITC2,2,Valle d'Aosta / Vallée d'Aoste
2021-04-25,PAT,1971,940,1031,1964,7,ITH,ITH2,4,Provincia Autonoma Trento
2021-01-27,LAZ,6116,2389,3727,999,5117,ITI,ITI4,12,Lazio
2021-02-06,MAR,2463,902,1561,522,1941,ITI,ITI3,11,Marche
2021-03-06,PIE,13994,5211,8783,11205,2789,ITC,ITC1,1,Piemonte
2021-06-05,PUG,42120,20637,21483,29529,12591,ITF,ITF4,16,Puglia
2021-06-15,BAS,3208,1406,1802,2233,975,ITF,ITF5,17,Basilicata
2021-06-26,LOM,101561,53214,48347,76178,25383,ITC,ITC4,3,Lombardia
2021-06-11,LIG,17348,8843,8505,11307,6041,ITC,ITC3,7,Liguria
2021-04-15,LIG,11832,5230,6602,9981,1851,ITC,ITC3,7,Liguria
2021-01-22,PIE,3867,1249,2618,2526,1341,ITC,ITC1,1,Piemonte
2021-01-05,CAL,1515,708,807,1515,0,ITF,ITF6,18,Calabria
2021-02-07,SIC,2372,1011,1361,674,1698,ITG,ITG1,19,Sicilia
2021-04-10,VEN,27464,11978,15486,18984,8480,ITH,ITH3,5,Veneto
2021-02-10,LOM,14395,4504,9891,7578,6817,ITC,ITC4,3,Lombardia
2021-02-24,CAM,11784,4149,7635,11096,688,ITF,ITF3,15,Campania
2021-05-18,SIC,36090,17360,18730,23576,12514,ITG,ITG1,19,Sicilia
2021-06-06,VEN,37310,19106,18204,32584,4726,ITH,ITH3,5,Veneto
2020-12-27,TOS,620,267,353,620,0,ITI,ITI1,9,Toscana
2021-06-01,LAZ,48774,23537,25237,30291,18483,ITI,ITI4,12,Lazio
2021-04-05,LAZ,19844,9063,10781,13663,6181,ITI,ITI4,12,Lazio
2021-01-16,ABR,934,430,504,934,0,ITF,ITF1,13,Abruzzo
2021-02-12,EMR,5313,1673,3640,3910,1403,ITH,ITH5,8,Emilia-Romagna
2021-06-05,VDA,925,476,449,737,188,ITC,ITC2,2,Valle d'Aosta / Vallée d'Aoste
2021-04-10,EMR,20921,9300,11621,16776,4145,ITH,ITH5,8,Emilia-Romagna
2021-02-11,VDA,231,107,124,222,9,ITC,ITC2,2,Valle d'Aosta / Vallée d'Aoste
2021-03-29,UMB,3630,1601,2029,2211,1419,ITI,ITI2,10,Umbria
2021-04-17,EMR,27299,13073,14226,17954,9345,ITH,ITH5,8,Emilia-Romagna
2021-01-31,UMB,1058,276,782,25,1033,ITI,ITI2,10,Umbria
2021-04-09,VDA,237,111,126,204,33,ITC,ITC2,2,Valle d'Aosta / Vallée d'Aoste
2021-01-07,EMR,10274,3406,6868,10274,0,ITH,ITH5,8,Emilia-Romagna
2021-05-21,MAR,13715,6507,7208,7438,6277,ITI,ITI3,11,Marche
2021-01-03,TOS,3336,1052,2284,3336,0,ITI,ITI1,9,Toscana
2021-05-25,LAZ,47393,22217,25176,35732,11661,ITI,ITI4,12,Lazio
2021-05-22,VDA,940,494,446,540,400,ITC,ITC2,2,Valle d'Aosta / Vallée d'Aoste
2021-05-25,UMB,8811,4299,4512,7749,1062,ITI,ITI2,10,Umbria
2021-05-26,MOL,1548,697,851,794,754,ITF,ITF2,14,Molise
2021-06-25,PAT,7456,3994,3462,4103,3353,ITH,ITH2,4,Provincia Autonoma Trento
2021-01-05,CAM,7237,3637,3600,7237,0,ITF,ITF3,15,Campania
2021-02-28,BAS,804,343,461,775,29,ITF,ITF5,17,Basilicata
2021-03-30,MOL,2003,857,1146,1491,512,ITF,ITF2,14,Molise
2020-12-27,VEN,880,395,485,880,0,ITH,ITH3,5,Veneto
2021-01-12,CAL,2074,1025,1049,2074,0,ITF,ITF6,18,Calabria
2021-02-18,PAB,1839,457,1382,1832,7,ITH,ITH1,4,Provincia Autonoma Bolzano / Bozen
2021-01-02,BAS,950,381,569,950,0,ITF,ITF5,17,Basilicata
2021-01-06,PUG,3952,1674,2278,3952,0,ITF,ITF4,16,Puglia
2021-02-01,MOL,562,201,361,14,548,ITF,ITF2,14,Molise
2021-01-16,BAS,722,304,418,722,0,ITF,ITF5,17,Basilicata
2021-05-12,MOL,2852,1294,1558,2756,96,ITF,ITF2,14,Molise
2021-04-08,LIG,13746,6161,7585,11701,2045,ITC,ITC3,7,Liguria
2021-05-06,FVG,11888,5522,6366,7921,3967,ITH,ITH4,6,Friuli-Venezia Giulia
2021-02-10,SAR,1959,765,1194,1441,518,ITG,ITG2,20,Sardegna
2021-04-26,BAS,4465,2164,2301,4244,221,ITF,ITF5,17,Basilicata
2021-06-04,LIG,14736,7236,7500,9249,5487,ITC,ITC3,7,Liguria
2021-02-17,CAM,7389,3211,4178,6329,1060,ITF,ITF3,15,Campania
2021-05-25,SIC,33393,15307,18086,14118,19275,ITG,ITG1,19,Sicilia
2021-05-30,VEN,22542,11267,11275,15849,6693,ITH,ITH3,5,Veneto
2021-02-03,LOM,25641,7916,17725,1081,24560,ITC,ITC4,3,Lombardia
2021-02-24,CAL,1914,975,939,1436,478,ITF,ITF6,18,Calabria
2021-03-29,SIC,14989,7059,7930,10492,4497,ITG,ITG1,19,Sicilia
2021-04-15,CAM,34344,16664,17680,24442,9902,ITF,ITF3,15,Campania
2021-04-01,LOM,42958,17231,25727,26760,16198,ITC,ITC4,3,Lombardia
2021-02-15,TOS,8771,3376,5395,7945,826,ITI,ITI1,9,Toscana
2021-04-12,LAZ,23844,10747,13097,16945,6899,ITI,ITI4,12,Lazio
2021-05-16,PAT,1331,736,595,1092,239,ITH,ITH2,4,Provincia Autonoma Trento
2021-03-04,PUG,15343,6091,9252,13923,1420,ITF,ITF4,16,Puglia
2021-03-30,PAB,1299,532,767,219,1080,ITH,ITH1,4,Provincia Autonoma Bolzano / Bozen
2021-06-08,UMB,7291,3590,3701,6751,540,ITI,ITI2,10,Umbria
2021-06-11,CAM,67808,32883,34925,61786,6022,ITF,ITF3,15,Campania
2021-05-21,LIG,12840,5952,6888,9715,3125,ITC,ITC3,7,Liguria
2021-06-09,PUG,41535,20566,20969,30368,11167,ITF,ITF4,16,Puglia
2021-01-28,VDA,291,123,168,56,235,ITC,ITC2,2,Valle d'Aosta / Vallée d'Aoste
2021-03-03,CAM,13924,5496,8428,7294,6630,ITF,ITF3,15,Campania
2021-04-03,VEN,21951,9626,12325,14244,7707,ITH,ITH3,5,Veneto
2021-03-11,MAR,6591,2784,3807,5221,1370,ITI,ITI3,11,Marche
2021-04-16,PAB,2951,1419,1532,2440,511,ITH,ITH1,4,Provincia Autonoma Bolzano / Bozen
2021-04-22,CAL,9743,4862,4881,6859,2884,ITF,ITF6,18,Calabria
2021-06-30,SAR,17417,8344,9073,4558,12859,ITG,ITG2,20,Sardegna
2021-01-05,PAT,709,232,477,709,0,ITH,ITH2,4,Provincia Autonoma Trento
2021-02-27,LIG,1888,921,967,1759,129,ITC,ITC3,7,Liguria
2021-03-20,VEN,13019,5388,7631,10939,2080,ITH,ITH3,5,Veneto
2021-03-27,FVG,5369,2911,2458,3958,1411,ITH,ITH4,6,Friuli-Venezia Giulia
2021-02-15,PUG,3257,1269,1988,2635,622,ITF,ITF4,16,Puglia
2021-03-15,LAZ,20842,9737,11105,14099,6743,ITI,ITI4,12,Lazio
2021-03-22,SAR,3696,1497,2199,3183,513,ITG,ITG2,20,Sardegna
2021-03-25,MAR,6654,2772,3882,3246,3408,ITI,ITI3,11,Marche
2021-05-06,CAL,13262,6277,6985,8993,4269,ITF,ITF6,18,Calabria
2021-03-16,MOL,614,230,384,267,347,ITF,ITF2,14,Molise
2021-04-15,PAT,3202,1443,1759,3048,154,ITH,ITH2,4,Provincia Autonoma Trento
2021-06-25,CAM,64465,31237,33228,13271,51194,ITF,ITF3,15,Campania
2021-01-17,TOS,2535,870,1665,2021,514,ITI,ITI1,9,Toscana
2021-02-10,LIG,2314,836,1478,1019,1295,ITC,ITC3,7,Liguria
2021-05-26,PUG,38427,18442,19985,26781,11646,ITF,ITF4,16,Puglia
2021-04-08,SAR,13451,5940,7511,8331,5120,ITG,ITG2,20,Sardegna
2021-06-19,PAB,5613,2984,2629,580,5033,ITH,ITH1,4,Provincia Autonoma Bolzano / Bozen
2021-06-29,ABR,11164,5504,5660,5182,5982,ITF,ITF1,13,Abruzzo
2020-12-29,SAR,57,32,25,57,0,ITG,ITG2,20,Sardegna
2021-03-11,PAB,1685,825,860,1147,538,ITH,ITH1,4,Provincia Autonoma Bolzano / Bozen
2021-01-11,MOL,557,194,363,557,0,ITF,ITF2,14,Molise
2021-06-18,PIE,40386,20163,20223,26257,14129,ITC,ITC1,1,Piemonte
2021-02-25,PAB,1498,549,949,1497,1,ITH,ITH1,4,Provincia Autonoma Bolzano / Bozen
2021-05-11,LOM,86836,41415,45421,60652,26184,ITC,ITC4,3,Lombardia
2021-03-10,PIE,13682,5214,8468,11388,2294,ITC,ITC1,1,Piemonte
2021-05-25,CAM,46475,22357,24118,23071,23404,ITF,ITF3,15,Campania
2021-06-02,PAB,1444,809,635,987,457,ITH,ITH1,4,Provincia Autonoma Bolzano / Bozen
2021-03-27,PIE,18397,7828,10569,9570,8827,ITC,ITC1,1,Piemonte
2021-04-05,CAL,3644,1729,1915,2684,960,ITF,ITF6,18,Calabria
2021-04-22,SAR,10508,4661,5847,5588,4920,ITG,ITG2,20,Sardegna
2021-01-10,VEN,5034,1672,3362,5034,0,ITH,ITH3,5,Veneto
2021-03-21,ABR,2134,914,1220,844,1290,ITF,ITF1,13,Abruzzo
2021-01-05,LAZ,7375,2803,4572,7375,0,ITI,ITI4,12,Lazio
2021-01-12,SAR,865,408,457,865,0,ITG,ITG2,20,Sardegna
2021-02-05,EMR,9290,2956,6334,1607,7683,ITH,ITH5,8,Emilia-Romagna
2021-05-28,LOM,93497,44813,48684,42936,50561,ITC,ITC4,3,Lombardia
2021-06-12,VDA,1232,599,633,1066,166,ITC,ITC2,2,Valle d'Aosta / Vallée d'Aoste
2021-04-15,FVG,6506,2873,3633,5236,1270,ITH,ITH4,6,Friuli-Venezia Giulia
2021-02-17,LOM,11990,3756,8234,10600,1390,ITC,ITC4,3,Lombardia
2021-03-15,SIC,10614,4686,5928,5722,4892,ITG,ITG1,19,Sicilia
2021-06-12,ABR,11210,5797,5413,9860,1350,ITF,ITF1,13,Abruzzo
2021-06-11,LOM,100549,51200,49349,85972,14577,ITC,ITC4,3,Lombardia
2021-03-08,TOS,6707,2945,3762,1887,4820,ITI,ITI1,9,Toscana
2021-04-29,FVG,6728,2957,3771,4165,2563,ITH,ITH4,6,Friuli-Venezia Giulia
2021-02-20,MAR,4152,1728,2424,4041,111,ITI,ITI3,11,Marche
2021-06-29,BAS,3825,1856,1969,2787,1038,ITF,ITF5,17,Basilicata
2021-01-24,LAZ,5695,2229,3466,612,5083,ITI,ITI4,12,Lazio
2021-06-16,TOS,31685,16210,15475,26554,5131,ITI,ITI1,9,Toscana
2021-06-27,UMB,7448,3727,3721,1763,5685,ITI,ITI2,10,Umbria
2021-01-27,PUG,4602,1941,2661,631,3971,ITF,ITF4,16,Puglia
2021-06-18,PAT,6920,3684,3236,1813,5107,ITH,ITH2,4,Provincia Autonoma Trento
2021-01-05,FVG,1678,551,1127,1678,0,ITH,ITH4,6,Friuli-Venezia Giulia
2021-02-07,LAZ,4944,2026,2918,387,4557,ITI,ITI4,12,Lazio
2021-03-27,PAT,1620,710,910,1363,257,ITH,ITH2,4,Provincia Autonoma Trento
2021-05-07,PUG,50002,22320,27682,26550,23452,ITF,ITF4,16,Puglia
2021-05-30,TOS,28668,13941,14727,21724,6944,ITI,ITI1,9,Toscana
2021-03-18,LIG,4986,2124,2862,2007,2979,ITC,ITC3,7,Liguria
2021-05-18,LAZ,44918,20541,24377,35375,9543,ITI,ITI4,12,Lazio
2021-06-20,EMR,29945,15192,14753,15332,14613,ITH,ITH5,8,Emilia-Romagna
2021-03-21,BAS,1056,488,568,361,695,ITF,ITF5,17,Basilicata
2021-04-01,LIG,12422,5510,6912,9652,2770,ITC,ITC3,7,Liguria
2021-01-13,PUG,4542,1729,2813,4542,0,ITF,ITF4,16,Puglia
2021-02-08,PAB,2,1,1,1,1,ITH,ITH1,4,Provincia Autonoma Bolzano / Bozen
2021-04-22,CAM,33962,16540,17422,21557,12405,ITF,ITF3,15,Campania
2021-05-23,VEN,34483,16464,18019,11083,23400,ITH,ITH3,5,Veneto
2021-06-04,PAT,5824,2605,3219,1832,3992,ITH,ITH2,4,Provincia Autonoma Trento
2021-06-08,CAL,15879,7492,8387,13858,2021,ITF,ITF6,18,Calabria
2021-01-20,MAR,403,100,303,384,19,ITI,ITI3,11,Marche
2021-05-29,BAS,3059,1534,1525,834,2225,ITF,ITF5,17,Basilicata
2021-01-12,CAM,5215,2564,2651,5215,0,ITF,ITF3,15,Campania
2021-02-12,VEN,4314,1447,2867,3742,572,ITH,ITH3,5,Veneto
2021-03-19,VDA,322,85,237,287,35,ITC,ITC2,2,Valle d'Aosta / Vallée d'Aoste
2021-02-03,MAR,2124,741,1383,119,2005,ITI,ITI3,11,Marche
2021-03-17,CAL,4100,1826,2274,2186,1914,ITF,ITF6,18,Calabria
2021-04-06,PUG,13831,6246,7585,7079,6752,ITF,ITF4,16,Puglia
2021-05-11,SAR,8888,4121,4767,6524,2364,ITG,ITG2,20,Sardegna
2021-01-25,MOL,319,130,189,3,316,ITF,ITF2,14,Molise
2021-01-29,VEN,9023,2788,6235,366,8657,ITH,ITH3,5,Veneto
2021-01-31,SAR,2121,750,1371,48,2073,ITG,ITG2,20,Sardegna
2021-05-14,MAR,13494,6218,7276,6720,6774,ITI,ITI3,11,Marche
2021-06-25,CAL,18508,8584,9924,7883,10625,ITF,ITF6,18,Calabria
2021-02-05,FVG,2610,784,1826,89,2521,ITH,ITH4,6,Friuli-Venezia Giulia
2021-02-24,PAT,1325,525,800,926,399,ITH,ITH2,4,Provincia Autonoma Trento
2021-03-10,CAL,6732,3420,3312,5399,1333,ITF,ITF6,18,Calabria
2021-04-29,UMB,5208,2245,2963,2888,2320,ITI,ITI2,10,Umbria
2021-05-18,SAR,14751,7377,7374,9551,5200,ITG,ITG2,20,Sardegna
2021-01-13,PAB,1691,557,1134,1691,0,ITH,ITH1,4,Provincia Autonoma Bolzano / Bozen
2021-03-24,UMB,4103,1792,2311,2780,1323,ITI,ITI2,10,Umbria
2021-01-23,ABR,264,115,149,57,207,ITF,ITF1,13,Abruzzo
2021-04-22,PIE,27695,12753,14942,20986,6709,ITC,ITC1,1,Piemonte
2021-01-12,PIE,10090,3415,6675,10090,0,ITC,ITC1,1,Piemonte
2021-01-30,PAB,498,245,253,4,494,ITH,ITH1,4,Provincia Autonoma Bolzano / Bozen
2021-03-29,CAM,19401,9575,9826,17855,1546,ITF,ITF3,15,Campania
2021-05-03,ABR,11111,5240,5871,7281,3830,ITF,ITF1,13,Abruzzo
2021-06-03,VDA,1306,667,639,896,410,ITC,ITC2,2,Valle d'Aosta / Vallée d'Aoste
2021-01-29,PIE,5945,1887,4058,455,5490,ITC,ITC1,1,Piemonte
2021-02-24,SAR,2414,1295,1119,2224,190,ITG,ITG2,20,Sardegna
2021-04-20,MAR,10700,4998,5702,9280,1420,ITI,ITI3,11,Marche
2021-06-01,CAL,12849,5959,6890,7932,4917,ITF,ITF6,18,Calabria
2021-04-10,UMB,7389,3477,3912,7305,84,ITI,ITI2,10,Umbria
2021-05-02,PUG,21313,9658,11655,14047,7266,ITF,ITF4,16,Puglia
2021-04-23,PAB,4543,2151,2392,3252,1291,ITH,ITH1,4,Provincia Autonoma Bolzano / Bozen
2021-05-17,VDA,809,417,392,375,434,ITC,ITC2,2,Valle d'Aosta / Vallée d'Aoste
2021-01-17,UMB,54,17,37,54,0,ITI,ITI2,10,Umbria
2021-03-27,LIG,3932,1549,2383,2537,1395,ITC,ITC3,7,Liguria
2021-05-23,TOS,28374,13643,14731,25813,2561,ITI,ITI1,9,Toscana
2021-01-25,MAR,1597,559,1038,95,1502,ITI,ITI3,11,Marche
2020-12-31,UMB,322,127,195,322,0,ITI,ITI2,10,Umbria
2021-04-10,SIC,20422,9969,10453,11458,8964,ITG,ITG1,19,Sicilia
2021-01-10,PAT,84,19,65,84,0,ITH,ITH2,4,Provincia Autonoma Trento
2021-04-13,LIG,13077,5867,7210,11053,2024,ITC,ITC3,7,Liguria
2021-04-15,LOM,49444,21857,27587,35621,13823,ITC,ITC4,3,Lombardia
2021-01-17,SIC,1305,592,713,1245,60,ITG,ITG1,19,Sicilia
2021-04-16,ABR,7537,3488,4049,5619,1918,ITF,ITF1,13,Abruzzo
2021-06-20,CAM,46788,22345,24443,13812,32976,ITF,ITF3,15,Campania
2021-01-05,LOM,7853,2576,5277,7853,0,ITC,ITC4,3,Lombardia
2021-03-22,LAZ,23152,10382,12770,16478,6674,ITI,ITI4,12,Lazio
2021-03-27,CAM,21511,10242,11269,17646,3865,ITF,ITF3,15,Campania
2021-01-23,BAS,721,305,416,33,688,ITF,ITF5,17,Basilicata
2021-05-13,CAL,15927,7659,8268,11220,4707,ITF,ITF6,18,Calabria
2021-05-03,BAS,4513,2043,2470,3685,828,ITF,ITF5,17,Basilicata
2021-04-24,EMR,28631,13241,15390,14403,14228,ITH,ITH5,8,Emilia-Romagna
2020-12-29,LAZ,488,176,312,488,0,ITI,ITI4,12,Lazio
2021-01-08,MAR,1581,592,989,1581,0,ITI,ITI3,11,Marche
2021-01-11,PAB,1574,513,1061,1574,0,ITH,ITH1,4,Provincia Autonoma Bolzano / Bozen
2021-02-19,CAL,1509,682,827,1248,261,ITF,ITF6,18,Calabria
2021-05-15,VDA,1065,614,451,380,685,ITC,ITC2,2,Valle d'Aosta / Vallée d'Aoste
2021-06-06,SAR,10030,4998,5032,6379,3651,ITG,ITG2,20,Sardegna
2021-01-29,PAT,1355,333,1022,55,1300,ITH,ITH2,4,Provincia Autonoma Trento
2021-02-09,BAS,491,213,278,316,175,ITF,ITF5,17,Basilicata
2021-02-04,VDA,294,86,208,8,286,ITC,ITC2,2,Valle d'Aosta / Vallée d'Aoste
2021-03-27,LOM,32436,12376,20060,23729,8707,ITC,ITC4,3,Lombardia
2021-04-18,MAR,8824,4131,4693,7903,921,ITI,ITI3,11,Marche
2021-05-11,EMR,35778,16792,18986,28524,7254,ITH,ITH5,8,Emilia-Romagna
2021-05-30,CAL,10948,5257,5691,6794,4154,ITF,ITF6,18,Calabria
2021-04-28,VDA,1218,632,586,715,503,ITC,ITC2,2,Valle d'Aosta / Vallée d'Aoste
2021-06-01,CAM,41949,20829,21120,31488,10461,ITF,ITF3,15,Campania
2021-01-31,EMR,7698,2763,4935,241,7457,ITH,ITH5,8,Emilia-Romagna
2021-02-10,TOS,4263,1281,2982,3740,523,ITI,ITI1,9,Toscana
2021-04-03,FVG,4012,1990,2022,2681,1331,ITH,ITH4,6,Friuli-Venezia Giulia
2021-01-03,LOM,854,316,538,854,0,ITC,ITC4,3,Lombardia
2021-04-06,PAB,2250,1118,1132,2147,103,ITH,ITH1,4,Provincia Autonoma Bolzano / Bozen
2021-06-18,CAM,63732,30303,33429,33463,30269,ITF,ITF3,15,Campania
2021-03-10,CAM,15611,7720,7891,8776,6835,ITF,ITF3,15,Campania
2021-04-22,PAT,3152,1470,1682,3107,45,ITH,ITH2,4,Provincia Autonoma Trento
2021-06-15,UMB,5966,3010,2956,3906,2060,ITI,ITI2,10,Umbria
2021-05-04,TOS,18293,8203,10090,12849,5444,ITI,ITI1,9,Toscana
2021-06-13,LAZ,52559,23273,29286,27735,24824,ITI,ITI4,12,Lazio
2021-03-07,LAZ,14133,5466,8667,10540,3593,ITI,ITI4,12,Lazio
2021-06-10,FVG,10655,5592,5063,9656,999,ITH,ITH4,6,Friuli-Venezia Giulia
2021-06-15,LAZ,65353,31502,33851,33448,31905,ITI,ITI4,12,Lazio
2021-06-18,PUG,46806,23041,23765,29048,17758,ITF,ITF4,16,Puglia
2021-02-28,PIE,10816,4060,6756,10576,240,ITC,ITC1,1,Piemonte
2021-05-15,CAM,62651,29039,33612,43941,18710,ITF,ITF3,15,Campania
2021-03-17,PIE,12518,5055,7463,5224,7294,ITC,ITC1,1,Piemonte
2021-06-21,BAS,4242,2038,2204,2151,2091,ITF,ITF5,17,Basilicata
2020-12-31,VEN,3220,1042,2178,3220,0,ITH,ITH3,5,Veneto
2021-03-11,ABR,5495,2221,3274,4357,1138,ITF,ITF1,13,Abruzzo
2021-03-24,LAZ,27636,12890,14746,21399,6237,ITI,ITI4,12,Lazio
2021-03-25,MOL,1806,730,1076,1309,497,ITF,ITF2,14,Molise
2021-03-19,FVG,3252,1350,1902,1316,1936,ITH,ITH4,6,Friuli-Venezia Giulia
2021-03-08,MOL,1379,522,857,1239,140,ITF,ITF2,14,Molise
2021-03-05,SIC,15666,6770,8896,11431,4235,ITG,ITG1,19,Sicilia
2021-06-02,ABR,9766,4745,5021,6955,2811,ITF,ITF1,13,Abruzzo
2021-06-29,EMR,35886,17634,18252,17339,18547,ITH,ITH5,8,Emilia-Romagna
2021-04-07,PAT,2622,1017,1605,1680,942,ITH,ITH2,4,Provincia Autonoma Trento
2021-06-16,MOL,2002,1013,989,1147,855,ITF,ITF2,14,Molise
2021-03-21,EMR,11956,5296,6660,7351,4605,ITH,ITH5,8,Emilia-Romagna
2021-05-13,LIG,13297,6081,7216,9049,4248,ITC,ITC3,7,Liguria
2021-02-16,SIC,4199,2206,1993,3734,465,ITG,ITG1,19,Sicilia
2021-05-29,LAZ,51938,23342,28596,40966,10972,ITI,ITI4,12,Lazio
2021-06-27,FVG,7262,3625,3637,3457,3805,ITH,ITH4,6,Friuli-Venezia Giulia
2021-04-12,VEN,14902,6333,8569,6686,8216,ITH,ITH3,5,Veneto
2021-02-19,LIG,3218,1306,1912,3042,176,ITC,ITC3,7,Liguria
2021-06-19,BAS,4460,2175,2285,2387,2073,ITF,ITF5,17,Basilicata
2021-01-02,VEN,5744,1767,3977,5744,0,ITH,ITH3,5,Veneto
2021-04-13,MOL,1632,718,914,1045,587,ITF,ITF2,14,Molise
2021-06-17,UMB,6941,3516,3425,4886,2055,ITI,ITI2,10,Umbria
2021-05-30,LIG,3302,1613,1689,1363,1939,ITC,ITC3,7,Liguria
2021-03-13,ABR,4124,1420,2704,3081,1043,ITF,ITF1,13,Abruzzo
2021-02-11,BAS,952,401,551,869,83,ITF,ITF5,17,Basilicata
2021-05-12,PAB,3792,2058,1734,3639,153,ITH,ITH1,4,Provincia Autonoma Bolzano / Bozen
2021-04-29,SIC,31702,14825,16877,22248,9454,ITG,ITG1,19,Sicilia
2021-06-04,PIE,37488,19595,17893,34555,2933,ITC,ITC1,1,Piemonte
2021-02-01,PAB,1452,440,1012,12,1440,ITH,ITH1,4,Provincia Autonoma Bolzano / Bozen
2021-01-17,LAZ,4893,2027,2866,4681,212,ITI,ITI4,12,Lazio
2021-02-24,PIE,11409,4629,6780,10904,505,ITC,ITC1,1,Piemonte
2021-03-03,SIC,14419,6431,7988,11356,3063,ITG,ITG1,19,Sicilia
2021-04-24,FVG,6679,2948,3731,5436,1243,ITH,ITH4,6,Friuli-Venezia Giulia
2021-05-19,PUG,26368,12751,13617,19947,6421,ITF,ITF4,16,Puglia
2021-06-14,MOL,1627,810,817,552,1075,ITF,ITF2,14,Molise
2021-01-31,CAM,8068,3711,4357,23,8045,ITF,ITF3,15,Campania
2021-01-19,LAZ,4770,1956,2814,4316,454,ITI,ITI4,12,Lazio
2021-03-23,PUG,11089,5621,5468,4617,6472,ITF,ITF4,16,Puglia
2021-05-09,LIG,2822,1244,1578,1113,1709,ITC,ITC3,7,Liguria
2021-06-06,FVG,9454,4614,4840,7908,1546,ITH,ITH4,6,Friuli-Venezia Giulia
2021-05-22,BAS,5488,2723,2765,1937,3551,ITF,ITF5,17,Basilicata
2021-02-26,FVG,3735,2093,1642,3587,148,ITH,ITH4,6,Friuli-Venezia Giulia
2021-06-25,EMR,41430,20968,20462,19257,22173,ITH,ITH5,8,Emilia-Romagna
2021-03-26,BAS,1955,703,1252,1695,260,ITF,ITF5,17,Basilicata
2021-02-17,FVG,2355,1000,1355,1875,480,ITH,ITH4,6,Friuli-Venezia Giulia
2021-02-18,ABR,2288,933,1355,2158,130,ITF,ITF1,13,Abruzzo
2021-03-17,EMR,13719,5692,8027,5873,7846,ITH,ITH5,8,Emilia-Romagna
2021-05-18,VEN,26887,12509,14378,13313,13574,ITH,ITH3,5,Veneto
2021-05-30,PAT,1770,872,898,930,840,ITH,ITH2,4,Provincia Autonoma Trento
2021-01-29,LIG,3082,1064,2018,67,3015,ITC,ITC3,7,Liguria
2021-03-27,TOS,8862,4153,4709,8647,215,ITI,ITI1,9,Toscana
2021-05-13,EMR,35780,16494,19286,27987,7793,ITH,ITH5,8,Emilia-Romagna
2021-05-29,ABR,10316,4429,5887,4543,5773,ITF,ITF1,13,Abruzzo
2021-03-06,MAR,5729,2635,3094,4462,1267,ITI,ITI3,11,Marche
2021-04-03,PAT,1141,471,670,972,169,ITH,ITH2,4,Provincia Autonoma Trento
2021-06-06,UMB,7608,3904,3704,6915,693,ITI,ITI2,10,Umbria
2021-01-09,VDA,443,199,244,443,0,ITC,ITC2,2,Valle d'Aosta / Vallée d'Aoste
2021-04-29,LAZ,38660,17246,21414,25425,13235,ITI,ITI4,12,Lazio
2021-01-20,MOL,18,8,10,18,0,ITF,ITF2,14,Molise
2021-06-30,VEN,44046,22233,21813,17685,26361,ITH,ITH3,5,Veneto
2021-01-24,CAL,45,18,27,39,6,ITF,ITF6,18,Calabria
2021-03-03,LAZ,17840,7854,9986,13546,4294,ITI,ITI4,12,Lazio
2021-06-06,PIE,35009,18299,16710,32579,2430,ITC,ITC1,1,Piemonte
2021-03-22,VEN,18139,8175,9964,13097,5042,ITH,ITH3,5,Veneto
2021-04-30,MOL,2937,1556,1381,830,2107,ITF,ITF2,14,Molise
2021-05-11,CAM,39860,19236,20624,30460,9400,ITF,ITF3,15,Campania
2021-01-20,LIG,1552,555,997,1540,12,ITC,ITC3,7,Liguria
2021-06-18,LOM,106799,52448,54351,54016,52783,ITC,ITC4,3,Lombardia
2021-03-13,VEN,17229,7303,9926,14098,3131,ITH,ITH3,5,Veneto
2021-03-25,PUG,11697,5988,5709,5455,6242,ITF,ITF4,16,Puglia
2021-02-24,UMB,1518,563,955,1503,15,ITI,ITI2,10,Umbria
2021-02-25,MOL,541,239,302,473,68,ITF,ITF2,14,Molise
2021-03-15,EMR,13444,6244,7200,6945,6499,ITH,ITH5,8,Emilia-Romagna
2021-05-22,ABR,13094,6363,6731,8199,4895,ITF,ITF1,13,Abruzzo
2021-06-14,MAR,12615,6377,6238,9307,3308,ITI,ITI3,11,Marche
2021-04-27,SAR,7617,3552,4065,5574,2043,ITG,ITG2,20,Sardegna
2021-01-15,VEN,5875,1820,4055,5875,0,ITH,ITH3,5,Veneto
2021-03-09,PAB,1194,543,651,1192,2,ITH,ITH1,4,Provincia Autonoma Bolzano / Bozen
2021-03-26,ABR,5354,2311,3043,3279,2075,ITF,ITF1,13,Abruzzo
2021-01-17,SAR,860,277,583,859,1,ITG,ITG2,20,Sardegna
2021-02-17,PIE,4794,2157,2637,3804,990,ITC,ITC1,1,Piemonte
2021-02-24,SIC,9306,4760,4546,8746,560,ITG,ITG1,19,Sicilia
2021-03-15,SAR,2799,1319,1480,2426,373,ITG,ITG2,20,Sardegna
2021-06-24,VDA,1221,629,592,388,833,ITC,ITC2,2,Valle d'Aosta / Vallée d'Aoste
2021-05-30,FVG,11059,4987,6072,7474,3585,ITH,ITH4,6,Friuli-Venezia Giulia
2021-03-01,LOM,18793,8232,10561,17088,1705,ITC,ITC4,3,Lombardia
2021-06-30,TOS,37885,18283,19602,8628,29257,ITI,ITI1,9,Toscana
2021-02-08,PUG,3992,1609,2383,1597,2395,ITF,ITF4,16,Puglia
2021-05-31,ABR,11265,5084,6181,6887,4378,ITF,ITF1,13,Abruzzo
2021-01-21,SIC,1434,706,728,501,933,ITG,ITG1,19,Sicilia
2021-04-20,ABR,5596,2693,2903,4178,1418,ITF,ITF1,13,Abruzzo
2021-04-24,PAT,3547,1701,1846,3533,14,ITH,ITH2,4,Provincia Autonoma Trento
2021-01-26,LAZ,7962,3128,4834,725,7237,ITI,ITI4,12,Lazio
2021-02-26,PAT,1218,435,783,923,295,ITH,ITH2,4,Provincia Autonoma Trento
2021-05-01,SIC,24439,11311,13128,19275,5164,ITG,ITG1,19,Sicilia
2021-02-14,TOS,9000,2569,6431,8890,110,ITI,ITI1,9,Toscana
2021-03-26,SAR,8440,3492,4948,6914,1526,ITG,ITG2,20,Sardegna
2021-06-08,PIE,37625,19481,18144,34784,2841,ITC,ITC1,1,Piemonte
2021-05-20,VEN,44741,21223,23518,20437,24304,ITH,ITH3,5,Veneto
2021-05-22,SAR,24848,11953,12895,19703,5145,ITG,ITG2,20,Sardegna
2021-05-23,PAB,4338,2303,2035,4330,8,ITH,ITH1,4,Provincia Autonoma Bolzano / Bozen
2021-05-25,TOS,34143,16472,17671,19531,14612,ITI,ITI1,9,Toscana
2021-01-14,PAT,700,203,497,700,0,ITH,ITH2,4,Provincia Autonoma Trento
2021-02-09,VEN,5248,1891,3357,3445,1803,ITH,ITH3,5,Veneto
2021-05-10,UMB,5976,2795,3181,3828,2148,ITI,ITI2,10,Umbria
2021-03-29,TOS,9670,4828,4842,9346,324,ITI,ITI1,9,Toscana
2021-04-26,PIE,19800,8748,11052,15398,4402,ITC,ITC1,1,Piemonte
2021-02-13,BAS,799,313,486,738,61,ITF,ITF5,17,Basilicata
2020-12-28,CAL,6,2,4,6,0,ITF,ITF6,18,Calabria
2021-02-03,PAB,1503,478,1025,5,1498,ITH,ITH1,4,Provincia Autonoma Bolzano / Bozen
2021-04-02,LAZ,29306,14012,15294,21969,7337,ITI,ITI4,12,Lazio
2021-06-03,CAL,14153,6623,7530,9579,4574,ITF,ITF6,18,Calabria
2021-05-15,LOM,80898,38781,42117,47522,33376,ITC,ITC4,3,Lombardia
2021-05-24,BAS,4833,2343,2490,1103,3730,ITF,ITF5,17,Basilicata
2021-01-19,SAR,747,270,477,692,55,ITG,ITG2,20,Sardegna
2021-04-07,CAL,7083,3210,3873,4078,3005,ITF,ITF6,18,Calabria
2021-01-29,MAR,1992,730,1262,167,1825,ITI,ITI3,11,Marche
2021-02-08,VDA,223,83,140,25,198,ITC,ITC2,2,Valle d'Aosta / Vallée d'Aoste
2021-02-10,PUG,3646,1436,2210,2135,1511,ITF,ITF4,16,Puglia
2021-03-17,SAR,6560,2852,3708,4952,1608,ITG,ITG2,20,Sardegna
2021-02-09,EMR,4154,1249,2905,2307,1847,ITH,ITH5,8,Emilia-Romagna
2021-02-14,VEN,126,56,70,113,13,ITH,ITH3,5,Veneto
2021-02-21,FVG,801,281,520,423,378,ITH,ITH4,6,Friuli-Venezia Giulia
2021-02-16,SAR,700,289,411,673,27,ITG,ITG2,20,Sardegna
2021-03-24,TOS,20012,8301,11711,10556,9456,ITI,ITI1,9,Toscana
2021-05-01,PIE,28540,12999,15541,16741,11799,ITC,ITC1,1,Piemonte
2021-02-12,PUG,4212,1672,2540,3120,1092,ITF,ITF4,16,Puglia
2021-03-08,MAR,6290,2755,3535,5288,1002,ITI,ITI3,11,Marche
2021-01-11,VDA,325,112,213,325,0,ITC,ITC2,2,Valle d'Aosta / Vallée d'Aoste
2021-01-21,PIE,6881,2314,4567,3385,3496,ITC,ITC1,1,Piemonte
2021-01-24,LIG,756,237,519,113,643,ITC,ITC3,7,Liguria
2021-03-05,SAR,5213,2606,2607,2857,2356,ITG,ITG2,20,Sardegna
2021-02-09,LAZ,8802,3770,5032,4581,4221,ITI,ITI4,12,Lazio
2021-03-27,PAB,3051,1554,1497,1543,1508,ITH,ITH1,4,Provincia Autonoma Bolzano / Bozen
2021-03-29,PAT,2493,966,1527,1758,735,ITH,ITH2,4,Provincia Autonoma Trento
2021-04-02,CAL,8525,3902,4623,4608,3917,ITF,ITF6,18,Calabria
2021-02-28,VEN,4136,1389,2747,3299,837,ITH,ITH3,5,Veneto
2021-02-23,LAZ,11093,4783,6310,10330,763,ITI,ITI4,12,Lazio
2021-03-13,PAB,2885,1459,1426,2784,101,ITH,ITH1,4,Provincia Autonoma Bolzano / Bozen
2021-04-12,PAT,3084,1407,1677,2588,496,ITH,ITH2,4,Provincia Autonoma Trento
2021-05-15,PIE,33779,15747,18032,20061,13718,ITC,ITC1,1,Piemonte
2021-01-29,PUG,6201,2663,3538,435,5766,ITF,ITF4,16,Puglia
2021-04-06,BAS,1273,464,809,1089,184,ITF,ITF5,17,Basilicata
2021-06-01,PIE,29257,14667,14590,24863,4394,ITC,ITC1,1,Piemonte
2021-03-17,VEN,14645,5992,8653,7849,6796,ITH,ITH3,5,Veneto
2021-05-27,LOM,94794,45422,49372,41401,53393,ITC,ITC4,3,Lombardia
2021-06-27,LIG,1931,887,1044,700,1231,ITC,ITC3,7,Liguria
2021-01-08,MOL,429,141,288,429,0,ITF,ITF2,14,Molise
2021-02-21,PIE,5090,2083,3007,4988,102,ITC,ITC1,1,Piemonte
2021-02-21,TOS,5105,2089,3016,4935,170,ITI,ITI1,9,Toscana
2021-03-19,SAR,7271,3051,4220,5056,2215,ITG,ITG2,20,Sardegna
2021-06-24,CAL,14950,6791,8159,6675,8275,ITF,ITF6,18,Calabria
2021-02-05,MAR,2154,653,1501,439,1715,ITI,ITI3,11,Marche
2021-03-19,CAL,4185,1953,2232,1894,2291,ITF,ITF6,18,Calabria
2021-03-20,PUG,8414,3878,4536,3820,4594,ITF,ITF4,16,Puglia
2021-06-14,BAS,4813,2149,2664,2104,2709,ITF,ITF5,17,Basilicata
2021-03-03,PUG,16776,6798,9978,14860,1916,ITF,ITF4,16,Puglia
2021-04-04,VDA,572,253,319,571,1,ITC,ITC2,2,Valle d'Aosta / Vallée d'Aoste
2021-05-08,CAM,56419,27132,29287,40591,15828,ITF,ITF3,15,Campania
2021-06-01,TOS,26893,13358,13535,23085,3808,ITI,ITI1,9,Toscana
2021-01-02,EMR,2375,916,1459,2375,0,ITH,ITH5,8,Emilia-Romagna
2021-04-24,LOM,75804,33595,42209,54674,21130,ITC,ITC4,3,Lombardia
2021-05-16,MAR,10898,4957,5941,6670,4228,ITI,ITI3,11,Marche
2021-01-28,CAM,8833,4122,4711,134,8699,ITF,ITF3,15,Campania
2021-02-05,PAB,3195,1181,2014,8,3187,ITH,ITH1,4,Provincia Autonoma Bolzano / Bozen
2021-03-23,BAS,1591,610,981,1423,168,ITF,ITF5,17,Basilicata
2021-06-11,PUG,47394,23186,24208,33481,13913,ITF,ITF4,16,Puglia
2021-01-14,LOM,26916,7803,19113,26916,0,ITC,ITC4,3,Lombardia
2021-01-21,PAT,352,95,257,228,124,ITH,ITH2,4,Provincia Autonoma Trento
2021-04-01,MOL,1469,667,802,743,726,ITF,ITF2,14,Molise
2021-05-30,MAR,9732,4690,5042,6743,2989,ITI,ITI3,11,Marche
2021-06-05,EMR,44067,22273,21794,37203,6864,ITH,ITH5,8,Emilia-Romagna
2021-07-01,BAS,3566,1764,1802,2465,1101,ITF,ITF5,17,Basilicata
2021-05-01,PAT,4848,2468,2380,4812,36,ITH,ITH2,4,Provincia Autonoma Trento
2021-05-08,LOM,87714,40752,46962,65678,22036,ITC,ITC4,3,Lombardia
2021-06-22,EMR,35483,17655,17828,16123,19360,ITH,ITH5,8,Emilia-Romagna
2021-02-09,SIC,4390,1817,2573,3312,1078,ITG,ITG1,19,Sicilia
2021-03-26,FVG,5998,2600,3398,3982,2016,ITH,ITH4,6,Friuli-Venezia Giulia
2021-05-09,ABR,9157,4091,5066,4287,4870,ITF,ITF1,13,Abruzzo
2021-02-12,LIG,1935,690,1245,897,1038,ITC,ITC3,7,Liguria
2021-03-12,FVG,4101,1695,2406,2720,1381,ITH,ITH4,6,Friuli-Venezia Giulia
2021-04-21,UMB,5319,2315,3004,3092,2227,ITI,ITI2,10,Umbria
2021-06-15,TOS,31172,16047,15125,26618,4554,ITI,ITI1,9,Toscana
2021-02-15,ABR,1796,833,963,1754,42,ITF,ITF1,13,Abruzzo
2021-03-10,TOS,18372,7408,10964,14354,4018,ITI,ITI1,9,Toscana
2021-06-10,CAL,15296,7033,8263,12536,2760,ITF,ITF6,18,Calabria
2021-04-21,CAM,30229,14727,15502,18002,12227,ITF,ITF3,15,Campania
2021-05-26,ABR,13559,6048,7511,8564,4995,ITF,ITF1,13,Abruzzo
2021-05-17,EMR,32393,15388,17005,22902,9491,ITH,ITH5,8,Emilia-Romagna
2021-01-02,FVG,1216,470,746,1216,0,ITH,ITH4,6,Friuli-Venezia Giulia
2021-01-21,LAZ,5603,2348,3255,550,5053,ITI,ITI4,12,Lazio
2021-04-15,PAB,4399,2307,2092,4136,263,ITH,ITH1,4,Provincia Autonoma Bolzano / Bozen
2021-06-14,ABR,10831,5349,5482,7463,3368,ITF,ITF1,13,Abruzzo
2021-01-12,VEN,5231,1517,3714,5231,0,ITH,ITH3,5,Veneto
2021-02-21,PAT,155,92,63,43,112,ITH,ITH2,4,Provincia Autonoma Trento
2021-03-02,UMB,3641,1346,2295,3637,4,ITI,ITI2,10,Umbria
2021-04-19,VEN,21544,8922,12622,5134,16410,ITH,ITH3,5,Veneto
2021-05-20,SIC,43749,20974,22775,27840,15909,ITG,ITG1,19,Sicilia
2021-06-20,PIE,33985,17025,16960,19268,14717,ITC,ITC1,1,Piemonte
2021-04-05,VEN,19153,8370,10783,13718,5435,ITH,ITH3,5,Veneto
2021-02-02,TOS,3743,1475,2268,196,3547,ITI,ITI1,9,Toscana
2021-03-12,PIE,14014,5241,8773,11078,2936,ITC,ITC1,1,Piemonte
2021-04-07,SAR,13552,6056,7496,7900,5652,ITG,ITG2,20,Sardegna
2021-04-12,FVG,7259,3183,4076,6127,1132,ITH,ITH4,6,Friuli-Venezia Giulia
2021-06-24,UMB,10093,5094,4999,6107,3986,ITI,ITI2,10,Umbria
2021-01-26,VEN,6919,2090,4829,149,6770,ITH,ITH3,5,Veneto
2021-04-24,SAR,10369,4850,5519,8032,2337,ITG,ITG2,20,Sardegna
2021-04-27,MAR,9525,4368,5157,5539,3986,ITI,ITI3,11,Marche
2021-05-15,PAT,1568,815,753,679,889,ITH,ITH2,4,Provincia Autonoma Trento
2021-03-31,LAZ,27616,13318,14298,20520,7096,ITI,ITI4,12,Lazio
2021-01-14,SAR,1106,426,680,1106,0,ITG,ITG2,20,Sardegna
2021-02-01,BAS,242,91,151,46,196,ITF,ITF5,17,Basilicata
2021-03-15,LIG,7246,3097,4149,4540,2706,ITC,ITC3,7,Liguria
2021-04-03,PUG,10559,4644,5915,7000,3559,ITF,ITF4,16,Puglia
2021-03-26,PIE,17810,7027,10783,8903,8907,ITC,ITC1,1,Piemonte
2021-05-02,PAB,2457,1288,1169,1536,921,ITH,ITH1,4,Provincia Autonoma Bolzano / Bozen
2021-06-01,PAT,4012,1875,2137,1157,2855,ITH,ITH2,4,Provincia Autonoma Trento
2021-02-13,VDA,216,196,20,215,1,ITC,ITC2,2,Valle d'Aosta / Vallée d'Aoste
2021-04-03,EMR,19940,8767,11173,16200,3740,ITH,ITH5,8,Emilia-Romagna
2021-03-07,ABR,2523,630,1893,2523,0,ITF,ITF1,13,Abruzzo
2021-05-30,EMR,27071,12790,14281,13377,13694,ITH,ITH5,8,Emilia-Romagna
2021-01-09,ABR,1484,566,918,1484,0,ITF,ITF1,13,Abruzzo
2021-02-19,EMR,7327,3010,4317,6813,514,ITH,ITH5,8,Emilia-Romagna
2021-04-16,VDA,599,261,338,597,2,ITC,ITC2,2,Valle d'Aosta / Vallée d'Aoste
2021-06-08,LAZ,66274,31557,34717,36532,29742,ITI,ITI4,12,Lazio
2020-12-31,EMR,2215,780,1435,2215,0,ITH,ITH5,8,Emilia-Romagna
2021-05-28,MAR,13953,6734,7219,9096,4857,ITI,ITI3,11,Marche
2021-06-06,EMR,36432,18925,17507,32026,4406,ITH,ITH5,8,Emilia-Romagna
2021-04-02,VDA,873,344,529,648,225,ITC,ITC2,2,Valle d'Aosta / Vallée d'Aoste
2021-05-18,UMB,7731,3349,4382,3894,3837,ITI,ITI2,10,Umbria
2021-02-26,EMR,9634,3673,5961,8586,1048,ITH,ITH5,8,Emilia-Romagna
2021-04-01,MAR,7577,3183,4394,4161,3416,ITI,ITI3,11,Marche
2021-06-25,FVG,10474,5243,5231,2040,8434,ITH,ITH4,6,Friuli-Venezia Giulia
2021-03-22,UMB,3560,1655,1905,2314,1246,ITI,ITI2,10,Umbria
2021-05-29,VDA,798,434,364,561,237,ITC,ITC2,2,Valle d'Aosta / Vallée d'Aoste
2021-06-16,PUG,41318,20325,20993,26996,14322,ITF,ITF4,16,Puglia
2021-04-05,UMB,4248,1728,2520,2193,2055,ITI,ITI2,10,Umbria
2021-04-06,MOL,1494,701,793,1151,343,ITF,ITF2,14,Molise
2021-02-22,TOS,9818,4253,5565,9541,277,ITI,ITI1,9,Toscana
2021-02-07,UMB,54,17,37,1,53,ITI,ITI2,10,Umbria
2021-02-08,MOL,334,141,193,216,118,ITF,ITF2,14,Molise
2021-05-19,MOL,2340,1205,1135,1915,425,ITF,ITF2,14,Molise
2021-06-01,SIC,38774,17634,21140,24983,13791,ITG,ITG1,19,Sicilia
2020-12-30,PAB,388,182,206,388,0,ITH,ITH1,4,Provincia Autonoma Bolzano / Bozen
2021-03-03,CAL,5052,2758,2294,3972,1080,ITF,ITF6,18,Calabria
2021-02-21,BAS,284,113,171,284,0,ITF,ITF5,17,Basilicata
2021-03-23,MOL,1642,694,948,1435,207,ITF,ITF2,14,Molise
2021-04-05,SIC,8021,3958,4063,6581,1440,ITG,ITG1,19,Sicilia
2021-01-15,PAT,595,132,463,595,0,ITH,ITH2,4,Provincia Autonoma Trento
2021-02-17,LIG,2689,1182,1507,2263,426,ITC,ITC3,7,Liguria
2021-03-17,FVG,3236,1267,1969,745,2491,ITH,ITH4,6,Friuli-Venezia Giulia
2021-03-07,BAS,889,309,580,851,38,ITF,ITF5,17,Basilicata
2021-07-01,MOL,2603,1258,1345,261,2342,ITF,ITF2,14,Molise
2021-05-13,FVG,11145,5372,5773,9088,2057,ITH,ITH4,6,Friuli-Venezia Giulia
2021-05-28,LIG,16280,8128,8152,11745,4535,ITC,ITC3,7,Liguria
2020-12-30,PUG,1,0,1,1,0,ITF,ITF4,16,Puglia
2021-01-09,BAS,557,160,397,557,0,ITF,ITF5,17,Basilicata
2021-01-05,LIG,2878,895,1983,2878,0,ITC,ITC3,7,Liguria
2021-06-09,PAB,3789,1884,1905,1315,2474,ITH,ITH1,4,Provincia Autonoma Bolzano / Bozen
2021-02-26,VEN,8294,3270,5024,7036,1258,ITH,ITH3,5,Veneto
2021-01-09,LAZ,6298,2562,3736,6298,0,ITI,ITI4,12,Lazio
2021-03-01,PAB,922,221,701,921,1,ITH,ITH1,4,Provincia Autonoma Bolzano / Bozen
2021-04-24,VEN,24749,10825,13924,15669,9080,ITH,ITH3,5,Veneto
2021-05-07,ABR,12185,5704,6481,7773,4412,ITF,ITF1,13,Abruzzo
2021-02-16,FVG,2516,1135,1381,2400,116,ITH,ITH4,6,Friuli-Venezia Giulia
2021-03-03,LIG,4581,1847,2734,3554,1027,ITC,ITC3,7,Liguria
2021-04-12,SAR,6997,3184,3813,5280,1717,ITG,ITG2,20,Sardegna
2021-01-02,SAR,60,21,39,60,0,ITG,ITG2,20,Sardegna
2021-03-15,PAB,1192,451,741,710,482,ITH,ITH1,4,Provincia Autonoma Bolzano / Bozen
2021-05-13,PIE,35685,17527,18158,20567,15118,ITC,ITC1,1,Piemonte
2021-06-08,SAR,14823,7067,7756,11320,3503,ITG,ITG2,20,Sardegna
2021-04-22,MAR,10797,4932,5865,9219,1578,ITI,ITI3,11,Marche
2021-05-20,PAT,5012,2357,2655,3377,1635,ITH,ITH2,4,Provincia Autonoma Trento
2021-02-02,PIE,10242,3509,6733,816,9426,ITC,ITC1,1,Piemonte
2021-02-28,SAR,368,169,199,142,226,ITG,ITG2,20,Sardegna
2021-02-24,MAR,3516,1534,1982,3438,78,ITI,ITI3,11,Marche
2021-03-24,PAT,2376,940,1436,1556,820,ITH,ITH2,4,Provincia Autonoma Trento
2021-03-22,PUG,9933,5097,4836,4287,5646,ITF,ITF4,16,Puglia
2021-03-31,PIE,19110,8104,11006,10416,8694,ITC,ITC1,1,Piemonte
2021-04-19,LAZ,30102,13680,16422,19421,10681,ITI,ITI4,12,Lazio
2021-04-26,SAR,6824,3266,3558,5948,876,ITG,ITG2,20,Sardegna
2021-04-27,PAB,2226,1013,1213,1149,1077,ITH,ITH1,4,Provincia Autonoma Bolzano / Bozen
2021-01-14,VEN,7063,1924,5139,7063,0,ITH,ITH3,5,Veneto
2021-01-17,PAB,2328,1044,1284,2317,11,ITH,ITH1,4,Provincia Autonoma Bolzano / Bozen
2021-01-24,PUG,1670,750,920,154,1516,ITF,ITF4,16,Puglia
2021-02-21,LAZ,6989,3180,3809,6526,463,ITI,ITI4,12,Lazio
2021-02-25,VDA,201,101,100,194,7,ITC,ITC2,2,Valle d'Aosta / Vallée d'Aoste
2021-05-27,PIE,37383,17388,19995,19252,18131,ITC,ITC1,1,Piemonte
2021-06-23,PAB,1133,584,549,369,764,ITH,ITH1,4,Provincia Autonoma Bolzano / Bozen
2021-06-30,PUG,43189,20924,22265,17411,25778,ITF,ITF4,16,Puglia
2021-02-09,PAT,917,287,630,442,475,ITH,ITH2,4,Provincia Autonoma Trento
2021-03-12,VEN,18657,8194,10463,11909,6748,ITH,ITH3,5,Veneto
2021-06-01,LOM,93903,46077,47826,76853,17050,ITC,ITC4,3,Lombardia
2021-01-02,LOM,200,72,128,200,0,ITC,ITC4,3,Lombardia
2021-02-16,PIE,3967,1756,2211,3209,758,ITC,ITC1,1,Piemonte
2021-06-08,LOM,102346,52025,50321,88314,14032,ITC,ITC4,3,Lombardia
2021-06-29,CAL,12747,5853,6894,5119,7628,ITF,ITF6,18,Calabria
2021-03-15,PUG,12331,6140,6191,5828,6503,ITF,ITF4,16,Puglia
2021-06-22,CAM,51300,24432,26868,12314,38986,ITF,ITF3,15,Campania
2021-02-28,LOM,7884,3254,4630,7674,210,ITC,ITC4,3,Lombardia
2021-05-03,CAL,14763,6767,7996,10548,4215,ITF,ITF6,18,Calabria
2021-01-17,PUG,1308,590,718,1239,69,ITF,ITF4,16,Puglia
2021-03-14,CAM,8618,3827,4791,4478,4140,ITF,ITF3,15,Campania
2021-06-23,PUG,28582,13964,14618,16923,11659,ITF,ITF4,16,Puglia
2021-02-15,MOL,144,70,74,141,3,ITF,ITF2,14,Molise
2021-03-17,PAT,2071,792,1279,1200,871,ITH,ITH2,4,Provincia Autonoma Trento
2021-04-26,LOM,87944,40923,47021,68784,19160,ITC,ITC4,3,Lombardia
2021-04-27,PUG,26671,12068,14603,21068,5603,ITF,ITF4,16,Puglia
2021-05-07,BAS,4649,2284,2365,3295,1354,ITF,ITF5,17,Basilicata
2021-05-10,CAM,35464,16389,19075,25541,9923,ITF,ITF3,15,Campania
2021-06-04,MAR,14335,7289,7046,11897,2438,ITI,ITI3,11,Marche
2021-03-21,CAL,4456,1924,2532,2736,1720,ITF,ITF6,18,Calabria
2021-04-08,MAR,8676,3800,4876,8331,345,ITI,ITI3,11,Marche
2021-04-12,SIC,18842,9141,9701,11591,7251,ITG,ITG1,19,Sicilia
2021-05-08,TOS,29132,13102,16030,13676,15456,ITI,ITI1,9,Toscana
2021-06-06,LOM,89824,46177,43647,80604,9220,ITC,ITC4,3,Lombardia
2021-01-07,LOM,11759,3636,8123,11759,0,ITC,ITC4,3,Lombardia
2021-03-03,TOS,18228,6538,11690,14622,3606,ITI,ITI1,9,Toscana
2021-06-04,MOL,3037,1490,1547,2595,442,ITF,ITF2,14,Molise
2021-01-18,BAS,463,157,306,364,99,ITF,ITF5,17,Basilicata
2021-01-05,TOS,5249,1755,3494,5249,0,ITI,ITI1,9,Toscana
2021-04-08,MOL,1766,903,863,1564,202,ITF,ITF2,14,Molise
2021-06-10,SIC,51144,24019,27125,44056,7088,ITG,ITG1,19,Sicilia
2021-01-15,PUG,4551,1866,2685,4551,0,ITF,ITF4,16,Puglia
2021-04-19,EMR,20900,9797,11103,14627,6273,ITH,ITH5,8,Emilia-Romagna
2021-01-31,PAT,75,15,60,1,74,ITH,ITH2,4,Provincia Autonoma Trento
2021-03-31,UMB,3897,1728,2169,2211,1686,ITI,ITI2,10,Umbria
2021-01-09,EMR,9988,3452,6536,9988,0,ITH,ITH5,8,Emilia-Romagna
2021-06-15,EMR,42950,22110,20840,28029,14921,ITH,ITH5,8,Emilia-Romagna
2021-03-16,BAS,1908,802,1106,229,1679,ITF,ITF5,17,Basilicata
2021-03-07,EMR,7839,2958,4881,6319,1520,ITH,ITH5,8,Emilia-Romagna
2021-02-16,UMB,1308,655,653,1299,9,ITI,ITI2,10,Umbria
2021-05-27,SIC,47444,21792,25652,24863,22581,ITG,ITG1,19,Sicilia
2021-05-03,EMR,28698,13557,15141,17820,10878,ITH,ITH5,8,Emilia-Romagna
2021-01-07,CAM,8911,4167,4744,8911,0,ITF,ITF3,15,Campania
2021-05-27,UMB,9964,4864,5100,8646,1318,ITI,ITI2,10,Umbria
2021-01-19,TOS,1105,532,573,1105,0,ITI,ITI1,9,Toscana
2021-03-12,CAL,5160,2474,2686,4098,1062,ITF,ITF6,18,Calabria
2021-01-04,UMB,809,398,411,809,0,ITI,ITI2,10,Umbria
2021-03-05,CAM,16811,6664,10147,10148,6663,ITF,ITF3,15,Campania
2021-04-14,SIC,20110,9720,10390,11414,8696,ITG,ITG1,19,Sicilia
2021-01-14,CAL,2641,1252,1389,2641,0,ITF,ITF6,18,Calabria
2021-04-14,UMB,8146,3678,4468,6167,1979,ITI,ITI2,10,Umbria
2021-05-29,FVG,12010,5840,6170,7023,4987,ITH,ITH4,6,Friuli-Venezia Giulia
2021-06-17,LAZ,66305,31800,34505,32167,34138,ITI,ITI4,12,Lazio
2021-01-15,PAB,3282,1228,2054,3282,0,ITH,ITH1,4,Provincia Autonoma Bolzano / Bozen
2021-04-21,LAZ,33036,15013,18023,20662,12374,ITI,ITI4,12,Lazio
2021-01-07,LIG,3229,1095,2134,3229,0,ITC,ITC3,7,Liguria
2021-06-13,LIG,5616,2695,2921,5163,453,ITC,ITC3,7,Liguria
2021-04-17,LIG,7382,3216,4166,6632,750,ITC,ITC3,7,Liguria
2021-01-07,SAR,3113,1077,2036,3113,0,ITG,ITG2,20,Sardegna
2021-04-18,VDA,522,254,268,518,4,ITC,ITC2,2,Valle d'Aosta / Vallée d'Aoste
2021-06-22,VEN,43144,21327,21817,18852,24292,ITH,ITH3,5,Veneto
2021-04-17,MAR,11703,5316,6387,10630,1073,ITI,ITI3,11,Marche
2021-05-01,LIG,7142,3256,3886,1342,5800,ITC,ITC3,7,Liguria
2021-02-07,PIE,3089,974,2115,445,2644,ITC,ITC1,1,Piemonte
2021-06-14,VDA,306,163,143,12,294,ITC,ITC2,2,Valle d'Aosta / Vallée d'Aoste
2021-03-05,LIG,4869,2150,2719,3737,1132,ITC,ITC3,7,Liguria
2021-06-10,SAR,17808,8478,9330,11772,6036,ITG,ITG2,20,Sardegna
2021-02-19,LOM,14218,5400,8818,13495,723,ITC,ITC4,3,Lombardia
2021-04-22,MOL,1845,864,981,1066,779,ITF,ITF2,14,Molise
2021-05-31,VDA,879,395,484,500,379,ITC,ITC2,2,Valle d'Aosta / Vallée d'Aoste
2021-04-17,LOM,48484,21293,27191,37646,10838,ITC,ITC4,3,Lombardia
2021-04-26,VEN,20715,9453,11262,15578,5137,ITH,ITH3,5,Veneto
2021-06-18,PAB,4053,2108,1945,1154,2899,ITH,ITH1,4,Provincia Autonoma Bolzano / Bozen
2021-06-03,LAZ,56310,28486,27824,38625,17685,ITI,ITI4,12,Lazio
2021-06-13,MAR,10493,5442,5051,9200,1293,ITI,ITI3,11,Marche
2020-12-27,MAR,204,99,105,204,0,ITI,ITI3,11,Marche
2021-05-05,BAS,4334,2048,2286,3444,890,ITF,ITF5,17,Basilicata
2021-02-17,MOL,72,32,40,57,15,ITF,ITF2,14,Molise
2021-02-26,LOM,18394,7554,10840,16522,1872,ITC,ITC4,3,Lombardia
2021-03-09,BAS,1400,713,687,794,606,ITF,ITF5,17,Basilicata
2021-04-21,SIC,22371,10743,11628,16263,6108,ITG,ITG1,19,Sicilia
2021-01-21,CAL,963,447,516,933,30,ITF,ITF6,18,Calabria
2021-01-22,PUG,1410,578,832,992,418,ITF,ITF4,16,Puglia
2021-05-28,MOL,2648,1363,1285,2101,547,ITF,ITF2,14,Molise
2021-02-28,EMR,6819,2527,4292,4974,1845,ITH,ITH5,8,Emilia-Romagna
2021-01-25,BAS,1024,429,595,74,950,ITF,ITF5,17,Basilicata
2021-04-26,EMR,27901,12936,14965,18580,9321,ITH,ITH5,8,Emilia-Romagna
2021-04-07,SIC,15482,7615,7867,8363,7119,ITG,ITG1,19,Sicilia
2021-06-03,UMB,9032,4464,4568,8747,285,ITI,ITI2,10,Umbria
2021-01-16,EMR,5628,1718,3910,5628,0,ITH,ITH5,8,Emilia-Romagna
2021-04-07,UMB,5570,2291,3279,3566,2004,ITI,ITI2,10,Umbria
2021-02-01,ABR,1632,573,1059,271,1361,ITF,ITF1,13,Abruzzo
2021-03-14,EMR,8801,3839,4962,5004,3797,ITH,ITH5,8,Emilia-Romagna
2021-01-11,BAS,183,66,117,183,0,ITF,ITF5,17,Basilicata
2021-01-14,CAM,7074,2978,4096,7074,0,ITF,ITF3,15,Campania
2021-02-23,UMB,1691,657,1034,1649,42,ITI,ITI2,10,Umbria
2021-06-03,SIC,45767,20985,24782,34259,11508,ITG,ITG1,19,Sicilia
2021-01-12,TOS,3581,1398,2183,3581,0,ITI,ITI1,9,Toscana
2021-01-08,PAB,1521,479,1042,1521,0,ITH,ITH1,4,Provincia Autonoma Bolzano / Bozen
2021-06-06,LIG,3818,2033,1785,2948,870,ITC,ITC3,7,Liguria
2021-06-10,LAZ,71287,33570,37717,37650,33637,ITI,ITI4,12,Lazio
2021-03-23,ABR,4832,2187,2645,2266,2566,ITF,ITF1,13,Abruzzo
2021-04-24,LIG,8218,3795,4423,5067,3151,ITC,ITC3,7,Liguria
2021-05-22,FVG,11568,5194,6374,7334,4234,ITH,ITH4,6,Friuli-Venezia Giulia
2020-12-31,SAR,32,16,16,32,0,ITG,ITG2,20,Sardegna
2021-04-25,VDA,849,408,441,710,139,ITC,ITC2,2,Valle d'Aosta / Vallée d'Aoste
2021-01-25,ABR,1604,632,972,17,1587,ITF,ITF1,13,Abruzzo
2021-02-26,LIG,3764,1523,2241,3436,328,ITC,ITC3,7,Liguria
2021-06-21,VDA,1122,600,522,617,505,ITC,ITC2,2,Valle d'Aosta / Vallée d'Aoste
2021-06-07,VDA,710,347,363,649,61,ITC,ITC2,2,Valle d'Aosta / Vallée d'Aoste
2021-06-06,MAR,12388,6104,6284,10811,1577,ITI,ITI3,11,Marche
2021-06-20,LIG,1257,618,639,990,267,ITC,ITC3,7,Liguria
2021-02-27,VDA,231,85,146,124,107,ITC,ITC2,2,Valle d'Aosta / Vallée d'Aoste
2021-04-14,LAZ,29299,13278,16021,19176,10123,ITI,ITI4,12,Lazio
2021-06-11,MOL,3441,1654,1787,2014,1427,ITF,ITF2,14,Molise
2021-06-15,VEN,47553,24148,23405,30070,17483,ITH,ITH3,5,Veneto
2021-05-22,PIE,33488,15115,18373,17262,16226,ITC,ITC1,1,Piemonte
2021-06-25,PUG,48314,23623,24691,23494,24820,ITF,ITF4,16,Puglia
2020-12-31,LOM,714,302,412,714,0,ITC,ITC4,3,Lombardia
2021-04-15,MOL,1926,794,1132,1081,845,ITF,ITF2,14,Molise
2021-05-05,MOL,2414,1042,1372,2273,141,ITF,ITF2,14,Molise
2021-05-06,CAM,57282,27910,29372,42831,14451,ITF,ITF3,15,Campania
2021-05-19,PAB,3637,1850,1787,1851,1786,ITH,ITH1,4,Provincia Autonoma Bolzano / Bozen
2021-01-03,PAB,41,16,25,41,0,ITH,ITH1,4,Provincia Autonoma Bolzano / Bozen
2021-04-14,FVG,7217,3118,4099,5505,1712,ITH,ITH4,6,Friuli-Venezia Giulia
2021-01-13,ABR,1258,441,817,1258,0,ITF,ITF1,13,Abruzzo
2021-06-03,PAT,4766,2235,2531,1301,3465,ITH,ITH2,4,Provincia Autonoma Trento
2021-01-19,PIE,6466,2105,4361,6454,12,ITC,ITC1,1,Piemonte
2021-02-14,SAR,539,263,276,537,2,ITG,ITG2,20,Sardegna
2021-06-08,LIG,17820,8896,8924,11203,6617,ITC,ITC3,7,Liguria
2021-04-13,PAB,2395,1132,1263,2388,7,ITH,ITH1,4,Provincia Autonoma Bolzano / Bozen
2021-05-03,LAZ,39223,17708,21515,26617,12606,ITI,ITI4,12,Lazio
2021-05-07,VDA,564,245,319,533,31,ITC,ITC2,2,Valle d'Aosta / Vallée d'Aoste
2021-03-17,LIG,5552,2368,3184,2473,3079,ITC,ITC3,7,Liguria
2021-04-23,VDA,921,443,478,538,383,ITC,ITC2,2,Valle d'Aosta / Vallée d'Aoste
2021-05-04,MOL,2705,1181,1524,2577,128,ITF,ITF2,14,Molise
2021-05-08,VEN,41432,18743,22689,29621,11811,ITH,ITH3,5,Veneto
2021-01-13,VDA,337,110,227,337,0,ITC,ITC2,2,Valle d'Aosta / Vallée d'Aoste
2021-06-25,LIG,13504,6439,7065,7178,6326,ITC,ITC3,7,Liguria
2021-01-10,MOL,270,72,198,270,0,ITF,ITF2,14,Molise
2021-04-05,LOM,27380,11695,15685,19277,8103,ITC,ITC4,3,Lombardia
2021-04-06,VDA,741,381,360,629,112,ITC,ITC2,2,Valle d'Aosta / Vallée d'Aoste
2021-04-20,MOL,2318,1025,1293,1220,1098,ITF,ITF2,14,Molise
2021-06-18,MAR,15119,7550,7569,8372,6747,ITI,ITI3,11,Marche
2021-06-09,MOL,1023,565,458,523,500,ITF,ITF2,14,Molise
2021-06-22,SIC,39414,18124,21290,18166,21248,ITG,ITG1,19,Sicilia
2021-01-13,BAS,916,387,529,916,0,ITF,ITF5,17,Basilicata
2020-12-31,TOS,802,201,601,802,0,ITI,ITI1,9,Toscana
2021-04-14,PIE,27714,12565,15149,23189,4525,ITC,ITC1,1,Piemonte
2021-04-23,BAS,4535,2184,2351,3536,999,ITF,ITF5,17,Basilicata
2021-05-23,MOL,1700,864,836,1695,5,ITF,ITF2,14,Molise
2021-04-10,TOS,11720,5348,6372,10977,743,ITI,ITI1,9,Toscana
2021-04-14,EMR,27040,12842,14198,20937,6103,ITH,ITH5,8,Emilia-Romagna
2021-01-19,PAT,406,77,329,406,0,ITH,ITH2,4,Provincia Autonoma Trento
2021-01-30,BAS,706,229,477,129,577,ITF,ITF5,17,Basilicata
2021-03-01,PUG,15104,5867,9237,13732,1372,ITF,ITF4,16,Puglia
2021-02-13,ABR,854,385,469,438,416,ITF,ITF1,13,Abruzzo
2021-04-19,CAL,7865,3797,4068,6191,1674,ITF,ITF6,18,Calabria
2021-01-21,EMR,2165,729,1436,819,1346,ITH,ITH5,8,Emilia-Romagna
2021-02-11,UMB,839,348,491,834,5,ITI,ITI2,10,Umbria
2021-05-22,SIC,47962,22784,25178,28652,19310,ITG,ITG1,19,Sicilia
2021-05-22,UMB,6959,2752,4207,2640,4319,ITI,ITI2,10,Umbria
2021-02-28,SIC,7163,3062,4101,6533,630,ITG,ITG1,19,Sicilia
2021-02-28,CAM,10412,3207,7205,8512,1900,ITF,ITF3,15,Campania
2021-01-09,CAL,1942,1048,894,1942,0,ITF,ITF6,18,Calabria
2021-06-08,SIC,47472,22308,25164,40956,6516,ITG,ITG1,19,Sicilia
2021-03-18,VDA,136,43,93,99,37,ITC,ITC2,2,Valle d'Aosta / Vallée d'Aoste
2021-06-03,FVG,12246,6672,5574,10270,1976,ITH,ITH4,6,Friuli-Venezia Giulia
2021-06-22,LAZ,61900,28489,33411,29078,32822,ITI,ITI4,12,Lazio
2021-03-04,ABR,5936,2360,3576,5014,922,ITF,ITF1,13,Abruzzo
2021-04-05,SAR,2037,784,1253,2036,1,ITG,ITG2,20,Sardegna
2021-01-31,LOM,9734,3762,5972,29,9705,ITC,ITC4,3,Lombardia
2021-02-14,CAM,3928,1923,2005,3894,34,ITF,ITF3,15,Campania
2021-02-22,PAB,526,143,383,514,12,ITH,ITH1,4,Provincia Autonoma Bolzano / Bozen
2021-03-14,LAZ,17238,6752,10486,12084,5154,ITI,ITI4,12,Lazio
2021-06-26,VDA,1061,509,552,357,704,ITC,ITC2,2,Valle d'Aosta / Vallée d'Aoste
2021-06-27,VEN,39575,20220,19355,15322,24253,ITH,ITH3,5,Veneto
2021-05-06,LIG,14518,6441,8077,6195,8323,ITC,ITC3,7,Liguria
2021-03-19,VEN,13791,5668,8123,7696,6095,ITH,ITH3,5,Veneto
2021-05-25,LOM,91134,43616,47518,44663,46471,ITC,ITC4,3,Lombardia
2021-03-04,VDA,291,139,152,42,249,ITC,ITC2,2,Valle d'Aosta / Vallée d'Aoste
2021-02-14,LOM,3583,1547,2036,2948,635,ITC,ITC4,3,Lombardia
2021-05-26,VDA,1209,587,622,576,633,ITC,ITC2,2,Valle d'Aosta / Vallée d'Aoste
2021-03-01,MOL,662,274,388,447,215,ITF,ITF2,14,Molise
2021-04-29,MAR,13375,6124,7251,7277,6098,ITI,ITI3,11,Marche
2021-01-26,LIG,2487,806,1681,16,2471,ITC,ITC3,7,Liguria
2021-01-12,LOM,20228,6700,13528,20228,0,ITC,ITC4,3,Lombardia
2021-01-26,CAM,7340,3726,3614,351,6989,ITF,ITF3,15,Campania
2021-03-10,PAT,2403,929,1474,1482,921,ITH,ITH2,4,Provincia Autonoma Trento
2021-06-29,SAR,17790,8538,9252,3772,14018,ITG,ITG2,20,Sardegna
2021-01-19,FVG,6,2,4,6,0,ITH,ITH4,6,Friuli-Venezia Giulia
2021-03-04,BAS,1881,892,989,1085,796,ITF,ITF5,17,Basilicata
2021-04-03,MOL,1773,851,922,1738,35,ITF,ITF2,14,Molise
2021-01-09,SIC,7182,3387,3795,7182,0,ITG,ITG1,19,Sicilia
2021-02-19,TOS,8293,2952,5341,7780,513,ITI,ITI1,9,Toscana
2021-06-03,EMR,37851,18417,19434,30345,7506,ITH,ITH5,8,Emilia-Romagna
2021-06-03,PIE,34593,17865,16728,30195,4398,ITC,ITC1,1,Piemonte
2021-01-10,PUG,2348,1061,1287,2348,0,ITF,ITF4,16,Puglia
2021-02-23,EMR,8215,3218,4997,7829,386,ITH,ITH5,8,Emilia-Romagna
2021-04-20,PUG,21150,9824,11326,17685,3465,ITF,ITF4,16,Puglia
2021-05-03,SIC,23312,10793,12519,13525,9787,ITG,ITG1,19,Sicilia
2021-03-12,EMR,18306,7701,10605,11589,6717,ITH,ITH5,8,Emilia-Romagna
2020-12-27,PUG,509,252,257,509,0,ITF,ITF4,16,Puglia
2021-04-02,UMB,4344,1779,2565,3589,755,ITI,ITI2,10,Umbria
2021-04-19,CAM,30766,14829,15937,19194,11572,ITF,ITF3,15,Campania
2021-05-28,ABR,14008,6307,7701,7659,6349,ITF,ITF1,13,Abruzzo
2021-06-12,BAS,3674,1687,1987,2987,687,ITF,ITF5,17,Basilicata
2021-01-09,UMB,1717,495,1222,1717,0,ITI,ITI2,10,Umbria
2021-04-19,SIC,18214,8623,9591,12635,5579,ITG,ITG1,19,Sicilia
2021-01-09,CAM,10567,5024,5543,10567,0,ITF,ITF3,15,Campania
2021-02-28,CAL,2333,1058,1275,2180,153,ITF,ITF6,18,Calabria
2021-04-19,UMB,5028,2223,2805,2980,2048,ITI,ITI2,10,Umbria
2021-03-28,BAS,2142,743,1399,2125,17,ITF,ITF5,17,Basilicata
2021-05-17,CAL,14899,7447,7452,10183,4716,ITF,ITF6,18,Calabria
2021-06-10,PIE,40215,21006,19209,37660,2555,ITC,ITC1,1,Piemonte
2021-03-26,UMB,4589,1712,2877,4417,172,ITI,ITI2,10,Umbria
2021-03-27,MOL,2743,1273,1470,1310,1433,ITF,ITF2,14,Molise
2021-02-12,TOS,7618,2694,4924,7405,213,ITI,ITI1,9,Toscana
2021-04-08,PAB,2767,1347,1420,2563,204,ITH,ITH1,4,Provincia Autonoma Bolzano / Bozen
2021-06-10,EMR,44046,22635,21411,38702,5344,ITH,ITH5,8,Emilia-Romagna
2021-06-21,ABR,10888,5308,5580,4916,5972,ITF,ITF1,13,Abruzzo
2021-06-22,LOM,108662,56757,51905,79471,29191,ITC,ITC4,3,Lombardia
2021-03-11,BAS,1794,928,866,835,959,ITF,ITF5,17,Basilicata
2021-01-02,UMB,304,111,193,304,0,ITI,ITI2,10,Umbria
2021-03-02,EMR,12658,4272,8386,10581,2077,ITH,ITH5,8,Emilia-Romagna
2021-06-29,FVG,10874,5536,5338,1208,9666,ITH,ITH4,6,Friuli-Venezia Giulia
2021-01-03,PUG,2006,942,1064,2006,0,ITF,ITF4,16,Puglia
2021-04-14,SAR,8258,3905,4353,7020,1238,ITG,ITG2,20,Sardegna
2021-06-27,PIE,37297,18499,18798,15675,21622,ITC,ITC1,1,Piemonte
2021-01-10,MAR,1744,700,1044,1744,0,ITI,ITI3,11,Marche
2021-02-21,CAL,623,295,328,546,77,ITF,ITF6,18,Calabria
2021-06-18,MOL,2754,1246,1508,1307,1447,ITF,ITF2,14,Molise
2021-03-19,EMR,15925,6972,8953,7956,7969,ITH,ITH5,8,Emilia-Romagna
2021-03-19,PIE,11032,4521,6511,4426,6606,ITC,ITC1,1,Piemonte
2021-03-27,PUG,12152,5708,6444,6983,5169,ITF,ITF4,16,Puglia
2021-04-05,PIE,14748,6234,8514,12192,2556,ITC,ITC1,1,Piemonte
2021-05-01,SAR,9917,4766,5151,5459,4458,ITG,ITG2,20,Sardegna
2021-01-19,VEN,1310,473,837,1160,150,ITH,ITH3,5,Veneto
2021-01-21,SAR,126,60,66,94,32,ITG,ITG2,20,Sardegna
2021-02-06,VDA,289,104,185,92,197,ITC,ITC2,2,Valle d'Aosta / Vallée d'Aoste
2021-03-12,CAM,14573,7409,7164,8490,6083,ITF,ITF3,15,Campania
2021-06-01,LIG,16149,8108,8041,10783,5366,ITC,ITC3,7,Liguria
2021-06-03,LOM,97038,49669,47369,86194,10844,ITC,ITC4,3,Lombardia
2021-06-17,SIC,41206,19192,22014,20167,21039,ITG,ITG1,19,Sicilia
2021-02-07,SAR,1118,395,723,228,890,ITG,ITG2,20,Sardegna
2021-04-28,CAL,12526,6061,6465,9665,2861,ITF,ITF6,18,Calabria
2021-03-07,UMB,845,180,665,838,7,ITI,ITI2,10,Umbria
2021-01-05,PUG,5107,2251,2856,5107,0,ITF,ITF4,16,Puglia
2020-12-27,PAB,144,65,79,144,0,ITH,ITH1,4,Provincia Autonoma Bolzano / Bozen
2021-02-04,CAL,3593,1708,1885,653,2940,ITF,ITF6,18,Calabria
2021-04-30,VDA,831,355,476,485,346,ITC,ITC2,2,Valle d'Aosta / Vallée d'Aoste
2021-05-10,LAZ,44437,20305,24132,31022,13415,ITI,ITI4,12,Lazio
2021-06-18,LIG,15063,7318,7745,9486,5577,ITC,ITC3,7,Liguria
2021-06-20,LOM,87811,43754,44057,54196,33615,ITC,ITC4,3,Lombardia
2021-06-27,PAT,1282,685,597,342,940,ITH,ITH2,4,Provincia Autonoma Trento
2021-04-15,PUG,32545,15185,17360,29000,3545,ITF,ITF4,16,Puglia
2021-01-20,VDA,23,8,15,23,0,ITC,ITC2,2,Valle d'Aosta / Vallée d'Aoste
2021-03-12,LOM,35264,12966,22298,25065,10199,ITC,ITC4,3,Lombardia
2021-04-03,MAR,7574,3205,4369,6905,669,ITI,ITI3,11,Marche
2021-04-07,FVG,7819,3616,4203,7037,782,ITH,ITH4,6,Friuli-Venezia Giulia
2021-05-15,CAL,27239,13027,14212,20386,6853,ITF,ITF6,18,Calabria
2021-03-29,LOM,40044,15541,24503,25208,14836,ITC,ITC4,3,Lombardia
2020-12-31,SIC,887,473,414,887,0,ITG,ITG1,19,Sicilia
2021-01-26,TOS,5393,1792,3601,220,5173,ITI,ITI1,9,Toscana
2021-03-30,ABR,5126,2261,2865,3304,1822,ITF,ITF1,13,Abruzzo
2021-06-30,PAB,3021,1542,1479,418,2603,ITH,ITH1,4,Provincia Autonoma Bolzano / Bozen
2021-06-29,PIE,40278,20127,20151,19743,20535,ITC,ITC1,1,Piemonte
2021-03-10,LIG,5900,2862,3038,3994,1906,ITC,ITC3,7,Liguria
2021-05-06,TOS,31307,13609,17698,14160,17147,ITI,ITI1,9,Toscana
2021-06-03,CAM,72556,35186,37370,61889,10667,ITF,ITF3,15,Campania
2021-01-06,ABR,1831,664,1167,1831,0,ITF,ITF1,13,Abruzzo
2021-06-25,MAR,14107,7033,7074,6520,7587,ITI,ITI3,11,Marche
2021-02-23,CAM,11003,3388,7615,10477,526,ITF,ITF3,15,Campania
2021-04-19,TOS,9093,4508,4585,8061,1032,ITI,ITI1,9,Toscana
2021-05-01,VEN,38842,18232,20610,29899,8943,ITH,ITH3,5,Veneto
2021-05-03,SAR,8187,3820,4367,6590,1597,ITG,ITG2,20,Sardegna
2021-02-02,CAL,2350,1151,1199,177,2173,ITF,ITF6,18,Calabria
2021-05-30,MOL,1845,919,926,1560,285,ITF,ITF2,14,Molise
2021-03-07,SIC,9259,3454,5805,8176,1083,ITG,ITG1,19,Sicilia
2021-04-07,EMR,26116,11890,14226,20105,6011,ITH,ITH5,8,Emilia-Romagna
2021-04-17,TOS,20518,9201,11317,18397,2121,ITI,ITI1,9,Toscana
2021-05-20,SAR,16306,7852,8454,11412,4894,ITG,ITG2,20,Sardegna
2021-01-12,PAT,506,158,348,506,0,ITH,ITH2,4,Provincia Autonoma Trento
2021-01-16,CAL,2400,1124,1276,2400,0,ITF,ITF6,18,Calabria
2021-06-11,PAB,5746,2947,2799,2276,3470,ITH,ITH1,4,Provincia Autonoma Bolzano / Bozen
2021-06-15,SIC,45103,21257,23846,27814,17289,ITG,ITG1,19,Sicilia
2021-02-09,SAR,2287,837,1450,1290,997,ITG,ITG2,20,Sardegna
2021-01-14,EMR,8129,2593,5536,8129,0,ITH,ITH5,8,Emilia-Romagna
2021-03-24,SIC,20879,9804,11075,15217,5662,ITG,ITG1,19,Sicilia
2021-02-26,SAR,2801,1109,1692,2495,306,ITG,ITG2,20,Sardegna
2021-03-20,PAB,1758,849,909,1133,625,ITH,ITH1,4,Provincia Autonoma Bolzano / Bozen
2021-05-27,LAZ,58095,26961,31134,44409,13686,ITI,ITI4,12,Lazio
2021-05-29,UMB,7851,3607,4244,6285,1566,ITI,ITI2,10,Umbria
2021-03-30,BAS,2742,1157,1585,2397,345,ITF,ITF5,17,Basilicata
2021-01-18,VDA,213,74,139,213,0,ITC,ITC2,2,Valle d'Aosta / Vallée d'Aoste
2021-02-21,CAM,5836,2241,3595,5611,225,ITF,ITF3,15,Campania
2021-03-19,PAT,2423,915,1508,1571,852,ITH,ITH2,4,Provincia Autonoma Trento
2021-01-06,BAS,294,129,165,294,0,ITF,ITF5,17,Basilicata
2021-01-24,TOS,3349,1073,2276,201,3148,ITI,ITI1,9,Toscana
2021-03-05,LAZ,19560,8662,10898,14827,4733,ITI,ITI4,12,Lazio
2021-02-16,LAZ,8360,4035,4325,7753,607,ITI,ITI4,12,Lazio
2021-04-05,PAT,35,17,18,33,2,ITH,ITH2,4,Provincia Autonoma Trento
2021-04-16,BAS,3320,1633,1687,2422,898,ITF,ITF5,17,Basilicata
2021-05-29,SIC,47165,21460,25705,23975,23190,ITG,ITG1,19,Sicilia
2021-06-28,PAB,4596,2299,2297,229,4367,ITH,ITH1,4,Provincia Autonoma Bolzano / Bozen
2021-01-07,TOS,6018,1751,4267,6018,0,ITI,ITI1,9,Toscana
2021-04-11,VDA,479,208,271,479,0,ITC,ITC2,2,Valle d'Aosta / Vallée d'Aoste
2021-05-26,PAB,4939,2492,2447,2965,1974,ITH,ITH1,4,Provincia Autonoma Bolzano / Bozen
2021-02-22,LOM,11896,4808,7088,11591,305,ITC,ITC4,3,Lombardia
2021-04-24,LAZ,33409,15068,18341,20635,12774,ITI,ITI4,12,Lazio
2021-04-29,CAM,41326,20035,21291,24846,16480,ITF,ITF3,15,Campania
2021-06-11,PAT,7186,3420,3766,1569,5617,ITH,ITH2,4,Provincia Autonoma Trento
2021-06-22,BAS,4363,2070,2293,2260,2103,ITF,ITF5,17,Basilicata
2021-03-15,TOS,8698,3645,5053,4255,4443,ITI,ITI1,9,Toscana
2021-01-19,CAM,1095,474,621,1092,3,ITF,ITF3,15,Campania
2021-06-05,BAS,4796,2206,2590,3853,943,ITF,ITF5,17,Basilicata
2021-06-23,TOS,31421,15208,16213,20118,11303,ITI,ITI1,9,Toscana
2021-01-31,SIC,4032,1927,2105,112,3920,ITG,ITG1,19,Sicilia
2021-03-08,VEN,13630,6271,7359,9561,4069,ITH,ITH3,5,Veneto
2021-03-09,MOL,1329,579,750,1177,152,ITF,ITF2,14,Molise
2021-03-03,EMR,15856,5253,10603,13371,2485,ITH,ITH5,8,Emilia-Romagna
2021-05-11,SIC,32291,15356,16935,19816,12475,ITG,ITG1,19,Sicilia
2021-06-13,PAT,3685,2033,1652,295,3390,ITH,ITH2,4,Provincia Autonoma Trento
2021-02-20,MOL,1018,441,577,998,20,ITF,ITF2,14,Molise
2021-02-17,SIC,5215,3203,2012,4547,668,ITG,ITG1,19,Sicilia
2021-05-17,ABR,11034,5037,5997,6180,4854,ITF,ITF1,13,Abruzzo
2021-05-30,LAZ,41177,17621,23556,33824,7353,ITI,ITI4,12,Lazio
2021-05-13,LAZ,50116,22516,27600,32335,17781,ITI,ITI4,12,Lazio
2021-05-31,MOL,2355,1143,1212,1937,418,ITF,ITF2,14,Molise
2021-05-06,PIE,33482,15796,17686,19927,13555,ITC,ITC1,1,Piemonte
2021-02-23,BAS,1901,771,1130,1763,138,ITF,ITF5,17,Basilicata
2021-05-23,PIE,28708,13135,15573,15757,12951,ITC,ITC1,1,Piemonte
2021-05-14,MOL,2644,1215,1429,1926,718,ITF,ITF2,14,Molise
2020-12-27,PAT,103,40,63,103,0,ITH,ITH2,4,Provincia Autonoma Trento
2021-02-12,PIE,6891,2215,4676,3930,2961,ITC,ITC1,1,Piemonte
2021-06-03,BAS,4918,2255,2663,3737,1181,ITF,ITF5,17,Basilicata
2021-05-25,FVG,12896,6377,6519,9584,3312,ITH,ITH4,6,Friuli-Venezia Giulia
2021-03-12,BAS,1907,981,926,806,1101,ITF,ITF5,17,Basilicata
2021-04-24,SIC,31126,14691,16435,23506,7620,ITG,ITG1,19,Sicilia
2021-03-01,PIE,12043,4846,7197,11234,809,ITC,ITC1,1,Piemonte
2021-06-14,PAB,2904,1576,1328,547,2357,ITH,ITH1,4,Provincia Autonoma Bolzano / Bozen
2021-03-13,LOM,27172,9769,17403,21081,6091,ITC,ITC4,3,Lombardia
2021-01-03,SAR,90,36,54,90,0,ITG,ITG2,20,Sardegna
2021-01-10,TOS,3001,1104,1897,3001,0,ITI,ITI1,9,Toscana
2021-06-18,VEN,52816,26355,26461,24430,28386,ITH,ITH3,5,Veneto
2021-02-05,CAL,3809,1718,2091,488,3321,ITF,ITF6,18,Calabria
2021-06-02,MOL,2805,1355,1450,2706,99,ITF,ITF2,14,Molise
2021-04-20,TOS,18137,8103,10034,12582,5555,ITI,ITI1,9,Toscana
2021-06-11,FVG,10551,5762,4789,9752,799,ITH,ITH4,6,Friuli-Venezia Giulia
2021-05-17,BAS,5541,2732,2809,3408,2133,ITF,ITF5,17,Basilicata
2021-03-03,FVG,3645,1633,2012,2371,1274,ITH,ITH4,6,Friuli-Venezia Giulia
2021-03-11,PUG,14802,6565,8237,11631,3171,ITF,ITF4,16,Puglia
2021-04-03,TOS,15014,6647,8367,13888,1126,ITI,ITI1,9,Toscana
2021-04-27,LIG,14779,6682,8097,7195,7584,ITC,ITC3,7,Liguria
2021-02-23,ABR,2781,1274,1507,2770,11,ITF,ITF1,13,Abruzzo
2021-03-18,MAR,3395,1477,1918,162,3233,ITI,ITI3,11,Marche
2021-04-29,CAL,12446,6046,6400,8700,3746,ITF,ITF6,18,Calabria
2021-01-21,VDA,33,12,21,33,0,ITC,ITC2,2,Valle d'Aosta / Vallée d'Aoste
2021-02-03,LIG,2314,790,1524,54,2260,ITC,ITC3,7,Liguria
2021-06-02,PUG,26928,13173,13755,22116,4812,ITF,ITF4,16,Puglia
2021-06-26,MAR,13414,6810,6604,5744,7670,ITI,ITI3,11,Marche
2021-02-06,ABR,1610,743,867,602,1008,ITF,ITF1,13,Abruzzo
2021-04-12,CAL,7088,3438,3650,5395,1693,ITF,ITF6,18,Calabria
2021-06-01,UMB,4380,2089,2291,4225,155,ITI,ITI2,10,Umbria
2021-01-04,VDA,142,59,83,142,0,ITC,ITC2,2,Valle d'Aosta / Vallée d'Aoste
2021-05-25,EMR,25054,11189,13865,11715,13339,ITH,ITH5,8,Emilia-Romagna
2021-05-25,PIE,31149,14454,16695,16007,15142,ITC,ITC1,1,Piemonte
2021-01-19,CAL,1116,491,625,1105,11,ITF,ITF6,18,Calabria
2021-03-10,UMB,4031,1943,2088,2775,1256,ITI,ITI2,10,Umbria
2021-06-11,PIE,43476,23004,20472,40656,2820,ITC,ITC1,1,Piemonte
2021-01-27,TOS,4835,1573,3262,206,4629,ITI,ITI1,9,Toscana
2021-02-14,EMR,1403,378,1025,1283,120,ITH,ITH5,8,Emilia-Romagna
2021-03-27,VEN,32066,14010,18056,26267,5799,ITH,ITH3,5,Veneto
2021-05-23,MAR,9210,4284,4926,7539,1671,ITI,ITI3,11,Marche
2021-01-21,CAM,2092,1115,977,676,1416,ITF,ITF3,15,Campania
2021-03-28,VDA,522,212,310,521,1,ITC,ITC2,2,Valle d'Aosta / Vallée d'Aoste
2021-01-16,UMB,217,71,146,217,0,ITI,ITI2,10,Umbria
2021-03-13,PUG,10468,4134,6334,8660,1808,ITF,ITF4,16,Puglia
2021-06-03,VEN,54245,27904,26341,42298,11947,ITH,ITH3,5,Veneto
2021-05-06,MAR,12655,5822,6833,5584,7071,ITI,ITI3,11,Marche
2021-06-17,CAL,15446,7042,8404,9319,6127,ITF,ITF6,18,Calabria
2021-02-15,PAB,72,42,30,26,46,ITH,ITH1,4,Provincia Autonoma Bolzano / Bozen
2021-03-11,VDA,197,76,121,66,131,ITC,ITC2,2,Valle d'Aosta / Vallée d'Aoste
2021-04-29,LIG,15577,6978,8599,6739,8838,ITC,ITC3,7,Liguria
2021-05-01,LOM,95972,43671,52301,66765,29207,ITC,ITC4,3,Lombardia
2021-05-27,FVG,12811,6131,6680,7584,5227,ITH,ITH4,6,Friuli-Venezia Giulia
2021-06-29,LAZ,58875,27946,30929,28141,30734,ITI,ITI4,12,Lazio
2021-01-21,LOM,5463,1596,3867,4774,689,ITC,ITC4,3,Lombardia
2021-02-12,MAR,1582,618,964,1430,152,ITI,ITI3,11,Marche
2021-03-26,CAL,8080,3836,4244,4960,3120,ITF,ITF6,18,Calabria
2021-02-02,UMB,942,272,670,32,910,ITI,ITI2,10,Umbria
2021-02-24,PUG,10039,4705,5334,9448,591,ITF,ITF4,16,Puglia
2021-04-12,LIG,12385,5475,6910,10366,2019,ITC,ITC3,7,Liguria
2021-02-08,ABR,1194,395,799,486,708,ITF,ITF1,13,Abruzzo
2021-06-02,VDA,1215,688,527,814,401,ITC,ITC2,2,Valle d'Aosta / Vallée d'Aoste
2021-06-04,PUG,52342,25332,27010,34707,17635,ITF,ITF4,16,Puglia
2021-01-19,LIG,1371,438,933,1281,90,ITC,ITC3,7,Liguria
2021-03-17,TOS,11421,4587,6834,6892,4529,ITI,ITI1,9,Toscana
2021-05-11,PAB,2844,1335,1509,1321,1523,ITH,ITH1,4,Provincia Autonoma Bolzano / Bozen
2021-05-18,PUG,28860,13425,15435,16088,12772,ITF,ITF4,16,Puglia
2021-05-19,ABR,10693,5109,5584,7655,3038,ITF,ITF1,13,Abruzzo
2021-06-19,VDA,1288,667,621,669,619,ITC,ITC2,2,Valle d'Aosta / Vallée d'Aoste
2021-02-07,LOM,7311,2824,4487,338,6973,ITC,ITC4,3,Lombardia
2021-04-14,CAM,27647,13337,14310,19077,8570,ITF,ITF3,15,Campania
2021-03-24,FVG,3970,1714,2256,2490,1480,ITH,ITH4,6,Friuli-Venezia Giulia
2021-03-25,ABR,5794,2663,3131,3177,2617,ITF,ITF1,13,Abruzzo
2021-02-14,SIC,1055,402,653,915,140,ITG,ITG1,19,Sicilia
2021-03-12,TOS,16973,6611,10362,13445,3528,ITI,ITI1,9,Toscana
2021-04-28,EMR,33715,15588,18127,20827,12888,ITH,ITH5,8,Emilia-Romagna
2021-01-27,ABR,1365,516,849,39,1326,ITF,ITF1,13,Abruzzo
2021-05-20,FVG,12689,6302,6387,10174,2515,ITH,ITH4,6,Friuli-Venezia Giulia
2021-06-08,CAM,51487,25050,26437,44491,6996,ITF,ITF3,15,Campania
2021-01-14,TOS,3255,1179,2076,3255,0,ITI,ITI1,9,Toscana
2021-03-07,CAL,3392,1731,1661,3300,92,ITF,ITF6,18,Calabria
2021-06-20,TOS,25141,12457,12684,15656,9485,ITI,ITI1,9,Toscana
2021-06-24,EMR,39252,19610,19642,19776,19476,ITH,ITH5,8,Emilia-Romagna
2021-06-05,UMB,8221,3775,4446,5567,2654,ITI,ITI2,10,Umbria
2021-01-02,SIC,4846,2524,2322,4846,0,ITG,ITG1,19,Sicilia
2021-04-24,TOS,13419,6164,7255,5981,7438,ITI,ITI1,9,Toscana
2021-06-15,CAL,9578,4434,5144,6260,3318,ITF,ITF6,18,Calabria
2021-01-26,FVG,1977,647,1330,217,1760,ITH,ITH4,6,Friuli-Venezia Giulia
2021-04-26,CAM,34030,16647,17383,28408,5622,ITF,ITF3,15,Campania
2021-05-21,ABR,13016,6326,6690,8037,4979,ITF,ITF1,13,Abruzzo
2021-04-17,VEN,22421,9085,13336,15143,7278,ITH,ITH3,5,Veneto
2021-02-24,LIG,3764,1560,2204,3506,258,ITC,ITC3,7,Liguria
2021-04-20,PAB,1562,784,778,1560,2,ITH,ITH1,4,Provincia Autonoma Bolzano / Bozen
2021-01-07,VEN,8360,2318,6042,8360,0,ITH,ITH3,5,Veneto
2021-06-13,VEN,36891,19045,17846,29931,6960,ITH,ITH3,5,Veneto
2020-12-29,LIG,125,33,92,125,0,ITC,ITC3,7,Liguria
2021-01-10,PAB,2,2,0,2,0,ITH,ITH1,4,Provincia Autonoma Bolzano / Bozen
2021-06-16,PAB,3811,2017,1794,9,3802,ITH,ITH1,4,Provincia Autonoma Bolzano / Bozen
2021-03-18,ABR,3897,1651,2246,2066,1831,ITF,ITF1,13,Abruzzo
2021-01-12,LIG,2469,887,1582,2469,0,ITC,ITC3,7,Liguria
2021-02-09,FVG,1842,555,1287,1556,286,ITH,ITH4,6,Friuli-Venezia Giulia
2021-06-01,SAR,14318,6653,7665,9728,4590,ITG,ITG2,20,Sardegna
2021-06-26,ABR,9870,4931,4939,5676,4194,ITF,ITF1,13,Abruzzo
2021-02-21,SAR,1589,710,879,1559,30,ITG,ITG2,20,Sardegna
2021-04-22,LIG,13850,6207,7643,8777,5073,ITC,ITC3,7,Liguria
2021-01-21,VEN,2293,719,1574,21,2272,ITH,ITH3,5,Veneto
2021-02-02,PAT,909,240,669,191,718,ITH,ITH2,4,Provincia Autonoma Trento
2021-03-03,MAR,6689,3065,3624,5805,884,ITI,ITI3,11,Marche
2021-01-06,VDA,65,33,32,65,0,ITC,ITC2,2,Valle d'Aosta / Vallée d'Aoste
2021-04-19,SAR,10196,4622,5574,8766,1430,ITG,ITG2,20,Sardegna
2021-01-05,MAR,1574,590,984,1574,0,ITI,ITI3,11,Marche
2021-05-13,PAT,3407,1580,1827,2305,1102,ITH,ITH2,4,Provincia Autonoma Trento
2021-05-14,BAS,5907,2799,3108,3376,2531,ITF,ITF5,17,Basilicata
2021-01-09,SAR,4026,1417,2609,4026,0,ITG,ITG2,20,Sardegna
2021-02-14,LAZ,5777,2372,3405,5306,471,ITI,ITI4,12,Lazio
2021-03-24,PIE,15540,6373,9167,6413,9127,ITC,ITC1,1,Piemonte
2021-06-15,SAR,14659,6786,7873,9928,4731,ITG,ITG2,20,Sardegna
2021-03-05,VEN,13336,5020,8316,9666,3670,ITH,ITH3,5,Veneto
2021-02-18,VDA,349,153,196,261,88,ITC,ITC2,2,Valle d'Aosta / Vallée d'Aoste
2021-02-28,LAZ,10263,4017,6246,9748,515,ITI,ITI4,12,Lazio
2021-03-07,SAR,1658,751,907,1117,541,ITG,ITG2,20,Sardegna
2021-03-08,PAB,1210,534,676,1183,27,ITH,ITH1,4,Provincia Autonoma Bolzano / Bozen
2021-05-20,PIE,38623,17938,20685,13679,24944,ITC,ITC1,1,Piemonte
2021-03-31,PAT,2584,983,1601,1727,857,ITH,ITH2,4,Provincia Autonoma Trento
2021-04-12,LOM,47241,20582,26659,32901,14340,ITC,ITC4,3,Lombardia
2021-01-02,LAZ,6708,2631,4077,6708,0,ITI,ITI4,12,Lazio
2021-02-09,PIE,7392,2316,5076,722,6670,ITC,ITC1,1,Piemonte
2021-05-04,PAB,3449,1843,1606,2412,1037,ITH,ITH1,4,Provincia Autonoma Bolzano / Bozen
2021-05-11,PUG,32543,14350,18193,14124,18419,ITF,ITF4,16,Puglia
2021-03-07,CAM,11973,5404,6569,8130,3843,ITF,ITF3,15,Campania
2021-05-04,PUG,35032,14815,20217,18583,16449,ITF,ITF4,16,Puglia
2021-02-21,LOM,5053,1864,3189,5036,17,ITC,ITC4,3,Lombardia
2021-02-22,MOL,265,129,136,250,15,ITF,ITF2,14,Molise
2021-03-14,CAL,2710,1053,1657,2285,425,ITF,ITF6,18,Calabria
2021-04-07,PIE,23611,9999,13612,18150,5461,ITC,ITC1,1,Piemonte
2021-03-08,PUG,14988,6435,8553,12588,2400,ITF,ITF4,16,Puglia
2021-05-03,CAM,40777,19898,20879,28920,11857,ITF,ITF3,15,Campania
2020-12-27,MOL,50,20,30,50,0,ITF,ITF2,14,Molise
2021-04-19,LOM,60122,27351,32771,50717,9405,ITC,ITC4,3,Lombardia
2021-06-22,CAL,14225,6706,7519,7140,7085,ITF,ITF6,18,Calabria
2021-03-18,BAS,1350,564,786,25,1325,ITF,ITF5,17,Basilicata
2021-04-15,MAR,10376,4674,5702,9811,565,ITI,ITI3,11,Marche
2021-06-29,CAM,47521,22994,24527,18867,28654,ITF,ITF3,15,Campania
2021-01-26,PAT,542,154,388,27,515,ITH,ITH2,4,Provincia Autonoma Trento
2021-06-15,LOM,95456,48573,46883,49603,45853,ITC,ITC4,3,Lombardia
2021-02-17,MAR,1817,691,1126,1700,117,ITI,ITI3,11,Marche
2021-06-26,BAS,3285,1586,1699,2729,556,ITF,ITF5,17,Basilicata
2021-05-06,PAT,5531,2739,2792,4751,780,ITH,ITH2,4,Provincia Autonoma Trento
2021-05-10,CAL,13124,6088,7036,7724,5400,ITF,ITF6,18,Calabria
2021-02-02,FVG,2467,806,1661,217,2250,ITH,ITH4,6,Friuli-Venezia Giulia
2021-06-17,EMR,45726,23103,22623,21644,24082,ITH,ITH5,8,Emilia-Romagna
2021-06-27,TOS,33290,16067,17223,6056,27234,ITI,ITI1,9,Toscana
2021-03-31,FVG,8114,3559,4555,7268,846,ITH,ITH4,6,Friuli-Venezia Giulia
2021-05-14,ABR,10594,5069,5525,5446,5148,ITF,ITF1,13,Abruzzo
2021-05-01,TOS,23307,10059,13248,14133,9174,ITI,ITI1,9,Toscana
2021-03-05,TOS,16878,6688,10190,12124,4754,ITI,ITI1,9,Toscana
2021-04-26,CAL,10196,5064,5132,7773,2423,ITF,ITF6,18,Calabria
2021-04-01,ABR,5591,2505,3086,3504,2087,ITF,ITF1,13,Abruzzo
2021-06-15,CAM,18073,8799,9274,10685,7388,ITF,ITF3,15,Campania
2021-02-21,SIC,5168,2501,2667,5062,106,ITG,ITG1,19,Sicilia
2021-06-13,TOS,24601,12344,12257,22939,1662,ITI,ITI1,9,Toscana
2021-01-22,PAB,248,143,105,124,124,ITH,ITH1,4,Provincia Autonoma Bolzano / Bozen
2021-04-07,LOM,50586,20921,29665,34779,15807,ITC,ITC4,3,Lombardia
2021-05-06,VEN,46950,22023,24927,38475,8475,ITH,ITH3,5,Veneto
2021-01-07,LAZ,7751,2904,4847,7751,0,ITI,ITI4,12,Lazio
2021-01-17,MAR,1616,693,923,1556,60,ITI,ITI3,11,Marche
2021-05-26,BAS,4489,2260,2229,1707,2782,ITF,ITF5,17,Basilicata
2021-02-23,CAL,1593,754,839,1478,115,ITF,ITF6,18,Calabria
2021-04-25,ABR,9066,4621,4445,8256,810,ITF,ITF1,13,Abruzzo
2021-05-18,MAR,11064,5259,5805,7655,3409,ITI,ITI3,11,Marche
2021-02-28,PAT,242,121,121,242,0,ITH,ITH2,4,Provincia Autonoma Trento
2021-03-23,VDA,379,150,229,245,134,ITC,ITC2,2,Valle d'Aosta / Vallée d'Aoste
2021-05-08,UMB,8125,3739,4386,4901,3224,ITI,ITI2,10,Umbria
2021-05-19,VDA,993,498,495,418,575,ITC,ITC2,2,Valle d'Aosta / Vallée d'Aoste
2021-06-08,PAT,5919,2863,3056,1870,4049,ITH,ITH2,4,Provincia Autonoma Trento
2021-01-28,LAZ,8279,3165,5114,782,7497,ITI,ITI4,12,Lazio
2021-02-02,CAM,5724,2805,2919,444,5280,ITF,ITF3,15,Campania
2021-02-10,PAB,1636,605,1031,26,1610,ITH,ITH1,4,Provincia Autonoma Bolzano / Bozen
2021-05-10,SIC,28302,13589,14713,16169,12133,ITG,ITG1,19,Sicilia
2021-03-31,CAM,23182,11369,11813,19743,3439,ITF,ITF3,15,Campania
2021-05-08,LAZ,45419,20734,24685,30023,15396,ITI,ITI4,12,Lazio
2021-01-28,UMB,1248,394,854,19,1229,ITI,ITI2,10,Umbria
2021-01-29,MOL,421,136,285,6,415,ITF,ITF2,14,Molise
2021-04-26,PAT,2655,1252,1403,2560,95,ITH,ITH2,4,Provincia Autonoma Trento
2021-05-09,MOL,2052,933,1119,1956,96,ITF,ITF2,14,Molise
2021-05-13,LOM,87090,41741,45349,58281,28809,ITC,ITC4,3,Lombardia
2021-05-23,PUG,17913,8370,9543,14108,3805,ITF,ITF4,16,Puglia
2021-02-02,LOM,19873,6595,13278,499,19374,ITC,ITC4,3,Lombardia
2021-03-26,SIC,17847,8287,9560,12417,5430,ITG,ITG1,19,Sicilia
2021-06-02,BAS,5960,2804,3156,4417,1543,ITF,ITF5,17,Basilicata
2021-03-31,LOM,42052,17051,25001,26822,15230,ITC,ITC4,3,Lombardia
2021-05-15,EMR,33247,14982,18265,22840,10407,ITH,ITH5,8,Emilia-Romagna
2021-05-03,FVG,7208,3285,3923,3429,3779,ITH,ITH4,6,Friuli-Venezia Giulia
2021-06-27,SAR,9007,4304,4703,2982,6025,ITG,ITG2,20,Sardegna
2021-02-04,EMR,9920,3201,6719,1230,8690,ITH,ITH5,8,Emilia-Romagna
2021-05-22,EMR,32997,14122,18875,16911,16086,ITH,ITH5,8,Emilia-Romagna
2021-05-03,UMB,5086,2270,2816,2199,2887,ITI,ITI2,10,Umbria
2021-01-14,FVG,2584,789,1795,2584,0,ITH,ITH4,6,Friuli-Venezia Giulia
2021-04-05,LIG,3978,1753,2225,2329,1649,ITC,ITC3,7,Liguria
2021-04-18,BAS,3719,1846,1873,2352,1367,ITF,ITF5,17,Basilicata
2021-04-09,EMR,25724,11666,14058,20027,5697,ITH,ITH5,8,Emilia-Romagna
2021-01-28,SIC,9028,4272,4756,393,8635,ITG,ITG1,19,Sicilia
2021-05-11,MOL,3207,1414,1793,2957,250,ITF,ITF2,14,Molise
2021-01-23,UMB,280,100,180,2,278,ITI,ITI2,10,Umbria
2021-05-08,SIC,35614,17020,18594,25324,10290,ITG,ITG1,19,Sicilia
2021-05-27,VEN,46460,22833,23627,23308,23152,ITH,ITH3,5,Veneto
2021-02-17,PUG,4278,1747,2531,3673,605,ITF,ITF4,16,Puglia
2021-05-03,PIE,26659,12168,14491,12498,14161,ITC,ITC1,1,Piemonte
2021-04-07,CAM,24971,11984,12987,20246,4725,ITF,ITF3,15,Campania
2021-03-26,LAZ,29965,13781,16184,23119,6846,ITI,ITI4,12,Lazio
2021-05-21,PAB,6923,3805,3118,5078,1845,ITH,ITH1,4,Provincia Autonoma Bolzano / Bozen
2021-05-28,PUG,43720,20709,23011,28050,15670,ITF,ITF4,16,Puglia
2021-02-07,VEN,2315,862,1453,714,1601,ITH,ITH3,5,Veneto
2021-02-02,EMR,9474,3048,6426,515,8959,ITH,ITH5,8,Emilia-Romagna
2021-02-20,BAS,1163,532,631,1044,119,ITF,ITF5,17,Basilicata
2021-02-19,PAT,929,359,570,870,59,ITH,ITH2,4,Provincia Autonoma Trento
2021-05-31,BAS,4229,2009,2220,1721,2508,ITF,ITF5,17,Basilicata
2021-01-26,SIC,9470,4687,4783,251,9219,ITG,ITG1,19,Sicilia
2021-02-26,PIE,12293,4933,7360,11556,737,ITC,ITC1,1,Piemonte
2021-03-24,SAR,7409,3108,4301,6050,1359,ITG,ITG2,20,Sardegna
2021-01-08,ABR,1525,507,1018,1525,0,ITF,ITF1,13,Abruzzo
2021-06-08,FVG,10286,5382,4904,9872,414,ITH,ITH4,6,Friuli-Venezia Giulia
2021-01-21,UMB,608,202,406,339,269,ITI,ITI2,10,Umbria
2021-03-10,LOM,33245,12714,20531,25384,7861,ITC,ITC4,3,Lombardia
2021-04-24,PIE,27507,12436,15071,21853,5654,ITC,ITC1,1,Piemonte
2021-05-27,TOS,28318,13170,15148,13484,14834,ITI,ITI1,9,Toscana
2021-02-28,FVG,2686,1003,1683,2292,394,ITH,ITH4,6,Friuli-Venezia Giulia
2021-04-18,ABR,5814,2728,3086,4871,943,ITF,ITF1,13,Abruzzo
2021-05-11,MAR,10622,4832,5790,5679,4943,ITI,ITI3,11,Marche
2021-01-14,PIE,9767,3152,6615,9767,0,ITC,ITC1,1,Piemonte
2021-03-16,VDA,182,37,145,118,64,ITC,ITC2,2,Valle d'Aosta / Vallée d'Aoste
2021-03-31,TOS,32703,13248,19455,20541,12162,ITI,ITI1,9,Toscana
2021-05-06,LOM,89797,42181,47616,73330,16467,ITC,ITC4,3,Lombardia
2021-01-26,LOM,8341,2706,5635,349,7992,ITC,ITC4,3,Lombardia
2021-03-31,CAL,9088,4137,4951,5048,4040,ITF,ITF6,18,Calabria
2021-02-18,BAS,1070,401,669,855,215,ITF,ITF5,17,Basilicata
2021-04-09,CAL,7915,3706,4209,5027,2888,ITF,ITF6,18,Calabria
2021-04-02,CAM,21856,10520,11336,19534,2322,ITF,ITF3,15,Campania
2021-05-11,LIG,13914,6388,7526,7300,6614,ITC,ITC3,7,Liguria
2021-05-30,PUG,20909,10015,10894,15875,5034,ITF,ITF4,16,Puglia
2021-01-22,MOL,128,36,92,128,0,ITF,ITF2,14,Molise
2021-03-22,TOS,5251,2763,2488,4807,444,ITI,ITI1,9,Toscana
2021-03-24,VEN,22109,9573,12536,15307,6802,ITH,ITH3,5,Veneto
2021-05-16,PAB,2025,932,1093,1333,692,ITH,ITH1,4,Provincia Autonoma Bolzano / Bozen
2021-05-02,MOL,1893,932,961,588,1305,ITF,ITF2,14,Molise
2021-02-20,ABR,4774,1841,2933,4698,76,ITF,ITF1,13,Abruzzo
2021-03-15,MAR,4405,2029,2376,1312,3093,ITI,ITI3,11,Marche
2021-03-29,LIG,10576,4619,5957,7445,3131,ITC,ITC3,7,Liguria
2021-04-26,FVG,5460,2450,3010,3811,1649,ITH,ITH4,6,Friuli-Venezia Giulia
2021-03-06,MOL,1728,807,921,1569,159,ITF,ITF2,14,Molise
2021-06-05,CAL,20345,9530,10815,17383,2962,ITF,ITF6,18,Calabria
2021-01-31,LIG,624,270,354,9,615,ITC,ITC3,7,Liguria
2021-06-23,MAR,13664,6698,6966,6667,6997,ITI,ITI3,11,Marche
2021-06-25,TOS,33465,16701,16764,12360,21105,ITI,ITI1,9,Toscana
2021-06-20,VEN,40416,19665,20751,18930,21486,ITH,ITH3,5,Veneto
2021-06-22,SAR,19329,8985,10344,7269,12060,ITG,ITG2,20,Sardegna
2021-02-05,LIG,2680,987,1693,304,2376,ITC,ITC3,7,Liguria
2021-05-01,CAM,46337,22659,23678,30233,16104,ITF,ITF3,15,Campania
2021-06-08,TOS,32492,16634,15858,32062,430,ITI,ITI1,9,Toscana
2021-02-26,TOS,10080,3834,6246,8874,1206,ITI,ITI1,9,Toscana
2021-05-27,EMR,42181,18717,23464,14019,28162,ITH,ITH5,8,Emilia-Romagna
2021-02-10,MAR,1439,452,987,1080,359,ITI,ITI3,11,Marche
2021-01-14,LAZ,5488,2145,3343,5488,0,ITI,ITI4,12,Lazio
2021-02-16,EMR,5772,2446,3326,5241,531,ITH,ITH5,8,Emilia-Romagna
2021-04-26,SIC,21708,10270,11438,13628,8080,ITG,ITG1,19,Sicilia
2021-06-06,TOS,28287,13645,14642,22933,5354,ITI,ITI1,9,Toscana
2021-03-31,SAR,10274,4164,6110,7826,2448,ITG,ITG2,20,Sardegna
2021-01-19,LOM,8053,2329,5724,7585,468,ITC,ITC4,3,Lombardia
2021-02-02,SIC,5271,2472,2799,627,4644,ITG,ITG1,19,Sicilia
2021-02-08,BAS,557,193,364,151,406,ITF,ITF5,17,Basilicata
2021-01-29,PAB,1497,510,987,24,1473,ITH,ITH1,4,Provincia Autonoma Bolzano / Bozen
2021-04-07,LAZ,25708,11916,13792,18395,7313,ITI,ITI4,12,Lazio
2021-04-12,CAM,23306,10920,12386,20271,3035,ITF,ITF3,15,Campania
2021-05-25,PAT,4770,2269,2501,1868,2902,ITH,ITH2,4,Provincia Autonoma Trento
2021-05-08,PAT,3162,1726,1436,2740,422,ITH,ITH2,4,Provincia Autonoma Trento
2021-05-19,BAS,2870,1498,1372,1194,1676,ITF,ITF5,17,Basilicata
2021-01-02,CAM,3672,1962,1710,3672,0,ITF,ITF3,15,Campania
2021-03-09,VDA,206,96,110,174,32,ITC,ITC2,2,Valle d'Aosta / Vallée d'Aoste
2021-04-22,PAB,2924,1501,1423,1982,942,ITH,ITH1,4,Provincia Autonoma Bolzano / Bozen
2021-04-26,UMB,5380,2332,3048,3129,2251,ITI,ITI2,10,Umbria
2021-02-25,BAS,1788,737,1051,1742,46,ITF,ITF5,17,Basilicata
2021-02-20,VDA,251,210,41,241,10,ITC,ITC2,2,Valle d'Aosta / Vallée d'Aoste
2020-12-28,LAZ,959,412,547,959,0,ITI,ITI4,12,Lazio
2021-02-14,PAT,246,186,60,11,235,ITH,ITH2,4,Provincia Autonoma Trento
2021-04-09,UMB,6727,3122,3605,6521,206,ITI,ITI2,10,Umbria
2021-05-09,PAB,4241,2410,1831,3089,1152,ITH,ITH1,4,Provincia Autonoma Bolzano / Bozen
2021-04-29,PUG,26159,12102,14057,19497,6662,ITF,ITF4,16,Puglia
2021-04-30,ABR,12405,5815,6590,6684,5721,ITF,ITF1,13,Abruzzo
2021-01-16,LAZ,5645,2281,3364,5645,0,ITI,ITI4,12,Lazio
2021-06-17,CAM,57540,27562,29978,30790,26750,ITF,ITF3,15,Campania
2021-04-19,PIE,22558,10772,11786,18194,4364,ITC,ITC1,1,Piemonte
2021-01-14,SIC,5230,2472,2758,5230,0,ITG,ITG1,19,Sicilia
2021-04-13,ABR,5855,2739,3116,4655,1200,ITF,ITF1,13,Abruzzo
2021-04-26,LAZ,29235,13458,15777,20031,9204,ITI,ITI4,12,Lazio
2021-01-09,PIE,6184,2185,3999,6184,0,ITC,ITC1,1,Piemonte
2021-02-02,LAZ,5911,2213,3698,639,5272,ITI,ITI4,12,Lazio
2021-01-20,ABR,447,156,291,445,2,ITF,ITF1,13,Abruzzo
2021-02-19,VEN,7322,3140,4182,7118,204,ITH,ITH3,5,Veneto
2021-03-26,CAM,19860,9320,10540,16045,3815,ITF,ITF3,15,Campania
2021-02-03,MOL,731,249,482,338,393,ITF,ITF2,14,Molise
2021-01-28,FVG,2239,794,1445,354,1885,ITH,ITH4,6,Friuli-Venezia Giulia
2021-01-26,PIE,6333,1880,4453,735,5598,ITC,ITC1,1,Piemonte
2021-06-11,MAR,13756,7034,6722,11435,2321,ITI,ITI3,11,Marche
2021-02-06,BAS,906,370,536,146,760,ITF,ITF5,17,Basilicata
2021-04-27,MOL,1593,767,826,465,1128,ITF,ITF2,14,Molise
2021-05-27,PAT,4291,1990,2301,1251,3040,ITH,ITH2,4,Provincia Autonoma Trento
2021-03-24,LIG,9177,4031,5146,5890,3287,ITC,ITC3,7,Liguria
2021-05-10,EMR,33840,16124,17716,26595,7245,ITH,ITH5,8,Emilia-Romagna
2021-05-08,FVG,10270,4643,5627,5488,4782,ITH,ITH4,6,Friuli-Venezia Giulia
2020-12-31,LIG,990,353,637,990,0,ITC,ITC3,7,Liguria
2021-04-30,BAS,5284,2373,2911,4122,1162,ITF,ITF5,17,Basilicata
2021-02-21,VEN,4638,1211,3427,4633,5,ITH,ITH3,5,Veneto
2021-04-28,UMB,5378,2326,3052,2983,2395,ITI,ITI2,10,Umbria
2021-03-06,PAB,3973,2081,1892,3762,211,ITH,ITH1,4,Provincia Autonoma Bolzano / Bozen
2021-04-10,LIG,7885,3559,4326,6971,914,ITC,ITC3,7,Liguria
2021-02-04,UMB,733,226,507,25,708,ITI,ITI2,10,Umbria
2021-05-15,VEN,36198,17491,18707,26209,9989,ITH,ITH3,5,Veneto
2021-01-17,LIG,866,301,565,866,0,ITC,ITC3,7,Liguria
2021-02-14,FVG,1,0,1,0,1,ITH,ITH4,6,Friuli-Venezia Giulia
2021-05-02,ABR,10458,5110,5348,5230,5228,ITF,ITF1,13,Abruzzo
2021-05-25,MAR,11652,5750,5902,8720,2932,ITI,ITI3,11,Marche
2021-05-28,PAB,5682,2895,2787,3792,1890,ITH,ITH1,4,Provincia Autonoma Bolzano / Bozen
2021-01-20,BAS,84,22,62,84,0,ITF,ITF5,17,Basilicata
2021-05-15,UMB,4988,1881,3107,1825,3163,ITI,ITI2,10,Umbria
2021-05-16,MOL,1247,571,676,1065,182,ITF,ITF2,14,Molise
2021-02-17,PAB,156,51,105,139,17,ITH,ITH1,4,Provincia Autonoma Bolzano / Bozen
2021-04-21,EMR,23957,10962,12995,14211,9746,ITH,ITH5,8,Emilia-Romagna
2021-06-01,VEN,26917,13543,13374,16404,10513,ITH,ITH3,5,Veneto
2021-02-22,PUG,9629,4536,5093,9297,332,ITF,ITF4,16,Puglia
2021-05-08,PIE,34290,16272,18018,18649,15641,ITC,ITC1,1,Piemonte
2021-06-03,SAR,16391,7641,8750,10705,5686,ITG,ITG2,20,Sardegna
2021-01-02,CAL,166,94,72,166,0,ITF,ITF6,18,Calabria
2021-01-28,PIE,5591,1809,3782,384,5207,ITC,ITC1,1,Piemonte
2021-05-08,EMR,32343,15094,17249,20921,11422,ITH,ITH5,8,Emilia-Romagna
2021-05-20,LOM,94410,45623,48787,31860,62550,ITC,ITC4,3,Lombardia
2021-03-01,MAR,3752,1506,2246,3504,248,ITI,ITI3,11,Marche
2021-05-10,FVG,7940,3529,4411,6398,1542,ITH,ITH4,6,Friuli-Venezia Giulia
2021-06-20,SAR,6276,2795,3481,3656,2620,ITG,ITG2,20,Sardegna
2021-01-28,EMR,10255,3339,6916,348,9907,ITH,ITH5,8,Emilia-Romagna
2021-03-10,VEN,19039,8727,10312,13356,5683,ITH,ITH3,5,Veneto
2021-02-05,PUG,5635,2273,3362,1333,4302,ITF,ITF4,16,Puglia
2021-03-12,SAR,5982,2623,3359,4674,1308,ITG,ITG2,20,Sardegna
2021-02-14,PIE,1476,498,978,876,600,ITC,ITC1,1,Piemonte
2021-05-16,PUG,24534,11063,13471,12706,11828,ITF,ITF4,16,Puglia
2020-12-31,VDA,18,4,14,18,0,ITC,ITC2,2,Valle d'Aosta / Vallée d'Aoste
2021-01-03,UMB,270,112,158,270,0,ITI,ITI2,10,Umbria
2021-02-20,LOM,9338,3867,5471,9040,298,ITC,ITC4,3,Lombardia
2021-04-25,CAL,15875,8052,7823,14844,1031,ITF,ITF6,18,Calabria
2021-05-05,PUG,39127,17149,21978,24950,14177,ITF,ITF4,16,Puglia
2021-06-06,VDA,1160,582,578,787,373,ITC,ITC2,2,Valle d'Aosta / Vallée d'Aoste
2021-04-23,MAR,11251,5186,6065,8196,3055,ITI,ITI3,11,Marche
2021-05-21,PAT,5051,2421,2630,3340,1711,ITH,ITH2,4,Provincia Autonoma Trento
2021-01-06,TOS,4519,1460,3059,4519,0,ITI,ITI1,9,Toscana
2021-03-10,ABR,5045,1682,3363,4089,956,ITF,ITF1,13,Abruzzo
2021-04-16,LIG,11987,5286,6701,10159,1828,ITC,ITC3,7,Liguria
2021-04-18,LOM,36403,16227,20176,31164,5239,ITC,ITC4,3,Lombardia
2021-04-27,CAM,32158,15625,16533,24237,7921,ITF,ITF3,15,Campania
2021-06-07,VEN,44397,23165,21232,37383,7014,ITH,ITH3,5,Veneto
2021-01-08,LOM,12706,3919,8787,12706,0,ITC,ITC4,3,Lombardia
2021-06-10,PAB,4442,2306,2136,1348,3094,ITH,ITH1,4,Provincia Autonoma Bolzano / Bozen
2021-06-17,PUG,41886,20465,21421,21298,20588,ITF,ITF4,16,Puglia
2021-02-27,VEN,8990,2692,6298,8143,847,ITH,ITH3,5,Veneto
2021-06-23,CAM,45970,21697,24273,10206,35764,ITF,ITF3,15,Campania
2021-01-26,ABR,1542,567,975,30,1512,ITF,ITF1,13,Abruzzo
2021-06-15,VDA,876,479,397,621,255,ITC,ITC2,2,Valle d'Aosta / Vallée d'Aoste
2021-02-09,MOL,359,170,189,197,162,ITF,ITF2,14,Molise
2021-01-06,LIG,1660,616,1044,1660,0,ITC,ITC3,7,Liguria
2021-05-06,ABR,12997,6082,6915,7971,5026,ITF,ITF1,13,Abruzzo
2021-06-30,CAL,16013,7309,8704,6789,9224,ITF,ITF6,18,Calabria
2021-02-15,SIC,3730,1733,1997,3166,564,ITG,ITG1,19,Sicilia
2021-04-13,SAR,7619,3601,4018,5792,1827,ITG,ITG2,20,Sardegna
2021-04-27,EMR,32101,14863,17238,19640,12461,ITH,ITH5,8,Emilia-Romagna
2021-02-08,FVG,2357,694,1663,92,2265,ITH,ITH4,6,Friuli-Venezia Giulia
2021-05-14,PIE,33417,16277,17140,17993,15424,ITC,ITC1,1,Piemonte
2021-05-26,SIC,44527,20867,23660,24091,20436,ITG,ITG1,19,Sicilia
2021-06-09,SAR,15458,7365,8093,11720,3738,ITG,ITG2,20,Sardegna
2021-02-01,PAT,1224,338,886,92,1132,ITH,ITH2,4,Provincia Autonoma Trento
2021-03-11,TOS,15884,6340,9544,12555,3329,ITI,ITI1,9,Toscana
2021-01-03,SIC,4782,2496,2286,4782,0,ITG,ITG1,19,Sicilia
2021-06-19,TOS,26454,13881,12573,21709,4745,ITI,ITI1,9,Toscana
2021-01-01,LAZ,3554,1382,2172,3554,0,ITI,ITI4,12,Lazio
2021-04-13,SIC,19685,9591,10094,10932,8753,ITG,ITG1,19,Sicilia
2021-01-10,LAZ,4043,1702,2341,4043,0,ITI,ITI4,12,Lazio
2021-01-15,CAM,4980,2381,2599,4980,0,ITF,ITF3,15,Campania
2021-03-10,BAS,1680,842,838,841,839,ITF,ITF5,17,Basilicata
2021-06-16,LAZ,63959,30607,33352,32267,31692,ITI,ITI4,12,Lazio
2021-06-21,CAM,45787,22109,23678,10605,35182,ITF,ITF3,15,Campania
2021-06-28,CAL,12999,5961,7038,5186,7813,ITF,ITF6,18,Calabria
2021-03-13,CAM,14518,7038,7480,9236,5282,ITF,ITF3,15,Campania
2021-04-20,LAZ,31085,14276,16809,19785,11300,ITI,ITI4,12,Lazio
2021-04-22,UMB,5444,2246,3198,2780,2664,ITI,ITI2,10,Umbria
2021-03-04,VEN,12980,4884,8096,9508,3472,ITH,ITH3,5,Veneto
2021-04-26,PAB,1543,771,772,1538,5,ITH,ITH1,4,Provincia Autonoma Bolzano / Bozen
2021-01-26,BAS,800,353,447,101,699,ITF,ITF5,17,Basilicata
2021-02-23,MAR,3300,1419,1881,3244,56,ITI,ITI3,11,Marche
2021-03-05,VDA,275,124,151,53,222,ITC,ITC2,2,Valle d'Aosta / Vallée d'Aoste
2021-03-08,LAZ,20856,9040,11816,15583,5273,ITI,ITI4,12,Lazio
2021-05-06,BAS,5052,2435,2617,3483,1569,ITF,ITF5,17,Basilicata
2021-03-20,CAL,6712,3074,3638,4200,2512,ITF,ITF6,18,Calabria
2021-03-22,CAM,13180,6343,6837,11140,2040,ITF,ITF3,15,Campania
2021-05-15,BAS,6529,3344,3185,3958,2571,ITF,ITF5,17,Basilicata
2021-03-30,PUG,12349,5913,6436,6442,5907,ITF,ITF4,16,Puglia
2021-06-13,FVG,8642,4498,4144,5322,3320,ITH,ITH4,6,Friuli-Venezia Giulia
2021-02-01,PUG,3966,1660,2306,373,3593,ITF,ITF4,16,Puglia
2021-02-07,CAM,2929,1382,1547,2158,771,ITF,ITF3,15,Campania
2021-04-02,BAS,2317,1046,1271,1713,604,ITF,ITF5,17,Basilicata
2021-06-28,LIG,11283,5423,5860,7224,4059,ITC,ITC3,7,Liguria
2021-02-03,PAT,847,315,532,414,433,ITH,ITH2,4,Provincia Autonoma Trento
2021-02-04,BAS,1098,442,656,63,1035,ITF,ITF5,17,Basilicata
2021-04-17,FVG,7452,3234,4218,5969,1483,ITH,ITH4,6,Friuli-Venezia Giulia
2021-05-06,EMR,35927,16602,19325,22871,13056,ITH,ITH5,8,Emilia-Romagna
2021-01-10,SIC,3534,1578,1956,3534,0,ITG,ITG1,19,Sicilia
2021-01-26,EMR,8334,3000,5334,214,8120,ITH,ITH5,8,Emilia-Romagna
2021-02-05,TOS,5749,2245,3504,1924,3825,ITI,ITI1,9,Toscana
2021-04-09,ABR,8924,4226,4698,6385,2539,ITF,ITF1,13,Abruzzo
2021-04-22,LAZ,38866,19227,19639,24252,14614,ITI,ITI4,12,Lazio
2021-01-15,MAR,1771,500,1271,1771,0,ITI,ITI3,11,Marche
2021-04-17,UMB,6675,3068,3607,5335,1340,ITI,ITI2,10,Umbria
2021-05-23,PAT,1955,993,962,447,1508,ITH,ITH2,4,Provincia Autonoma Trento
2021-03-20,LIG,2316,995,1321,1142,1174,ITC,ITC3,7,Liguria
2021-03-24,EMR,21219,9401,11818,13837,7382,ITH,ITH5,8,Emilia-Romagna
2021-05-16,TOS,26661,12880,13781,24202,2459,ITI,ITI1,9,Toscana
2021-02-28,VDA,260,86,174,77,183,ITC,ITC2,2,Valle d'Aosta / Vallée d'Aoste
2021-03-10,LAZ,23328,10652,12676,17681,5647,ITI,ITI4,12,Lazio
2021-03-11,MOL,1465,637,828,1459,6,ITF,ITF2,14,Molise
2021-04-10,PAT,2823,1321,1502,2028,795,ITH,ITH2,4,Provincia Autonoma Trento
2021-05-11,VEN,33150,16495,16655,28432,4718,ITH,ITH3,5,Veneto
2021-06-30,CAM,46029,21916,24113,17646,28383,ITF,ITF3,15,Campania
2021-01-12,LAZ,5413,1981,3432,5413,0,ITI,ITI4,12,Lazio
2021-01-15,LOM,25219,7433,17786,25219,0,ITC,ITC4,3,Lombardia
2021-03-15,CAL,3582,1711,1871,2135,1447,ITF,ITF6,18,Calabria
2021-06-18,LAZ,63730,30615,33115,30708,33022,ITI,ITI4,12,Lazio
2021-01-18,PAB,1772,687,1085,1767,5,ITH,ITH1,4,Provincia Autonoma Bolzano / Bozen
2021-05-14,PUG,44899,20520,24379,28784,16115,ITF,ITF4,16,Puglia
2021-02-02,BAS,367,143,224,175,192,ITF,ITF5,17,Basilicata
2021-04-17,PIE,30461,14147,16314,27145,3316,ITC,ITC1,1,Piemonte
2021-01-22,VEN,1080,332,748,25,1055,ITH,ITH3,5,Veneto
2021-01-06,MOL,689,260,429,689,0,ITF,ITF2,14,Molise
2021-04-29,LOM,115508,53585,61923,85666,29842,ITC,ITC4,3,Lombardia
2021-06-13,PIE,37867,19993,17874,33736,4131,ITC,ITC1,1,Piemonte
2021-04-02,ABR,6694,3102,3592,5207,1487,ITF,ITF1,13,Abruzzo
2021-04-25,MAR,8600,3993,4607,7025,1575,ITI,ITI3,11,Marche
2021-04-16,MOL,2430,1033,1397,1198,1232,ITF,ITF2,14,Molise
2021-05-05,VDA,1038,566,472,456,582,ITC,ITC2,2,Valle d'Aosta / Vallée d'Aoste
2021-06-25,LOM,104088,54099,49989,76730,27358,ITC,ITC4,3,Lombardia
2021-01-24,EMR,2443,885,1558,298,2145,ITH,ITH5,8,Emilia-Romagna
2021-02-04,ABR,1682,616,1066,610,1072,ITF,ITF1,13,Abruzzo
2021-03-08,SAR,4680,2426,2254,3459,1221,ITG,ITG2,20,Sardegna
2021-05-20,CAL,16907,8439,8468,11301,5606,ITF,ITF6,18,Calabria
2021-01-05,SIC,10324,5072,5252,10324,0,ITG,ITG1,19,Sicilia
2021-02-10,PIE,7535,2371,5164,1316,6219,ITC,ITC1,1,Piemonte
2021-04-09,BAS,1150,350,800,1087,63,ITF,ITF5,17,Basilicata
2021-05-04,SAR,9543,4388,5155,7690,1853,ITG,ITG2,20,Sardegna
2021-04-10,FVG,5047,2212,2835,3822,1225,ITH,ITH4,6,Friuli-Venezia Giulia
2021-06-30,LIG,14659,6937,7722,8336,6323,ITC,ITC3,7,Liguria
2021-01-05,UMB,854,429,425,854,0,ITI,ITI2,10,Umbria
2021-01-24,SAR,90,34,56,5,85,ITG,ITG2,20,Sardegna
2021-04-08,PIE,25153,10935,14218,20423,4730,ITC,ITC1,1,Piemonte
2021-04-15,SIC,21039,10247,10792,11744,9295,ITG,ITG1,19,Sicilia
2021-05-11,TOS,27938,12977,14961,12480,15458,ITI,ITI1,9,Toscana
2021-04-20,LOM,67656,30831,36825,57318,10338,ITC,ITC4,3,Lombardia
2021-06-21,MOL,2900,1350,1550,1669,1231,ITF,ITF2,14,Molise
2021-05-23,FVG,10274,4855,5419,6124,4150,ITH,ITH4,6,Friuli-Venezia Giulia
2021-01-10,LOM,10517,3959,6558,10517,0,ITC,ITC4,3,Lombardia
2021-04-25,MOL,792,395,397,559,233,ITF,ITF2,14,Molise
2021-01-15,LIG,2257,755,1502,2257,0,ITC,ITC3,7,Liguria
2021-01-17,LOM,8349,3346,5003,8148,201,ITC,ITC4,3,Lombardia
2021-02-07,CAL,859,428,431,148,711,ITF,ITF6,18,Calabria
2021-03-13,TOS,9288,3310,5978,5324,3964,ITI,ITI1,9,Toscana
2021-03-17,LAZ,13811,5914,7897,7555,6256,ITI,ITI4,12,Lazio
2021-06-23,LOM,107968,55908,52060,76627,31341,ITC,ITC4,3,Lombardia
2021-03-15,LOM,31550,11327,20223,23035,8515,ITC,ITC4,3,Lombardia
2021-04-25,LIG,1936,921,1015,1521,415,ITC,ITC3,7,Liguria
2021-05-18,CAL,15279,7638,7641,11864,3415,ITF,ITF6,18,Calabria
2021-06-25,LAZ,61368,29308,32060,28320,33048,ITI,ITI4,12,Lazio
2021-05-04,VEN,42921,20328,22593,34895,8026,ITH,ITH3,5,Veneto
2021-06-20,SIC,32885,15560,17325,14917,17968,ITG,ITG1,19,Sicilia
2021-01-25,PUG,3828,1680,2148,425,3403,ITF,ITF4,16,Puglia
2021-01-13,MAR,2106,746,1360,2106,0,ITI,ITI3,11,Marche
2021-02-10,PAT,853,291,562,511,342,ITH,ITH2,4,Provincia Autonoma Trento
2021-03-13,LIG,3849,1637,2212,2994,855,ITC,ITC3,7,Liguria
2021-05-03,VDA,839,400,439,488,351,ITC,ITC2,2,Valle d'Aosta / Vallée d'Aoste
2021-06-18,SAR,16478,7504,8974,8714,7764,ITG,ITG2,20,Sardegna
2021-05-02,MAR,8900,3937,4963,3161,5739,ITI,ITI3,11,Marche
2021-03-10,SAR,6052,2955,3097,5202,850,ITG,ITG2,20,Sardegna
2021-01-17,CAM,1155,551,604,702,453,ITF,ITF3,15,Campania
2021-01-29,TOS,6144,1700,4444,304,5840,ITI,ITI1,9,Toscana
2021-03-22,CAL,4942,2319,2623,3183,1759,ITF,ITF6,18,Calabria
2021-04-10,PIE,30192,13428,16764,25914,4278,ITC,ITC1,1,Piemonte
2021-05-06,SAR,12953,6013,6940,9805,3148,ITG,ITG2,20,Sardegna
2021-05-07,PAB,4193,2061,2132,3665,528,ITH,ITH1,4,Provincia Autonoma Bolzano / Bozen
2021-01-24,VEN,4117,1219,2898,28,4089,ITH,ITH3,5,Veneto
2021-03-15,CAM,13342,6489,6853,8597,4745,ITF,ITF3,15,Campania
2021-06-20,UMB,6208,3000,3208,1580,4628,ITI,ITI2,10,Umbria
2021-03-07,VDA,64,30,34,11,53,ITC,ITC2,2,Valle d'Aosta / Vallée d'Aoste
2021-05-09,TOS,22521,9763,12758,9665,12856,ITI,ITI1,9,Toscana
2021-04-24,UMB,4558,1960,2598,3377,1181,ITI,ITI2,10,Umbria
2021-06-28,MAR,12146,5912,6234,4700,7446,ITI,ITI3,11,Marche
2021-01-13,MOL,474,160,314,474,0,ITF,ITF2,14,Molise
2021-06-19,MOL,2326,1156,1170,1316,1010,ITF,ITF2,14,Molise
2021-05-05,PAB,4154,1945,2209,2038,2116,ITH,ITH1,4,Provincia Autonoma Bolzano / Bozen
2021-06-27,LAZ,47000,21461,25539,21021,25979,ITI,ITI4,12,Lazio
2021-04-23,MOL,2050,882,1168,1391,659,ITF,ITF2,14,Molise
2021-01-17,EMR,2890,887,2003,2644,246,ITH,ITH5,8,Emilia-Romagna
2021-01-25,PAB,487,183,304,3,484,ITH,ITH1,4,Provincia Autonoma Bolzano / Bozen
2021-03-01,SAR,2267,1155,1112,1608,659,ITG,ITG2,20,Sardegna
2021-06-23,LIG,14064,6730,7334,9591,4473,ITC,ITC3,7,Liguria
2021-01-12,UMB,834,247,587,834,0,ITI,ITI2,10,Umbria
2021-04-22,SIC,26756,12639,14117,20298,6458,ITG,ITG1,19,Sicilia
2021-04-04,ABR,1631,767,864,1502,129,ITF,ITF1,13,Abruzzo
2021-04-08,PAT,3138,1315,1823,2019,1119,ITH,ITH2,4,Provincia Autonoma Trento
2021-03-10,SIC,13861,6059,7802,11678,2183,ITG,ITG1,19,Sicilia
2021-04-15,PIE,29648,13582,16066,24162,5486,ITC,ITC1,1,Piemonte
2021-03-23,PAB,1555,760,795,1554,1,ITH,ITH1,4,Provincia Autonoma Bolzano / Bozen
2021-01-05,PIE,5381,1603,3778,5381,0,ITC,ITC1,1,Piemonte
2021-01-12,SIC,4326,2120,2206,4326,0,ITG,ITG1,19,Sicilia
2021-04-27,LOM,85994,39971,46023,69446,16548,ITC,ITC4,3,Lombardia
2021-06-18,SIC,42983,19871,23112,18723,24260,ITG,ITG1,19,Sicilia
2021-03-14,UMB,66,48,18,66,0,ITI,ITI2,10,Umbria
2021-04-07,VEN,36006,16182,19824,28668,7338,ITH,ITH3,5,Veneto
2021-06-27,SIC,24871,11974,12897,11925,12946,ITG,ITG1,19,Sicilia
2021-01-07,FVG,2093,718,1375,2093,0,ITH,ITH4,6,Friuli-Venezia Giulia
2021-02-14,LIG,233,122,111,233,0,ITC,ITC3,7,Liguria
2021-04-02,EMR,23394,10552,12842,18913,4481,ITH,ITH5,8,Emilia-Romagna
2021-02-27,BAS,1993,861,1132,1829,164,ITF,ITF5,17,Basilicata
2021-06-22,UMB,8009,4060,3949,5237,2772,ITI,ITI2,10,Umbria
2021-03-05,FVG,3772,1511,2261,2698,1074,ITH,ITH4,6,Friuli-Venezia Giulia
2021-05-25,LIG,14110,6866,7244,10930,3180,ITC,ITC3,7,Liguria
2021-05-29,EMR,37797,16486,21311,17155,20642,ITH,ITH5,8,Emilia-Romagna
2021-05-15,SIC,56470,26386,30084,41235,15235,ITG,ITG1,19,Sicilia
2021-03-19,SIC,16215,7985,8230,10734,5481,ITG,ITG1,19,Sicilia
2021-06-16,ABR,10705,5354,5351,8045,2660,ITF,ITF1,13,Abruzzo
2021-01-30,VDA,439,202,237,14,425,ITC,ITC2,2,Valle d'Aosta / Vallée d'Aoste
2021-06-30,MOL,2897,1376,1521,931,1966,ITF,ITF2,14,Molise
2021-01-31,VEN,4769,1563,3206,391,4378,ITH,ITH3,5,Veneto
2021-05-27,CAM,72914,35351,37563,26383,46531,ITF,ITF3,15,Campania
2021-06-22,PIE,40387,19930,20457,18207,22180,ITC,ITC1,1,Piemonte
2021-02-16,CAM,5439,2411,3028,4668,771,ITF,ITF3,15,Campania
2021-03-29,VEN,31447,13693,17754,27629,3818,ITH,ITH3,5,Veneto
2021-02-04,LAZ,6336,2505,3831,1021,5315,ITI,ITI4,12,Lazio
2021-04-01,PAB,2786,1407,1379,2642,144,ITH,ITH1,4,Provincia Autonoma Bolzano / Bozen
2021-04-08,PUG,17469,7580,9889,11292,6177,ITF,ITF4,16,Puglia
2020-12-31,PAT,1625,449,1176,1625,0,ITH,ITH2,4,Provincia Autonoma Trento
2021-06-07,BAS,4234,1918,2316,3918,316,ITF,ITF5,17,Basilicata
2021-04-11,BAS,849,330,519,785,64,ITF,ITF5,17,Basilicata
2021-05-13,SAR,12384,5864,6520,8938,3446,ITG,ITG2,20,Sardegna
2021-04-19,FVG,6711,3133,3578,3295,3416,ITH,ITH4,6,Friuli-Venezia Giulia
2021-02-02,SAR,1498,669,829,257,1241,ITG,ITG2,20,Sardegna
2021-01-09,FVG,2513,841,1672,2513,0,ITH,ITH4,6,Friuli-Venezia Giulia
2021-02-27,ABR,2813,1339,1474,2547,266,ITF,ITF1,13,Abruzzo
2021-03-22,MAR,5653,2376,3277,2524,3129,ITI,ITI3,11,Marche
2021-06-15,FVG,11742,5935,5807,5302,6440,ITH,ITH4,6,Friuli-Venezia Giulia
2021-01-07,PIE,5387,1739,3648,5387,0,ITC,ITC1,1,Piemonte
2021-03-12,UMB,2694,1081,1613,2199,495,ITI,ITI2,10,Umbria
2021-06-06,PUG,30530,15368,15162,25499,5031,ITF,ITF4,16,Puglia
2021-02-09,CAL,2158,912,1246,956,1202,ITF,ITF6,18,Calabria
2021-03-05,PIE,15376,6060,9316,11558,3818,ITC,ITC1,1,Piemonte
2021-05-20,TOS,29728,13884,15844,18918,10810,ITI,ITI1,9,Toscana
2021-06-22,PAT,6179,3374,2805,3645,2534,ITH,ITH2,4,Provincia Autonoma Trento
2021-04-10,PUG,30881,13097,17784,26657,4224,ITF,ITF4,16,Puglia
2021-01-25,VDA,147,65,82,0,147,ITC,ITC2,2,Valle d'Aosta / Vallée d'Aoste
2021-03-17,LOM,26257,10495,15762,15258,10999,ITC,ITC4,3,Lombardia
2021-03-22,LIG,7745,3467,4278,4808,2937,ITC,ITC3,7,Liguria
2021-05-22,CAM,67947,32504,35443,46464,21483,ITF,ITF3,15,Campania
2021-01-31,TOS,3050,1129,1921,106,2944,ITI,ITI1,9,Toscana
2021-05-13,VEN,44225,21825,22400,34340,9885,ITH,ITH3,5,Veneto
2021-05-29,CAL,19251,8941,10310,9401,9850,ITF,ITF6,18,Calabria
2021-02-02,VEN,6511,1880,4631,396,6115,ITH,ITH3,5,Veneto
2021-03-13,MOL,1189,594,595,200,989,ITF,ITF2,14,Molise
2021-01-24,MAR,881,339,542,5,876,ITI,ITI3,11,Marche
2021-02-07,LIG,407,153,254,2,405,ITC,ITC3,7,Liguria
2021-03-07,FVG,2545,932,1613,2544,1,ITH,ITH4,6,Friuli-Venezia Giulia
2021-06-07,ABR,10994,5243,5751,9178,1816,ITF,ITF1,13,Abruzzo
2021-06-30,MAR,13630,6657,6973,4658,8972,ITI,ITI3,11,Marche
2021-01-15,MOL,538,242,296,538,0,ITF,ITF2,14,Molise
2021-04-11,ABR,5330,2606,2724,4847,483,ITF,ITF1,13,Abruzzo
2021-05-04,MAR,10923,4822,6101,5024,5899,ITI,ITI3,11,Marche
2021-05-18,LIG,13460,6117,7343,10168,3292,ITC,ITC3,7,Liguria
2021-05-30,PAB,4760,2514,2246,752,4008,ITH,ITH1,4,Provincia Autonoma Bolzano / Bozen
2021-03-05,PAT,2247,703,1544,1681,566,ITH,ITH2,4,Provincia Autonoma Trento
2021-03-12,SIC,12772,5491,7281,10777,1995,ITG,ITG1,19,Sicilia
2021-06-09,ABR,11423,6022,5401,9745,1678,ITF,ITF1,13,Abruzzo
2021-05-15,SAR,13795,6426,7369,10361,3434,ITG,ITG2,20,Sardegna
2021-01-07,PAT,1271,310,961,1271,0,ITH,ITH2,4,Provincia Autonoma Trento
2021-05-14,VDA,960,442,518,291,669,ITC,ITC2,2,Valle d'Aosta / Vallée d'Aoste
2020-12-31,FVG,1053,384,669,1053,0,ITH,ITH4,6,Friuli-Venezia Giulia
2021-04-05,TOS,15285,6826,8459,14548,737,ITI,ITI1,9,Toscana
2021-06-15,PIE,38846,20002,18844,27087,11759,ITC,ITC1,1,Piemonte
2021-03-21,UMB,675,338,337,675,0,ITI,ITI2,10,Umbria
2021-03-31,VEN,38812,16388,22424,31317,7495,ITH,ITH3,5,Veneto
2021-02-07,TOS,2806,952,1854,886,1920,ITI,ITI1,9,Toscana
2021-03-07,PIE,11977,4658,7319,11099,878,ITC,ITC1,1,Piemonte
2021-04-03,PAB,831,364,467,21,810,ITH,ITH1,4,Provincia Autonoma Bolzano / Bozen
2021-06-29,UMB,9835,5007,4828,4170,5665,ITI,ITI2,10,Umbria
2021-03-25,PAB,2150,1063,1087,1707,443,ITH,ITH1,4,Provincia Autonoma Bolzano / Bozen
2021-04-14,CAL,8060,3891,4169,6615,1445,ITF,ITF6,18,Calabria
2021-05-22,LAZ,55098,26991,28107,44417,10681,ITI,ITI4,12,Lazio
2021-04-04,BAS,610,225,385,197,413,ITF,ITF5,17,Basilicata
2021-02-16,CAL,1739,735,1004,1460,279,ITF,ITF6,18,Calabria
2021-06-23,MOL,2787,1284,1503,230,2557,ITF,ITF2,14,Molise
2021-05-17,UMB,6367,3060,3307,4190,2177,ITI,ITI2,10,Umbria
2021-04-01,PUG,13924,6536,7388,7577,6347,ITF,ITF4,16,Puglia
2021-01-14,UMB,722,192,530,722,0,ITI,ITI2,10,Umbria
2021-03-20,MAR,4138,1741,2397,1048,3090,ITI,ITI3,11,Marche
2021-04-17,PAT,2231,1139,1092,2174,57,ITH,ITH2,4,Provincia Autonoma Trento
2020-12-31,PIE,3909,1334,2575,3909,0,ITC,ITC1,1,Piemonte
2021-01-26,SAR,1336,453,883,27,1309,ITG,ITG2,20,Sardegna
2021-01-27,PAB,84,28,56,1,83,ITH,ITH1,4,Provincia Autonoma Bolzano / Bozen
2021-02-03,PUG,5037,2005,3032,729,4308,ITF,ITF4,16,Puglia
2021-03-31,EMR,25266,11043,14223,19810,5456,ITH,ITH5,8,Emilia-Romagna
2021-01-22,MAR,488,168,320,194,294,ITI,ITI3,11,Marche
2021-06-17,FVG,11266,5691,5575,2287,8979,ITH,ITH4,6,Friuli-Venezia Giulia
2021-02-01,VDA,404,127,277,87,317,ITC,ITC2,2,Valle d'Aosta / Vallée d'Aoste
2021-03-19,UMB,1740,565,1175,1084,656,ITI,ITI2,10,Umbria
2021-04-19,PAT,2625,1235,1390,2603,22,ITH,ITH2,4,Provincia Autonoma Trento
2021-03-30,VDA,402,223,179,382,20,ITC,ITC2,2,Valle d'Aosta / Vallée d'Aoste
2021-03-24,CAM,17921,8368,9553,14963,2958,ITF,ITF3,15,Campania
2021-05-20,LIG,12856,5968,6888,8831,4025,ITC,ITC3,7,Liguria
2021-05-27,CAL,17617,8695,8922,9838,7779,ITF,ITF6,18,Calabria
2021-05-15,LAZ,57334,27393,29941,40824,16510,ITI,ITI4,12,Lazio
2021-05-20,CAM,60799,28119,32680,43175,17624,ITF,ITF3,15,Campania
2021-06-29,SIC,30532,14270,16262,15374,15158,ITG,ITG1,19,Sicilia
2021-05-12,VDA,1140,549,591,470,670,ITC,ITC2,2,Valle d'Aosta / Vallée d'Aoste
2021-06-15,PAT,6238,3281,2957,1723,4515,ITH,ITH2,4,Provincia Autonoma Trento
2021-02-09,CAM,4643,2202,2441,4391,252,ITF,ITF3,15,Campania
2021-03-06,ABR,4177,1358,2819,3607,570,ITF,ITF1,13,Abruzzo
2021-03-19,LAZ,17411,7535,9876,11083,6328,ITI,ITI4,12,Lazio
2021-03-20,MOL,2321,968,1353,1000,1321,ITF,ITF2,14,Molise
2021-03-24,LOM,43235,15607,27628,31357,11878,ITC,ITC4,3,Lombardia
2021-05-18,TOS,28830,14267,14563,20009,8821,ITI,ITI1,9,Toscana
2021-06-28,MOL,2880,1342,1538,1010,1870,ITF,ITF2,14,Molise
2021-05-29,CAM,67796,32250,35546,43940,23856,ITF,ITF3,15,Campania
2021-02-09,LOM,12213,3332,8881,4037,8176,ITC,ITC4,3,Lombardia
2021-03-26,EMR,23703,10110,13593,17266,6437,ITH,ITH5,8,Emilia-Romagna
2021-05-08,SAR,13090,5972,7118,10800,2290,ITG,ITG2,20,Sardegna
2021-06-22,FVG,11313,5842,5471,2273,9040,ITH,ITH4,6,Friuli-Venezia Giulia
