data_somministrazione,area,totale,sesso_maschile,sesso_femminile,prima_dose,seconda_dose,codice_NUTS1,codice_NUTS2,codice_regione_ISTAT,nome_area
2021-02-07,MOL,66,32,34,19,47,ITF,ITF2,14,Molise
2021-05-18,MOL,1645,877,768,990,655,ITF,ITF2,14,Molise
2021-05-19,PIE,33079,15266,17813,21999,11080,ITC,ITC1,1,Piemonte
2021-02-13,SIC,2976,1122,1854,2721,255,ITG,ITG1,19,Sicilia
2021-05-24,LOM,89509,43536,45973,49515,39994,ITC,ITC4,3,Lombardia
2021-03-22,MOL,1148,440,708,905,243,ITF,ITF2,14,Molise
2021-02-18,EMR,7038,2892,4146,6455,583,ITH,ITH5,8,Emilia-Romagna
2021-05-04,BAS,4137,1991,2146,3614,523,ITF,ITF5,17,Basilicata
2021-03-14,PIE,8205,3336,4869,5308,2897,ITC,ITC1,1,Piemonte
2021-04-09,SAR,12323,5492,6831,7971,4352,ITG,ITG2,20,Sardegna
2021-03-08,BAS,1457,710,747,845,612,ITF,ITF5,17,Basilicata
2021-05-10,PIE,28901,13945,14956,15806,13095,ITC,ITC1,1,Piemonte
2021-06-06,PAB,4526,2175,2351,853,3673,ITH,ITH1,4,Provincia Autonoma Bolzano / Bozen
2021-05-24,SIC,35858,17461,18397,15710,20148,ITG,ITG1,19,Sicilia
2021-01-30,PIE,5980,2136,3844,218,5762,ITC,ITC1,1,Piemonte
2021-02-26,PAB,1526,551,975,1496,30,ITH,ITH1,4,Provincia Autonoma Bolzano / Bozen
2021-03-05,PUG,17951,7408,10543,15647,2304,ITF,ITF4,16,Puglia
2021-02-11,LOM,17032,5000,12032,9694,7338,ITC,ITC4,3,Lombardia
2021-04-07,TOS,35969,15608,20361,28720,7249,ITI,ITI1,9,Toscana
2021-01-06,CAL,930,502,428,930,0,ITF,ITF6,18,Calabria
2021-02-26,PUG,13752,5047,8705,12718,1034,ITF,ITF4,16,Puglia
2020-12-31,PUG,1634,782,852,1634,0,ITF,ITF4,16,Puglia
2021-02-16,LIG,2425,956,1469,2004,421,ITC,ITC3,7,Liguria
2021-03-16,FVG,3153,1287,1866,1073,2080,ITH,ITH4,6,Friuli-Venezia Giulia
2021-05-12,FVG,10810,5005,5805,9411,1399,ITH,ITH4,6,Friuli-Venezia Giulia
2021-05-27,LIG,17742,9353,8389,13322,4420,ITC,ITC3,7,Liguria
2021-02-25,VEN,7899,3339,4560,7294,605,ITH,ITH3,5,Veneto
2021-03-09,PAT,1582,590,992,938,644,ITH,ITH2,4,Provincia Autonoma Trento
2021-03-23,UMB,3797,1685,2112,2168,1629,ITI,ITI2,10,Umbria
2021-05-04,ABR,10749,5050,5699,7133,3616,ITF,ITF1,13,Abruzzo
2021-05-17,LAZ,44005,20123,23882,35496,8509,ITI,ITI4,12,Lazio
2021-05-27,MAR,13729,6816,6913,9429,4300,ITI,ITI3,11,Marche
2021-06-07,EMR,40232,20657,19575,34025,6207,ITH,ITH5,8,Emilia-Romagna
2021-02-11,CAM,6279,2704,3575,6213,66,ITF,ITF3,15,Campania
2021-03-08,ABR,5176,1719,3457,4205,971,ITF,ITF1,13,Abruzzo
2021-03-31,MAR,7375,3086,4289,4351,3024,ITI,ITI3,11,Marche
2021-04-14,LIG,13067,5666,7401,10864,2203,ITC,ITC3,7,Liguria
2021-02-03,VDA,351,114,237,14,337,ITC,ITC2,2,Valle d'Aosta / Vallée d'Aoste
2021-04-09,VEN,31182,13776,17406,22845,8337,ITH,ITH3,5,Veneto
2021-04-16,CAL,10299,5008,5291,8643,1656,ITF,ITF6,18,Calabria
2021-06-01,PAB,3549,2310,1239,2078,1471,ITH,ITH1,4,Provincia Autonoma Bolzano / Bozen
2021-02-08,UMB,637,203,434,88,549,ITI,ITI2,10,Umbria
2021-04-11,SAR,5394,2443,2951,4274,1120,ITG,ITG2,20,Sardegna
2021-02-18,CAL,1821,824,997,1595,226,ITF,ITF6,18,Calabria
2021-04-01,VDA,776,394,382,764,12,ITC,ITC2,2,Valle d'Aosta / Vallée d'Aoste
2021-06-05,VEN,46628,24019,22609,38636,7992,ITH,ITH3,5,Veneto
2021-01-24,ABR,50,22,28,6,44,ITF,ITF1,13,Abruzzo
2021-02-06,LAZ,6137,2475,3662,817,5320,ITI,ITI4,12,Lazio
2021-03-16,PIE,10523,4269,6254,4463,6060,ITC,ITC1,1,Piemonte
2021-05-19,UMB,9396,4199,5197,5651,3745,ITI,ITI2,10,Umbria
2021-06-07,SAR,12554,6138,6416,9556,2998,ITG,ITG2,20,Sardegna
2021-06-08,PUG,38256,18624,19632,20937,17319,ITF,ITF4,16,Puglia
2021-05-12,PIE,31841,15166,16675,18979,12862,ITC,ITC1,1,Piemonte
2021-02-19,PAB,2252,512,1740,2241,11,ITH,ITH1,4,Provincia Autonoma Bolzano / Bozen
2021-05-29,LIG,6839,3236,3603,3971,2868,ITC,ITC3,7,Liguria
2021-05-31,LOM,95643,47429,48214,79472,16171,ITC,ITC4,3,Lombardia
2021-02-04,SAR,2271,816,1455,916,1355,ITG,ITG2,20,Sardegna
2021-03-01,ABR,3479,1386,2093,2727,752,ITF,ITF1,13,Abruzzo
2021-04-02,SAR,8991,3549,5442,5748,3243,ITG,ITG2,20,Sardegna
2021-02-06,UMB,396,138,258,34,362,ITI,ITI2,10,Umbria
2021-03-14,PAT,107,65,42,20,87,ITH,ITH2,4,Provincia Autonoma Trento
2021-05-17,SIC,31905,15376,16529,19228,12677,ITG,ITG1,19,Sicilia
2021-03-21,SIC,15218,7341,7877,11248,3970,ITG,ITG1,19,Sicilia
2021-04-16,TOS,28954,12888,16066,22046,6908,ITI,ITI1,9,Toscana
2021-03-26,LOM,41277,15728,25549,28208,13069,ITC,ITC4,3,Lombardia
2021-01-04,CAL,1052,517,535,1052,0,ITF,ITF6,18,Calabria
2021-02-06,SIC,4685,2088,2597,1464,3221,ITG,ITG1,19,Sicilia
2021-05-22,LOM,70497,33804,36693,32403,38094,ITC,ITC4,3,Lombardia
2021-02-11,LAZ,6999,3013,3986,6467,532,ITI,ITI4,12,Lazio
2021-05-20,MOL,2660,1370,1290,2474,186,ITF,ITF2,14,Molise
2021-02-09,LIG,1936,689,1247,256,1680,ITC,ITC3,7,Liguria
2021-04-11,LAZ,19124,8439,10685,13243,5881,ITI,ITI4,12,Lazio
2021-04-16,CAM,34308,16555,17753,23646,10662,ITF,ITF3,15,Campania
2021-05-19,FVG,11890,5833,6057,9553,2337,ITH,ITH4,6,Friuli-Venezia Giulia
2021-06-09,BAS,4415,2065,2350,3991,424,ITF,ITF5,17,Basilicata
2021-04-23,CAL,12924,6346,6578,9446,3478,ITF,ITF6,18,Calabria
2021-01-06,CAM,7652,3749,3903,7652,0,ITF,ITF3,15,Campania
2021-02-13,LAZ,6609,2626,3983,6194,415,ITI,ITI4,12,Lazio
2021-04-13,BAS,2113,1051,1062,1295,818,ITF,ITF5,17,Basilicata
2021-05-29,LOM,88111,42326,45785,42105,46006,ITC,ITC4,3,Lombardia
2021-02-18,LOM,14027,4916,9111,13012,1015,ITC,ITC4,3,Lombardia
2021-03-07,PAT,22,6,16,22,0,ITH,ITH2,4,Provincia Autonoma Trento
2021-03-01,BAS,547,284,263,381,166,ITF,ITF5,17,Basilicata
2021-03-29,MAR,5860,2567,3293,3435,2425,ITI,ITI3,11,Marche
2021-01-09,PAT,190,40,150,190,0,ITH,ITH2,4,Provincia Autonoma Trento
2021-01-13,CAL,2039,1026,1013,2039,0,ITF,ITF6,18,Calabria
2021-02-24,VDA,183,82,101,164,19,ITC,ITC2,2,Valle d'Aosta / Vallée d'Aoste
2021-05-31,EMR,29801,13822,15979,18238,11563,ITH,ITH5,8,Emilia-Romagna
2021-03-14,FVG,1397,549,848,1145,252,ITH,ITH4,6,Friuli-Venezia Giulia
2021-02-04,SIC,6692,3044,3648,1451,5241,ITG,ITG1,19,Sicilia
2021-02-20,EMR,5318,2094,3224,5055,263,ITH,ITH5,8,Emilia-Romagna
2021-03-02,TOS,10598,3798,6800,7154,3444,ITI,ITI1,9,Toscana
2021-04-04,SAR,1,0,1,0,1,ITG,ITG2,20,Sardegna
2021-01-04,TOS,5065,1894,3171,5065,0,ITI,ITI1,9,Toscana
2021-04-08,VDA,584,282,302,441,143,ITC,ITC2,2,Valle d'Aosta / Vallée d'Aoste
2021-05-24,LAZ,44614,20820,23794,34170,10444,ITI,ITI4,12,Lazio
2021-05-26,UMB,9636,4564,5072,8384,1252,ITI,ITI2,10,Umbria
2021-03-08,VDA,482,231,251,237,245,ITC,ITC2,2,Valle d'Aosta / Vallée d'Aoste
2021-04-23,UMB,6610,2786,3824,3489,3121,ITI,ITI2,10,Umbria
2021-05-12,EMR,38853,18273,20580,29212,9641,ITH,ITH5,8,Emilia-Romagna
2021-02-25,UMB,1336,497,839,1284,52,ITI,ITI2,10,Umbria
2021-05-04,VDA,1135,510,625,462,673,ITC,ITC2,2,Valle d'Aosta / Vallée d'Aoste
2021-02-01,EMR,10321,3611,6710,362,9959,ITH,ITH5,8,Emilia-Romagna
2021-03-11,UMB,3625,1755,1870,2619,1006,ITI,ITI2,10,Umbria
2021-01-28,TOS,6282,1882,4400,354,5928,ITI,ITI1,9,Toscana
2021-05-01,MOL,2647,1268,1379,424,2223,ITF,ITF2,14,Molise
2021-01-13,UMB,450,139,311,450,0,ITI,ITI2,10,Umbria
2021-03-05,MOL,1219,649,570,1015,204,ITF,ITF2,14,Molise
2021-05-31,PAT,4697,2165,2532,1673,3024,ITH,ITH2,4,Provincia Autonoma Trento
2021-01-30,CAM,10721,5079,5642,38,10683,ITF,ITF3,15,Campania
2021-03-25,BAS,1884,602,1282,1538,346,ITF,ITF5,17,Basilicata
2021-02-06,CAL,2909,1338,1571,443,2466,ITF,ITF6,18,Calabria
2021-01-27,BAS,411,175,236,113,298,ITF,ITF5,17,Basilicata
2021-04-17,MOL,3054,1501,1553,1568,1486,ITF,ITF2,14,Molise
2021-02-10,BAS,548,238,310,496,52,ITF,ITF5,17,Basilicata
2021-03-14,LIG,1659,752,907,1055,604,ITC,ITC3,7,Liguria
2021-04-11,FVG,3433,1520,1913,2527,906,ITH,ITH4,6,Friuli-Venezia Giulia
2021-01-12,MAR,1227,413,814,1227,0,ITI,ITI3,11,Marche
2021-05-21,BAS,4575,2320,2255,1492,3083,ITF,ITF5,17,Basilicata
2021-06-07,FVG,8940,4639,4301,8040,900,ITH,ITH4,6,Friuli-Venezia Giulia
2021-01-16,SAR,1492,525,967,1492,0,ITG,ITG2,20,Sardegna
2021-01-16,CAM,3369,1675,1694,3369,0,ITF,ITF3,15,Campania
2021-05-10,LIG,12650,5640,7010,6275,6375,ITC,ITC3,7,Liguria
2021-05-05,VEN,44240,21209,23031,37673,6567,ITH,ITH3,5,Veneto
2021-04-23,SIC,28623,13711,14912,22809,5814,ITG,ITG1,19,Sicilia
2021-01-23,CAL,400,186,214,358,42,ITF,ITF6,18,Calabria
2021-06-07,PIE,34570,17687,16883,29805,4765,ITC,ITC1,1,Piemonte
2021-01-16,LOM,15425,5731,9694,15425,0,ITC,ITC4,3,Lombardia
2021-04-30,LAZ,41287,18281,23006,27098,14189,ITI,ITI4,12,Lazio
2021-02-10,ABR,947,312,635,503,444,ITF,ITF1,13,Abruzzo
2021-01-18,EMR,3127,879,2248,2449,678,ITH,ITH5,8,Emilia-Romagna
2021-03-15,VDA,362,123,239,159,203,ITC,ITC2,2,Valle d'Aosta / Vallée d'Aoste
2021-03-16,EMR,12243,5027,7216,4935,7308,ITH,ITH5,8,Emilia-Romagna
2021-05-11,VDA,647,325,322,496,151,ITC,ITC2,2,Valle d'Aosta / Vallée d'Aoste
2021-01-25,EMR,6462,2146,4316,207,6255,ITH,ITH5,8,Emilia-Romagna
2021-01-06,UMB,846,325,521,846,0,ITI,ITI2,10,Umbria
2021-04-27,VDA,978,423,555,686,292,ITC,ITC2,2,Valle d'Aosta / Vallée d'Aoste
2021-03-23,EMR,18928,8252,10676,12241,6687,ITH,ITH5,8,Emilia-Romagna
2021-04-26,MAR,8980,3983,4997,5958,3022,ITI,ITI3,11,Marche
2021-01-17,VDA,131,56,75,131,0,ITC,ITC2,2,Valle d'Aosta / Vallée d'Aoste
2021-04-16,UMB,8111,3747,4364,6273,1838,ITI,ITI2,10,Umbria
2021-04-30,UMB,6232,2962,3270,2843,3389,ITI,ITI2,10,Umbria
2021-03-19,TOS,10140,4460,5680,7272,2868,ITI,ITI1,9,Toscana
2021-03-04,UMB,4485,1853,2632,3657,828,ITI,ITI2,10,Umbria
2021-04-24,MOL,2551,1202,1349,710,1841,ITF,ITF2,14,Molise
2021-01-24,PAB,12,10,2,0,12,ITH,ITH1,4,Provincia Autonoma Bolzano / Bozen
2021-01-31,PUG,1813,829,984,75,1738,ITF,ITF4,16,Puglia
2021-02-26,MOL,563,260,303,490,73,ITF,ITF2,14,Molise
2021-03-28,CAL,2567,1188,1379,1513,1054,ITF,ITF6,18,Calabria
2021-01-20,UMB,613,222,391,613,0,ITI,ITI2,10,Umbria
2021-04-30,SIC,34913,16304,18609,23933,10980,ITG,ITG1,19,Sicilia
2021-06-06,MOL,2007,1035,972,1685,322,ITF,ITF2,14,Molise
2021-04-01,BAS,2801,1125,1676,2081,720,ITF,ITF5,17,Basilicata
2021-05-03,LIG,13270,5919,7351,6458,6812,ITC,ITC3,7,Liguria
2021-05-31,FVG,8683,4358,4325,6392,2291,ITH,ITH4,6,Friuli-Venezia Giulia
2021-02-03,BAS,666,300,366,32,634,ITF,ITF5,17,Basilicata
2021-05-12,VEN,36634,17729,18905,31535,5099,ITH,ITH3,5,Veneto
2021-03-21,LIG,550,220,330,69,481,ITC,ITC3,7,Liguria
2020-12-28,PIE,1,1,0,1,0,ITC,ITC1,1,Piemonte
2021-01-23,LIG,809,295,514,153,656,ITC,ITC3,7,Liguria
2021-01-09,LOM,12411,4573,7838,12411,0,ITC,ITC4,3,Lombardia
2021-01-30,CAL,2181,1149,1032,357,1824,ITF,ITF6,18,Calabria
2021-01-23,CAM,3838,2028,1810,273,3565,ITF,ITF3,15,Campania
2021-03-04,SIC,15196,6689,8507,11078,4118,ITG,ITG1,19,Sicilia
2021-03-07,LOM,12079,5354,6725,9523,2556,ITC,ITC4,3,Lombardia
2021-03-16,VEN,12517,5348,7169,6902,5615,ITH,ITH3,5,Veneto
2021-03-21,CAM,10027,4631,5396,7637,2390,ITF,ITF3,15,Campania
2021-05-17,LIG,12029,5519,6510,8705,3324,ITC,ITC3,7,Liguria
2021-01-21,TOS,1589,686,903,867,722,ITI,ITI1,9,Toscana
2021-05-07,LAZ,48174,22581,25593,30446,17728,ITI,ITI4,12,Lazio
2021-03-11,LAZ,26323,12835,13488,20093,6230,ITI,ITI4,12,Lazio
2021-03-09,EMR,14752,6019,8733,10797,3955,ITH,ITH5,8,Emilia-Romagna
2021-05-05,EMR,30082,13978,16104,18833,11249,ITH,ITH5,8,Emilia-Romagna
2021-02-03,ABR,2062,718,1344,419,1643,ITF,ITF1,13,Abruzzo
2021-01-27,LOM,8033,2672,5361,808,7225,ITC,ITC4,3,Lombardia
2021-02-17,CAL,1834,799,1035,1623,211,ITF,ITF6,18,Calabria
2021-05-29,PUG,30143,14209,15934,20901,9242,ITF,ITF4,16,Puglia
2021-02-10,CAM,6904,3413,3491,6728,176,ITF,ITF3,15,Campania
2021-03-19,MOL,1184,482,702,757,427,ITF,ITF2,14,Molise
2021-05-02,PIE,25066,11266,13800,14321,10745,ITC,ITC1,1,Piemonte
2021-03-25,LOM,42760,16045,26715,30172,12588,ITC,ITC4,3,Lombardia
2021-04-02,PUG,12831,5991,6840,8309,4522,ITF,ITF4,16,Puglia
2021-05-28,CAL,21001,10228,10773,11521,9480,ITF,ITF6,18,Calabria
2021-01-21,MOL,6,2,4,6,0,ITF,ITF2,14,Molise
2021-04-08,CAM,28349,13714,14635,22510,5839,ITF,ITF3,15,Campania
2021-05-21,LOM,93669,45169,48500,29071,64598,ITC,ITC4,3,Lombardia
2021-01-23,MAR,557,190,367,123,434,ITI,ITI3,11,Marche
2021-02-20,PAT,407,245,162,123,284,ITH,ITH2,4,Provincia Autonoma Trento
2021-06-01,BAS,6137,2926,3211,3061,3076,ITF,ITF5,17,Basilicata
2021-06-04,CAM,74548,35973,38575,65225,9323,ITF,ITF3,15,Campania
2021-04-15,CAL,7595,3722,3873,5984,1611,ITF,ITF6,18,Calabria
2021-05-03,MAR,10197,4605,5592,4790,5407,ITI,ITI3,11,Marche
2021-02-27,FVG,3530,1200,2330,3529,1,ITH,ITH4,6,Friuli-Venezia Giulia
2021-02-28,ABR,1702,508,1194,1700,2,ITF,ITF1,13,Abruzzo
2021-04-16,LAZ,34409,15683,18726,22336,12073,ITI,ITI4,12,Lazio
2021-04-18,CAL,5839,2790,3049,4930,909,ITF,ITF6,18,Calabria
2021-04-08,BAS,764,348,416,754,10,ITF,ITF5,17,Basilicata
2021-01-27,VDA,151,71,80,79,72,ITC,ITC2,2,Valle d'Aosta / Vallée d'Aoste
2021-02-06,PAT,574,298,276,433,141,ITH,ITH2,4,Provincia Autonoma Trento
2021-03-26,TOS,20913,9589,11324,15147,5766,ITI,ITI1,9,Toscana
2021-04-20,VDA,933,430,503,739,194,ITC,ITC2,2,Valle d'Aosta / Vallée d'Aoste
2021-04-22,BAS,5036,2346,2690,3433,1603,ITF,ITF5,17,Basilicata
2021-01-23,LAZ,7213,2869,4344,584,6629,ITI,ITI4,12,Lazio
2021-03-30,EMR,23385,10371,13014,18347,5038,ITH,ITH5,8,Emilia-Romagna
2021-01-06,LAZ,5123,1961,3162,5123,0,ITI,ITI4,12,Lazio
2021-01-10,VDA,220,71,149,220,0,ITC,ITC2,2,Valle d'Aosta / Vallée d'Aoste
2021-02-23,PAT,1110,395,715,897,213,ITH,ITH2,4,Provincia Autonoma Trento
2021-03-09,TOS,11123,4561,6562,5571,5552,ITI,ITI1,9,Toscana
2021-03-24,MAR,7033,2984,4049,3365,3668,ITI,ITI3,11,Marche
2021-03-28,FVG,4841,2284,2557,4700,141,ITH,ITH4,6,Friuli-Venezia Giulia
2021-04-05,PUG,12705,6173,6532,12172,533,ITF,ITF4,16,Puglia
2020-12-27,VDA,20,9,11,20,0,ITC,ITC2,2,Valle d'Aosta / Vallée d'Aoste
2021-03-19,PUG,7958,3653,4305,3413,4545,ITF,ITF4,16,Puglia
2021-01-07,MOL,598,209,389,598,0,ITF,ITF2,14,Molise
2021-01-11,VEN,7239,2102,5137,7239,0,ITH,ITH3,5,Veneto
2021-06-01,MAR,12050,6153,5897,9960,2090,ITI,ITI3,11,Marche
2021-02-28,LIG,1058,580,478,1049,9,ITC,ITC3,7,Liguria
2021-05-07,UMB,10107,4695,5412,6906,3201,ITI,ITI2,10,Umbria
2021-01-18,FVG,1961,606,1355,1867,94,ITH,ITH4,6,Friuli-Venezia Giulia
2021-03-03,ABR,4623,1881,2742,3717,906,ITF,ITF1,13,Abruzzo
2021-03-10,MAR,5666,2400,3266,4529,1137,ITI,ITI3,11,Marche
2021-05-24,CAM,31502,15294,16208,16209,15293,ITF,ITF3,15,Campania
2021-01-04,FVG,1507,558,949,1507,0,ITH,ITH4,6,Friuli-Venezia Giulia
2021-04-09,TOS,24652,10609,14043,21243,3409,ITI,ITI1,9,Toscana
2021-05-17,PAT,4293,2122,2171,3942,351,ITH,ITH2,4,Provincia Autonoma Trento
2021-02-13,CAM,5508,2550,2958,5291,217,ITF,ITF3,15,Campania
2021-02-21,MAR,376,141,235,375,1,ITI,ITI3,11,Marche
2021-04-04,CAL,1762,886,876,1262,500,ITF,ITF6,18,Calabria
2021-04-21,VEN,32319,13177,19142,16256,16063,ITH,ITH3,5,Veneto
2021-02-07,PAB,2361,1057,1304,14,2347,ITH,ITH1,4,Provincia Autonoma Bolzano / Bozen
2021-02-12,MOL,330,149,181,208,122,ITF,ITF2,14,Molise
2021-02-25,SIC,9866,5156,4710,8704,1162,ITG,ITG1,19,Sicilia
2021-03-28,PIE,16056,6899,9157,8435,7621,ITC,ITC1,1,Piemonte
2021-04-23,SAR,12846,5736,7110,7384,5462,ITG,ITG2,20,Sardegna
2021-05-22,VEN,34723,16659,18064,13332,21391,ITH,ITH3,5,Veneto
2021-02-11,VEN,4012,1238,2774,3384,628,ITH,ITH3,5,Veneto
2021-04-08,ABR,7398,3337,4061,5069,2329,ITF,ITF1,13,Abruzzo
2021-06-05,SIC,59890,28485,31405,49314,10576,ITG,ITG1,19,Sicilia
2021-04-23,CAM,32304,15510,16794,23162,9142,ITF,ITF3,15,Campania
2021-05-10,SAR,9736,4338,5398,7198,2538,ITG,ITG2,20,Sardegna
2021-01-28,VEN,9209,2662,6547,173,9036,ITH,ITH3,5,Veneto
2021-04-22,ABR,6727,3248,3479,4998,1729,ITF,ITF1,13,Abruzzo
2021-01-30,SAR,3863,1392,2471,362,3501,ITG,ITG2,20,Sardegna
2021-03-14,SIC,8774,3927,4847,4938,3836,ITG,ITG1,19,Sicilia
2021-04-11,PIE,20824,9317,11507,18663,2161,ITC,ITC1,1,Piemonte
2021-05-18,PAB,3334,1749,1585,2149,1185,ITH,ITH1,4,Provincia Autonoma Bolzano / Bozen
2021-01-04,EMR,7315,2527,4788,7315,0,ITH,ITH5,8,Emilia-Romagna
2021-01-04,PIE,5564,1679,3885,5564,0,ITC,ITC1,1,Piemonte
2021-04-23,LOM,73391,33281,40110,56872,16519,ITC,ITC4,3,Lombardia
2021-04-28,PIE,26029,11736,14293,15996,10033,ITC,ITC1,1,Piemonte
2021-01-18,PIE,6166,2048,4118,5917,249,ITC,ITC1,1,Piemonte
2021-03-22,ABR,4459,2011,2448,2489,1970,ITF,ITF1,13,Abruzzo
2021-05-10,LOM,85189,40857,44332,63682,21507,ITC,ITC4,3,Lombardia
2021-02-11,SIC,5235,2060,3175,4774,461,ITG,ITG1,19,Sicilia
2021-01-30,LOM,12307,4563,7744,154,12153,ITC,ITC4,3,Lombardia
2021-02-06,FVG,1154,338,816,22,1132,ITH,ITH4,6,Friuli-Venezia Giulia
2021-02-17,BAS,1135,493,642,1059,76,ITF,ITF5,17,Basilicata
2021-02-25,LAZ,12652,5517,7135,11602,1050,ITI,ITI4,12,Lazio
2021-04-14,PAT,3115,1464,1651,2379,736,ITH,ITH2,4,Provincia Autonoma Trento
2021-02-04,TOS,4253,1594,2659,961,3292,ITI,ITI1,9,Toscana
2021-02-23,FVG,2643,1277,1366,2463,180,ITH,ITH4,6,Friuli-Venezia Giulia
2021-03-28,PAT,751,294,457,749,2,ITH,ITH2,4,Provincia Autonoma Trento
2021-06-07,CAL,16951,7881,9070,13744,3207,ITF,ITF6,18,Calabria
2021-01-19,MAR,229,84,145,143,86,ITI,ITI3,11,Marche
2021-05-28,BAS,3612,1807,1805,949,2663,ITF,ITF5,17,Basilicata
2021-06-05,LAZ,65463,32198,33265,43088,22375,ITI,ITI4,12,Lazio
2021-02-14,PUG,786,347,439,662,124,ITF,ITF4,16,Puglia
2021-05-15,TOS,29313,13833,15480,23560,5753,ITI,ITI1,9,Toscana
2021-05-19,EMR,33661,14936,18725,18513,15148,ITH,ITH5,8,Emilia-Romagna
2021-02-02,MAR,1191,397,794,72,1119,ITI,ITI3,11,Marche
2021-06-09,VDA,1027,535,492,991,36,ITC,ITC2,2,Valle d'Aosta / Vallée d'Aoste
2021-06-11,BAS,2973,1388,1585,2305,668,ITF,ITF5,17,Basilicata
2021-05-25,PUG,34395,16004,18391,20952,13443,ITF,ITF4,16,Puglia
2021-01-04,PAT,870,227,643,870,0,ITH,ITH2,4,Provincia Autonoma Trento
2021-03-01,VDA,181,66,115,147,34,ITC,ITC2,2,Valle d'Aosta / Vallée d'Aoste
2021-03-15,MOL,832,338,494,587,245,ITF,ITF2,14,Molise
2021-04-28,TOS,19114,8181,10933,3832,15282,ITI,ITI1,9,Toscana
2021-05-13,MAR,12602,5695,6907,7102,5500,ITI,ITI3,11,Marche
2021-05-17,FVG,8778,4077,4701,6295,2483,ITH,ITH4,6,Friuli-Venezia Giulia
2021-03-02,VEN,11483,4622,6861,8176,3307,ITH,ITH3,5,Veneto
2021-03-09,FVG,4008,1721,2287,1261,2747,ITH,ITH4,6,Friuli-Venezia Giulia
2021-04-12,MAR,8567,3772,4795,8083,484,ITI,ITI3,11,Marche
2021-05-24,CAL,17699,8814,8885,10023,7676,ITF,ITF6,18,Calabria
2021-01-09,LIG,1335,481,854,1335,0,ITC,ITC3,7,Liguria
2021-02-15,VDA,264,136,128,229,35,ITC,ITC2,2,Valle d'Aosta / Vallée d'Aoste
2021-03-18,UMB,2942,1164,1778,1704,1238,ITI,ITI2,10,Umbria
2021-06-02,EMR,23919,11914,12005,19101,4818,ITH,ITH5,8,Emilia-Romagna
2021-04-19,LIG,12807,5613,7194,8999,3808,ITC,ITC3,7,Liguria
2021-05-01,PAB,2104,1067,1037,1944,160,ITH,ITH1,4,Provincia Autonoma Bolzano / Bozen
2021-05-07,CAL,16100,7586,8514,9725,6375,ITF,ITF6,18,Calabria
2021-05-08,PUG,54106,22901,31205,24412,29694,ITF,ITF4,16,Puglia
2021-01-12,PUG,4212,1772,2440,4212,0,ITF,ITF4,16,Puglia
2021-02-16,LOM,9505,3073,6432,9057,448,ITC,ITC4,3,Lombardia
2021-03-02,CAM,12764,4561,8203,8419,4345,ITF,ITF3,15,Campania
2021-05-20,PAB,4729,2340,2389,3250,1479,ITH,ITH1,4,Provincia Autonoma Bolzano / Bozen
2021-01-11,CAL,2160,1044,1116,2160,0,ITF,ITF6,18,Calabria
2020-12-27,ABR,37,19,18,37,0,ITF,ITF1,13,Abruzzo
2021-01-25,CAL,1071,514,557,147,924,ITF,ITF6,18,Calabria
2021-06-10,LOM,100985,51472,49513,87031,13954,ITC,ITC4,3,Lombardia
2021-01-15,BAS,813,350,463,813,0,ITF,ITF5,17,Basilicata
2021-02-11,LIG,1979,767,1212,1103,876,ITC,ITC3,7,Liguria
2021-03-02,LOM,22802,9697,13105,19769,3033,ITC,ITC4,3,Lombardia
2021-05-05,CAL,13600,6508,7092,8493,5107,ITF,ITF6,18,Calabria
2021-03-23,SAR,6900,3338,3562,5822,1078,ITG,ITG2,20,Sardegna
2021-05-22,LIG,6551,3195,3356,4943,1608,ITC,ITC3,7,Liguria
2021-06-07,SIC,49456,23308,26148,41575,7881,ITG,ITG1,19,Sicilia
2021-01-16,TOS,3271,1046,2225,3271,0,ITI,ITI1,9,Toscana
2021-03-20,ABR,4789,2198,2591,2618,2171,ITF,ITF1,13,Abruzzo
2021-04-16,EMR,29210,13755,15455,20373,8837,ITH,ITH5,8,Emilia-Romagna
2021-01-06,EMR,8287,2955,5332,8287,0,ITH,ITH5,8,Emilia-Romagna
2021-04-26,TOS,10151,4943,5208,7598,2553,ITI,ITI1,9,Toscana
2021-04-03,VDA,676,341,335,661,15,ITC,ITC2,2,Valle d'Aosta / Vallée d'Aoste
2021-04-04,VEN,7775,3531,4244,6624,1151,ITH,ITH3,5,Veneto
2021-02-13,UMB,115,28,87,112,3,ITI,ITI2,10,Umbria
2021-03-20,VDA,208,86,122,172,36,ITC,ITC2,2,Valle d'Aosta / Vallée d'Aoste
2021-03-30,LAZ,27689,13783,13906,20541,7148,ITI,ITI4,12,Lazio
2021-01-02,TOS,3497,1096,2401,3497,0,ITI,ITI1,9,Toscana
2021-04-30,EMR,36581,16780,19801,21789,14792,ITH,ITH5,8,Emilia-Romagna
2021-05-24,UMB,9075,4534,4541,8169,906,ITI,ITI2,10,Umbria
2021-04-18,UMB,1530,680,850,600,930,ITI,ITI2,10,Umbria
2021-01-11,UMB,1315,346,969,1315,0,ITI,ITI2,10,Umbria
2021-03-28,EMR,13497,6024,7473,9633,3864,ITH,ITH5,8,Emilia-Romagna
2021-04-07,PUG,15725,7161,8564,9051,6674,ITF,ITF4,16,Puglia
2020-12-27,BAS,106,41,65,106,0,ITF,ITF5,17,Basilicata
2021-01-26,MOL,450,184,266,8,442,ITF,ITF2,14,Molise
2021-02-04,FVG,2725,808,1917,35,2690,ITH,ITH4,6,Friuli-Venezia Giulia
2021-05-15,MAR,13965,6375,7590,8076,5889,ITI,ITI3,11,Marche
2021-05-05,UMB,7196,3291,3905,3896,3300,ITI,ITI2,10,Umbria
2021-05-06,MOL,2679,1214,1465,2081,598,ITF,ITF2,14,Molise
2021-06-11,VDA,594,254,340,345,249,ITC,ITC2,2,Valle d'Aosta / Vallée d'Aoste
2021-04-18,LAZ,23774,10557,13217,16139,7635,ITI,ITI4,12,Lazio
2021-03-20,BAS,1290,570,720,278,1012,ITF,ITF5,17,Basilicata
2021-01-25,SIC,7400,3671,3729,300,7100,ITG,ITG1,19,Sicilia
2021-06-10,LIG,18055,9413,8642,12450,5605,ITC,ITC3,7,Liguria
2021-02-19,MAR,1962,712,1250,1827,135,ITI,ITI3,11,Marche
2021-04-30,FVG,7324,3231,4093,3693,3631,ITH,ITH4,6,Friuli-Venezia Giulia
2021-01-25,UMB,648,323,325,5,643,ITI,ITI2,10,Umbria
2021-05-05,SIC,26232,12184,14048,16671,9561,ITG,ITG1,19,Sicilia
2021-03-19,LIG,5296,2234,3062,2150,3146,ITC,ITC3,7,Liguria
2021-05-19,SIC,42639,20620,22019,28343,14296,ITG,ITG1,19,Sicilia
2021-02-04,PIE,10203,3339,6864,588,9615,ITC,ITC1,1,Piemonte
2021-03-02,LIG,4074,1689,2385,3764,310,ITC,ITC3,7,Liguria
2021-03-26,PAT,3190,1242,1948,2591,599,ITH,ITH2,4,Provincia Autonoma Trento
2021-01-11,CAM,4072,1871,2201,4072,0,ITF,ITF3,15,Campania
2021-03-31,PAB,1832,694,1138,821,1011,ITH,ITH1,4,Provincia Autonoma Bolzano / Bozen
2020-12-28,LOM,107,47,60,107,0,ITC,ITC4,3,Lombardia
2021-03-02,CAL,4366,2490,1876,3611,755,ITF,ITF6,18,Calabria
2021-05-24,VEN,33226,16602,16624,8248,24978,ITH,ITH3,5,Veneto
2021-03-16,CAL,3847,1888,1959,2187,1660,ITF,ITF6,18,Calabria
2021-03-06,BAS,1355,536,819,759,596,ITF,ITF5,17,Basilicata
2021-04-02,LIG,11770,5209,6561,9284,2486,ITC,ITC3,7,Liguria
2021-05-12,SAR,10825,5080,5745,7747,3078,ITG,ITG2,20,Sardegna
2021-04-21,LOM,71693,32510,39183,57085,14608,ITC,ITC4,3,Lombardia
2021-05-23,VDA,999,465,534,658,341,ITC,ITC2,2,Valle d'Aosta / Vallée d'Aoste
2021-01-11,LOM,16146,5349,10797,16146,0,ITC,ITC4,3,Lombardia
2021-02-25,EMR,9250,3499,5751,8296,954,ITH,ITH5,8,Emilia-Romagna
2021-03-07,TOS,5647,2357,3290,2104,3543,ITI,ITI1,9,Toscana
2021-01-28,LOM,12186,3690,8496,766,11420,ITC,ITC4,3,Lombardia
2021-01-29,VDA,318,138,180,2,316,ITC,ITC2,2,Valle d'Aosta / Vallée d'Aoste
2021-04-30,PIE,31773,14278,17495,18444,13329,ITC,ITC1,1,Piemonte
2021-05-19,LAZ,46817,21492,25325,36780,10037,ITI,ITI4,12,Lazio
2021-04-04,UMB,59,20,39,23,36,ITI,ITI2,10,Umbria
2021-01-29,ABR,1387,449,938,74,1313,ITF,ITF1,13,Abruzzo
2021-03-11,EMR,17643,7468,10175,11793,5850,ITH,ITH5,8,Emilia-Romagna
2021-04-22,VDA,1067,449,618,684,383,ITC,ITC2,2,Valle d'Aosta / Vallée d'Aoste
2021-06-07,UMB,6898,3393,3505,6217,681,ITI,ITI2,10,Umbria
2021-05-09,VDA,574,287,287,444,130,ITC,ITC2,2,Valle d'Aosta / Vallée d'Aoste
2021-01-04,LAZ,7483,2909,4574,7483,0,ITI,ITI4,12,Lazio
2021-02-06,EMR,7602,2407,5195,2131,5471,ITH,ITH5,8,Emilia-Romagna
2021-03-16,UMB,3538,1454,2084,1911,1627,ITI,ITI2,10,Umbria
2021-03-17,MOL,908,385,523,576,332,ITF,ITF2,14,Molise
2021-05-27,PUG,42416,20985,21431,24169,18247,ITF,ITF4,16,Puglia
2021-06-07,LAZ,61340,28487,32853,32823,28517,ITI,ITI4,12,Lazio
2021-02-27,UMB,1658,354,1304,1642,16,ITI,ITI2,10,Umbria
2021-04-21,LIG,14240,6430,7810,8918,5322,ITC,ITC3,7,Liguria
2020-12-28,SAR,65,25,40,65,0,ITG,ITG2,20,Sardegna
2020-12-31,MAR,387,181,206,387,0,ITI,ITI3,11,Marche
2021-02-11,CAL,2330,1041,1289,1082,1248,ITF,ITF6,18,Calabria
2021-05-09,BAS,4685,2340,2345,2990,1695,ITF,ITF5,17,Basilicata
2021-06-08,MOL,2885,1593,1292,2189,696,ITF,ITF2,14,Molise
2021-03-16,SIC,9558,4277,5281,3623,5935,ITG,ITG1,19,Sicilia
2021-01-05,PAB,830,286,544,830,0,ITH,ITH1,4,Provincia Autonoma Bolzano / Bozen
2021-02-04,PAT,976,304,672,422,554,ITH,ITH2,4,Provincia Autonoma Trento
2021-02-15,BAS,622,232,390,580,42,ITF,ITF5,17,Basilicata
2021-05-08,LIG,7530,3334,4196,2314,5216,ITC,ITC3,7,Liguria
2021-01-09,VEN,7927,2539,5388,7927,0,ITH,ITH3,5,Veneto
2021-01-29,BAS,615,230,385,63,552,ITF,ITF5,17,Basilicata
2021-05-26,CAM,52561,25760,26801,21535,31026,ITF,ITF3,15,Campania
2021-01-26,MAR,2023,748,1275,91,1932,ITI,ITI3,11,Marche
2021-03-09,CAL,6339,3259,3080,5359,980,ITF,ITF6,18,Calabria
2021-05-17,VEN,26456,12968,13488,16439,10017,ITH,ITH3,5,Veneto
2021-03-26,LIG,9481,4158,5323,6327,3154,ITC,ITC3,7,Liguria
2021-03-28,LOM,20465,7803,12662,14303,6162,ITC,ITC4,3,Lombardia
2021-04-11,SIC,15336,7575,7761,8306,7030,ITG,ITG1,19,Sicilia
2021-05-22,TOS,26013,12663,13350,21724,4289,ITI,ITI1,9,Toscana
2021-02-06,VEN,4095,1354,2741,709,3386,ITH,ITH3,5,Veneto
2021-04-14,LOM,47138,21011,26127,34172,12966,ITC,ITC4,3,Lombardia
2021-02-20,CAL,1419,760,659,1101,318,ITF,ITF6,18,Calabria
2021-05-26,LAZ,47175,21577,25598,35277,11898,ITI,ITI4,12,Lazio
2021-01-02,LIG,691,245,446,691,0,ITC,ITC3,7,Liguria
2021-01-04,LOM,6094,2101,3993,6094,0,ITC,ITC4,3,Lombardia
2021-01-30,FVG,2275,745,1530,270,2005,ITH,ITH4,6,Friuli-Venezia Giulia
2021-03-04,LAZ,20140,9399,10741,15123,5017,ITI,ITI4,12,Lazio
2021-04-21,PAT,2894,1349,1545,2844,50,ITH,ITH2,4,Provincia Autonoma Trento
2021-05-05,TOS,30119,13441,16678,15648,14471,ITI,ITI1,9,Toscana
2021-04-24,PAB,5104,2449,2655,4619,485,ITH,ITH1,4,Provincia Autonoma Bolzano / Bozen
2021-02-05,VDA,294,102,192,101,193,ITC,ITC2,2,Valle d'Aosta / Vallée d'Aoste
2021-02-07,PUG,1579,669,910,253,1326,ITF,ITF4,16,Puglia
2021-05-19,SAR,16392,8147,8245,12747,3645,ITG,ITG2,20,Sardegna
2021-01-21,PUG,2132,904,1228,1271,861,ITF,ITF4,16,Puglia
2021-01-22,ABR,118,57,61,118,0,ITF,ITF1,13,Abruzzo
2021-02-22,VDA,316,94,222,213,103,ITC,ITC2,2,Valle d'Aosta / Vallée d'Aoste
2021-03-28,CAM,15555,7504,8051,13930,1625,ITF,ITF3,15,Campania
2021-04-23,PIE,27446,12602,14844,20684,6762,ITC,ITC1,1,Piemonte
2021-02-28,TOS,1649,667,982,922,727,ITI,ITI1,9,Toscana
2021-05-01,PUG,27520,12610,14910,16877,10643,ITF,ITF4,16,Puglia
2021-06-05,SAR,17825,8413,9412,11377,6448,ITG,ITG2,20,Sardegna
2021-02-23,VEN,7376,3251,4125,7106,270,ITH,ITH3,5,Veneto
2021-04-19,MAR,9601,4497,5104,8020,1581,ITI,ITI3,11,Marche
2021-05-31,CAL,15362,7409,7953,7410,7952,ITF,ITF6,18,Calabria
2021-02-25,SAR,2899,1255,1644,2294,605,ITG,ITG2,20,Sardegna
2021-01-04,CAM,5826,2962,2864,5826,0,ITF,ITF3,15,Campania
2021-02-11,TOS,5383,2021,3362,5141,242,ITI,ITI1,9,Toscana
2021-05-16,VDA,688,341,347,347,341,ITC,ITC2,2,Valle d'Aosta / Vallée d'Aoste
2021-01-30,EMR,10078,3520,6558,141,9937,ITH,ITH5,8,Emilia-Romagna
2021-03-14,SAR,607,376,231,607,0,ITG,ITG2,20,Sardegna
2021-03-24,MOL,1631,658,973,1229,402,ITF,ITF2,14,Molise
2020-12-30,SIC,180,105,75,180,0,ITG,ITG1,19,Sicilia
2021-02-09,TOS,4488,1468,3020,3877,611,ITI,ITI1,9,Toscana
2021-04-05,PAB,301,144,157,23,278,ITH,ITH1,4,Provincia Autonoma Bolzano / Bozen
2021-01-16,SIC,2461,1101,1360,2461,0,ITG,ITG1,19,Sicilia
2021-01-28,PAT,530,147,383,48,482,ITH,ITH2,4,Provincia Autonoma Trento
2021-01-11,PAT,730,221,509,730,0,ITH,ITH2,4,Provincia Autonoma Trento
2021-01-22,BAS,67,24,43,67,0,ITF,ITF5,17,Basilicata
2021-03-21,LAZ,18047,6989,11058,12996,5051,ITI,ITI4,12,Lazio
2021-04-09,SIC,20261,9878,10383,11186,9075,ITG,ITG1,19,Sicilia
2021-01-12,PAB,1709,459,1250,1709,0,ITH,ITH1,4,Provincia Autonoma Bolzano / Bozen
2021-03-23,SIC,20918,10100,10818,15404,5514,ITG,ITG1,19,Sicilia
2021-01-02,PUG,2949,1301,1648,2949,0,ITF,ITF4,16,Puglia
2021-01-03,ABR,471,185,286,471,0,ITF,ITF1,13,Abruzzo
2021-04-12,PUG,29127,13716,15411,26301,2826,ITF,ITF4,16,Puglia
2020-12-30,LAZ,1630,629,1001,1630,0,ITI,ITI4,12,Lazio
2021-02-16,PAT,663,244,419,658,5,ITH,ITH2,4,Provincia Autonoma Trento
2021-03-09,CAM,14048,6800,7248,10263,3785,ITF,ITF3,15,Campania
2021-05-02,BAS,4179,2000,2179,3551,628,ITF,ITF5,17,Basilicata
2021-04-15,BAS,3386,1659,1727,2632,754,ITF,ITF5,17,Basilicata
2021-01-17,MOL,78,38,40,48,30,ITF,ITF2,14,Molise
2021-02-14,MAR,738,301,437,738,0,ITI,ITI3,11,Marche
2021-04-28,VEN,32381,15163,17218,23360,9021,ITH,ITH3,5,Veneto
2021-04-23,EMR,29558,13810,15748,14677,14881,ITH,ITH5,8,Emilia-Romagna
2021-04-23,PAT,3606,1752,1854,3552,54,ITH,ITH2,4,Provincia Autonoma Trento
2021-01-30,PAT,386,132,254,152,234,ITH,ITH2,4,Provincia Autonoma Trento
2021-04-21,FVG,7746,3454,4292,4067,3679,ITH,ITH4,6,Friuli-Venezia Giulia
2020-12-28,SIC,211,126,85,211,0,ITG,ITG1,19,Sicilia
2021-01-13,EMR,9077,2941,6136,9077,0,ITH,ITH5,8,Emilia-Romagna
2021-03-27,ABR,6123,2621,3502,3636,2487,ITF,ITF1,13,Abruzzo
2021-04-09,LAZ,27674,12598,15076,19425,8249,ITI,ITI4,12,Lazio
2021-01-11,FVG,1882,608,1274,1882,0,ITH,ITH4,6,Friuli-Venezia Giulia
2021-03-23,LAZ,28178,14461,13717,21577,6601,ITI,ITI4,12,Lazio
2021-04-10,MOL,2637,1260,1377,2485,152,ITF,ITF2,14,Molise
2021-05-10,PAT,3208,1646,1562,2703,505,ITH,ITH2,4,Provincia Autonoma Trento
2021-03-07,LIG,1915,1138,777,1614,301,ITC,ITC3,7,Liguria
2021-05-31,CAM,41201,21099,20102,30676,10525,ITF,ITF3,15,Campania
2021-01-03,BAS,901,344,557,901,0,ITF,ITF5,17,Basilicata
2021-01-01,UMB,274,105,169,274,0,ITI,ITI2,10,Umbria
2021-02-05,MOL,593,269,324,55,538,ITF,ITF2,14,Molise
2021-04-11,UMB,3102,1503,1599,3053,49,ITI,ITI2,10,Umbria
2021-04-30,SAR,11132,5299,5833,6923,4209,ITG,ITG2,20,Sardegna
2021-01-18,VEN,2762,776,1986,2563,199,ITH,ITH3,5,Veneto
2021-01-05,ABR,1615,604,1011,1615,0,ITF,ITF1,13,Abruzzo
2021-03-11,CAL,7276,3427,3849,6014,1262,ITF,ITF6,18,Calabria
2021-04-04,EMR,9885,4718,5167,7616,2269,ITH,ITH5,8,Emilia-Romagna
2021-04-04,PIE,9254,4059,5195,6541,2713,ITC,ITC1,1,Piemonte
2021-06-04,VDA,908,383,525,474,434,ITC,ITC2,2,Valle d'Aosta / Vallée d'Aoste
2021-01-18,UMB,614,219,395,529,85,ITI,ITI2,10,Umbria
2021-01-19,MOL,173,63,110,162,11,ITF,ITF2,14,Molise
2021-04-21,PIE,25748,11837,13911,20408,5340,ITC,ITC1,1,Piemonte
2021-05-17,SAR,12126,5693,6433,9236,2890,ITG,ITG2,20,Sardegna
2021-02-04,VEN,7386,2025,5361,553,6833,ITH,ITH3,5,Veneto
2021-04-15,ABR,7820,3680,4140,5980,1840,ITF,ITF1,13,Abruzzo
2021-04-16,LOM,53623,23905,29718,39285,14338,ITC,ITC4,3,Lombardia
2021-05-08,MAR,12268,5476,6792,5021,7247,ITI,ITI3,11,Marche
2021-01-11,PIE,8744,2980,5764,8744,0,ITC,ITC1,1,Piemonte
2021-02-06,SAR,1970,697,1273,569,1401,ITG,ITG2,20,Sardegna
2021-04-29,MOL,2237,1144,1093,890,1347,ITF,ITF2,14,Molise
2021-04-11,CAM,17523,8606,8917,15441,2082,ITF,ITF3,15,Campania
2021-05-24,FVG,11442,5591,5851,7720,3722,ITH,ITH4,6,Friuli-Venezia Giulia
2021-06-04,BAS,4830,2286,2544,3784,1046,ITF,ITF5,17,Basilicata
2021-02-22,ABR,2642,1173,1469,2612,30,ITF,ITF1,13,Abruzzo
2021-06-02,UMB,3941,1894,2047,3901,40,ITI,ITI2,10,Umbria
2021-02-13,FVG,566,179,387,560,6,ITH,ITH4,6,Friuli-Venezia Giulia
2021-02-18,LAZ,10017,4975,5042,9208,809,ITI,ITI4,12,Lazio
2021-02-21,PUG,2176,474,1702,2114,62,ITF,ITF4,16,Puglia
2021-04-28,CAM,36435,17643,18792,26685,9750,ITF,ITF3,15,Campania
2021-01-18,CAM,957,399,558,713,244,ITF,ITF3,15,Campania
2021-06-01,PUG,34489,17241,17248,21781,12708,ITF,ITF4,16,Puglia
2021-02-24,BAS,1803,743,1060,1734,69,ITF,ITF5,17,Basilicata
2021-05-15,PUG,43262,18825,24437,23365,19897,ITF,ITF4,16,Puglia
2021-05-26,EMR,33147,14707,18440,10294,22853,ITH,ITH5,8,Emilia-Romagna
2021-04-26,LIG,10560,4988,5572,7924,2636,ITC,ITC3,7,Liguria
2021-05-12,LAZ,47478,21538,25940,30881,16597,ITI,ITI4,12,Lazio
2021-03-09,VEN,16538,7445,9093,10216,6322,ITH,ITH3,5,Veneto
2021-04-05,MAR,5688,2355,3333,4419,1269,ITI,ITI3,11,Marche
2021-02-05,ABR,1534,521,1013,788,746,ITF,ITF1,13,Abruzzo
2021-03-04,EMR,16450,5349,11101,13433,3017,ITH,ITH5,8,Emilia-Romagna
2021-02-19,MOL,169,93,76,167,2,ITF,ITF2,14,Molise
2021-01-16,LIG,1278,557,721,1278,0,ITC,ITC3,7,Liguria
2021-05-16,ABR,9579,4138,5441,5764,3815,ITF,ITF1,13,Abruzzo
2021-05-31,VEN,31675,16307,15368,21659,10016,ITH,ITH3,5,Veneto
2021-02-01,LAZ,5675,2177,3498,354,5321,ITI,ITI4,12,Lazio
2021-03-02,FVG,4219,1519,2700,2720,1499,ITH,ITH4,6,Friuli-Venezia Giulia
2021-03-21,PAT,129,69,60,129,0,ITH,ITH2,4,Provincia Autonoma Trento
2021-06-03,PUG,49736,24119,25617,30878,18858,ITF,ITF4,16,Puglia
2021-06-04,ABR,15618,7396,8222,10930,4688,ITF,ITF1,13,Abruzzo
2021-02-22,BAS,1790,773,1017,1737,53,ITF,ITF5,17,Basilicata
2021-02-20,UMB,282,100,182,258,24,ITI,ITI2,10,Umbria
2021-05-24,PIE,29243,13665,15578,17007,12236,ITC,ITC1,1,Piemonte
2021-02-02,LIG,2668,1005,1663,134,2534,ITC,ITC3,7,Liguria
2021-05-18,ABR,12116,5662,6454,7732,4384,ITF,ITF1,13,Abruzzo
2021-03-22,PAB,1144,523,621,1139,5,ITH,ITH1,4,Provincia Autonoma Bolzano / Bozen
2021-04-15,VDA,810,377,433,671,139,ITC,ITC2,2,Valle d'Aosta / Vallée d'Aoste
2021-05-24,EMR,30045,13827,16218,18417,11628,ITH,ITH5,8,Emilia-Romagna
2021-06-05,LOM,102017,52763,49254,92337,9680,ITC,ITC4,3,Lombardia
2021-02-13,EMR,3628,1085,2543,3030,598,ITH,ITH5,8,Emilia-Romagna
2021-02-24,ABR,3305,1441,1864,3129,176,ITF,ITF1,13,Abruzzo
2021-03-19,MAR,3835,1597,2238,339,3496,ITI,ITI3,11,Marche
2021-03-26,VEN,29586,13155,16431,24118,5468,ITH,ITH3,5,Veneto
2021-04-30,CAL,14929,7325,7604,10603,4326,ITF,ITF6,18,Calabria
2021-03-09,UMB,4089,2001,2088,2798,1291,ITI,ITI2,10,Umbria
2021-03-10,MOL,1737,720,1017,1687,50,ITF,ITF2,14,Molise
2021-03-28,SAR,4643,1838,2805,4564,79,ITG,ITG2,20,Sardegna
2021-03-04,FVG,3447,1595,1852,2788,659,ITH,ITH4,6,Friuli-Venezia Giulia
2021-03-02,PIE,11202,4506,6696,10386,816,ITC,ITC1,1,Piemonte
2021-03-14,LOM,14872,5348,9524,11589,3283,ITC,ITC4,3,Lombardia
2021-01-04,SAR,592,217,375,592,0,ITG,ITG2,20,Sardegna
2021-06-01,MOL,2596,1321,1275,2488,108,ITF,ITF2,14,Molise
2021-04-28,LIG,14443,6519,7924,6459,7984,ITC,ITC3,7,Liguria
2021-03-10,PUG,15022,6829,8193,11901,3121,ITF,ITF4,16,Puglia
2021-02-04,LIG,2817,986,1831,179,2638,ITC,ITC3,7,Liguria
2021-04-02,TOS,31967,13556,18411,23943,8024,ITI,ITI1,9,Toscana
2021-05-24,PAT,4380,2010,2370,1357,3023,ITH,ITH2,4,Provincia Autonoma Trento
2021-03-17,MAR,3428,1494,1934,107,3321,ITI,ITI3,11,Marche
2021-03-28,VEN,31236,13579,17657,27617,3619,ITH,ITH3,5,Veneto
2021-05-15,LIG,7252,3235,4017,4298,2954,ITC,ITC3,7,Liguria
2021-05-31,SIC,38083,17241,20842,21624,16459,ITG,ITG1,19,Sicilia
2021-01-13,LAZ,5693,2151,3542,5693,0,ITI,ITI4,12,Lazio
2021-02-21,LIG,869,491,378,865,4,ITC,ITC3,7,Liguria
2021-02-23,LOM,11791,4797,6994,11465,326,ITC,ITC4,3,Lombardia
2021-03-02,PAT,1304,440,864,928,376,ITH,ITH2,4,Provincia Autonoma Trento
2021-03-21,FVG,2671,999,1672,2262,409,ITH,ITH4,6,Friuli-Venezia Giulia
2021-01-18,CAL,1273,574,699,1046,227,ITF,ITF6,18,Calabria
2021-04-23,LAZ,37666,18088,19578,22404,15262,ITI,ITI4,12,Lazio
2021-06-10,PAT,6010,2933,3077,1852,4158,ITH,ITH2,4,Provincia Autonoma Trento
2021-03-29,PUG,13916,6954,6962,7180,6736,ITF,ITF4,16,Puglia
2021-03-05,PAB,1839,625,1214,1397,442,ITH,ITH1,4,Provincia Autonoma Bolzano / Bozen
2021-05-17,CAM,49280,21650,27630,24089,25191,ITF,ITF3,15,Campania
2021-01-09,TOS,4485,1596,2889,4485,0,ITI,ITI1,9,Toscana
2021-02-06,CAM,5340,2665,2675,2102,3238,ITF,ITF3,15,Campania
2021-04-13,VDA,373,171,202,329,44,ITC,ITC2,2,Valle d'Aosta / Vallée d'Aoste
2021-02-28,MAR,2836,1251,1585,2830,6,ITI,ITI3,11,Marche
2021-04-11,CAL,4166,1895,2271,2223,1943,ITF,ITF6,18,Calabria
2021-04-14,VEN,15884,6883,9001,9259,6625,ITH,ITH3,5,Veneto
2021-05-27,PAB,6075,3195,2880,4063,2012,ITH,ITH1,4,Provincia Autonoma Bolzano / Bozen
2021-05-31,UMB,5822,2857,2965,4919,903,ITI,ITI2,10,Umbria
2021-03-12,PUG,14900,7030,7870,10972,3928,ITF,ITF4,16,Puglia
2021-04-16,SAR,14441,6488,7953,9098,5343,ITG,ITG2,20,Sardegna
2021-01-04,VEN,6735,2033,4702,6735,0,ITH,ITH3,5,Veneto
2021-03-27,VDA,333,164,169,302,31,ITC,ITC2,2,Valle d'Aosta / Vallée d'Aoste
2021-06-08,MAR,13915,7013,6902,11304,2611,ITI,ITI3,11,Marche
2021-05-14,UMB,5265,2448,2817,3457,1808,ITI,ITI2,10,Umbria
2021-05-25,PAB,3835,1988,1847,2950,885,ITH,ITH1,4,Provincia Autonoma Bolzano / Bozen
2021-01-23,SAR,60,22,38,0,60,ITG,ITG2,20,Sardegna
2021-05-13,MOL,3038,1410,1628,2581,457,ITF,ITF2,14,Molise
2021-02-14,PAB,297,130,167,297,0,ITH,ITH1,4,Provincia Autonoma Bolzano / Bozen
2021-02-18,SIC,5276,3100,2176,4847,429,ITG,ITG1,19,Sicilia
2021-04-30,CAM,42273,20163,22110,25821,16452,ITF,ITF3,15,Campania
2021-05-08,PAB,4426,2381,2045,3762,664,ITH,ITH1,4,Provincia Autonoma Bolzano / Bozen
2021-01-30,LAZ,7010,2892,4118,807,6203,ITI,ITI4,12,Lazio
2021-02-01,UMB,1285,342,943,48,1237,ITI,ITI2,10,Umbria
2021-02-04,CAM,7943,3429,4514,1308,6635,ITF,ITF3,15,Campania
2021-05-12,SIC,36717,17293,19424,21867,14850,ITG,ITG1,19,Sicilia
2021-03-13,BAS,1797,889,908,752,1045,ITF,ITF5,17,Basilicata
2021-03-02,SIC,14724,6355,8369,11952,2772,ITG,ITG1,19,Sicilia
2021-05-30,ABR,8561,4067,4494,5348,3213,ITF,ITF1,13,Abruzzo
2021-03-09,SAR,5543,2738,2805,4814,729,ITG,ITG2,20,Sardegna
2021-01-04,SIC,8235,4115,4120,8235,0,ITG,ITG1,19,Sicilia
2021-04-03,ABR,5085,2221,2864,3489,1596,ITF,ITF1,13,Abruzzo
2021-01-28,LIG,2847,971,1876,39,2808,ITC,ITC3,7,Liguria
2021-02-11,PIE,6764,2107,4657,3006,3758,ITC,ITC1,1,Piemonte
2021-05-05,SAR,10154,4644,5510,8145,2009,ITG,ITG2,20,Sardegna
2021-01-18,SIC,1437,582,855,1289,148,ITG,ITG1,19,Sicilia
2021-01-23,VEN,4050,1246,2804,31,4019,ITH,ITH3,5,Veneto
2021-01-26,PAB,810,291,519,1,809,ITH,ITH1,4,Provincia Autonoma Bolzano / Bozen
2021-04-09,PIE,25849,11387,14462,21340,4509,ITC,ITC1,1,Piemonte
2021-03-21,VEN,11983,4754,7229,8521,3462,ITH,ITH3,5,Veneto
2021-04-28,SIC,29166,13680,15486,20144,9022,ITG,ITG1,19,Sicilia
2020-12-30,PIE,730,322,408,730,0,ITC,ITC1,1,Piemonte
2021-03-16,CAM,8087,3519,4568,3773,4314,ITF,ITF3,15,Campania
2021-03-24,PAB,2062,998,1064,2049,13,ITH,ITH1,4,Provincia Autonoma Bolzano / Bozen
2021-06-05,PIE,34721,17663,17058,30275,4446,ITC,ITC1,1,Piemonte
2021-04-28,LOM,95618,43620,51998,68759,26859,ITC,ITC4,3,Lombardia
2021-02-25,PIE,12218,5252,6966,11671,547,ITC,ITC1,1,Piemonte
2021-03-16,LAZ,13545,5740,7805,7101,6444,ITI,ITI4,12,Lazio
2021-03-16,LOM,25478,10112,15366,16417,9061,ITC,ITC4,3,Lombardia
2021-01-23,EMR,2448,871,1577,443,2005,ITH,ITH5,8,Emilia-Romagna
2021-05-12,LOM,87335,41676,45659,59872,27463,ITC,ITC4,3,Lombardia
2021-01-21,MAR,905,258,647,585,320,ITI,ITI3,11,Marche
2021-05-30,BAS,2774,1420,1354,922,1852,ITF,ITF5,17,Basilicata
2021-04-09,PAT,2709,1145,1564,1509,1200,ITH,ITH2,4,Provincia Autonoma Trento
2021-05-02,VDA,765,345,420,605,160,ITC,ITC2,2,Valle d'Aosta / Vallée d'Aoste
2021-05-07,EMR,35206,16935,18271,23359,11847,ITH,ITH5,8,Emilia-Romagna
2021-05-17,TOS,29673,14799,14874,20807,8866,ITI,ITI1,9,Toscana
2021-02-18,FVG,3218,1492,1726,2811,407,ITH,ITH4,6,Friuli-Venezia Giulia
2021-04-03,BAS,1806,748,1058,1471,335,ITF,ITF5,17,Basilicata
2021-05-01,MAR,9318,3924,5394,3576,5742,ITI,ITI3,11,Marche
2021-01-22,VDA,56,21,35,20,36,ITC,ITC2,2,Valle d'Aosta / Vallée d'Aoste
2021-02-11,PAT,1132,365,767,796,336,ITH,ITH2,4,Provincia Autonoma Trento
2021-03-21,TOS,3293,1627,1666,1860,1433,ITI,ITI1,9,Toscana
2021-02-09,PUG,3840,1570,2270,2168,1672,ITF,ITF4,16,Puglia
2021-03-09,LAZ,21782,9759,12023,16585,5197,ITI,ITI4,12,Lazio
2021-01-08,VDA,299,130,169,299,0,ITC,ITC2,2,Valle d'Aosta / Vallée d'Aoste
2021-01-23,TOS,3949,1354,2595,640,3309,ITI,ITI1,9,Toscana
2021-02-25,PAT,1641,643,998,1200,441,ITH,ITH2,4,Provincia Autonoma Trento
2021-01-11,LAZ,5532,2105,3427,5532,0,ITI,ITI4,12,Lazio
2021-04-02,FVG,6567,2915,3652,4734,1833,ITH,ITH4,6,Friuli-Venezia Giulia
2021-05-20,PUG,33932,15674,18258,21410,12522,ITF,ITF4,16,Puglia
2020-12-30,PAT,7,3,4,7,0,ITH,ITH2,4,Provincia Autonoma Trento
2021-03-06,VDA,22,4,18,22,0,ITC,ITC2,2,Valle d'Aosta / Vallée d'Aoste
2021-05-03,TOS,11933,5510,6423,10615,1318,ITI,ITI1,9,Toscana
2021-06-05,PAT,4076,1914,2162,752,3324,ITH,ITH2,4,Provincia Autonoma Trento
2021-01-25,CAM,5746,2927,2819,164,5582,ITF,ITF3,15,Campania
2021-03-24,PUG,13429,6381,7048,6125,7304,ITF,ITF4,16,Puglia
2021-01-12,MOL,336,114,222,336,0,ITF,ITF2,14,Molise
2021-01-16,VEN,4611,1542,3069,4611,0,ITH,ITH3,5,Veneto
2021-02-01,CAL,2501,1195,1306,244,2257,ITF,ITF6,18,Calabria
2021-03-10,PAB,1268,529,739,1125,143,ITH,ITH1,4,Provincia Autonoma Bolzano / Bozen
2021-01-26,PUG,5360,2397,2963,570,4790,ITF,ITF4,16,Puglia
2021-03-23,CAM,16244,7925,8319,13731,2513,ITF,ITF3,15,Campania
2021-03-14,VEN,15172,5939,9233,14278,894,ITH,ITH3,5,Veneto
2021-05-06,PAB,5181,2747,2434,2613,2568,ITH,ITH1,4,Provincia Autonoma Bolzano / Bozen
2021-05-12,CAL,16314,7921,8393,10887,5427,ITF,ITF6,18,Calabria
2021-02-05,BAS,986,443,543,64,922,ITF,ITF5,17,Basilicata
2021-03-05,MAR,6171,2856,3315,4703,1468,ITI,ITI3,11,Marche
2021-04-16,FVG,6916,2997,3919,4992,1924,ITH,ITH4,6,Friuli-Venezia Giulia
2021-05-06,PUG,39460,17250,22210,19795,19665,ITF,ITF4,16,Puglia
2021-05-19,CAM,51079,22551,28528,34519,16560,ITF,ITF3,15,Campania
2021-02-24,MOL,666,278,388,333,333,ITF,ITF2,14,Molise
2021-05-22,PAT,3246,1592,1654,923,2323,ITH,ITH2,4,Provincia Autonoma Trento
2021-05-26,CAL,18673,9267,9406,10402,8271,ITF,ITF6,18,Calabria
2021-01-06,FVG,710,264,446,710,0,ITH,ITH4,6,Friuli-Venezia Giulia
2021-01-07,MAR,1808,636,1172,1808,0,ITI,ITI3,11,Marche
2021-01-21,LIG,1104,385,719,673,431,ITC,ITC3,7,Liguria
2021-03-02,SAR,3253,1819,1434,2100,1153,ITG,ITG2,20,Sardegna
2021-05-16,BAS,4971,2468,2503,2858,2113,ITF,ITF5,17,Basilicata
2021-03-30,CAL,6154,2642,3512,3438,2716,ITF,ITF6,18,Calabria
2021-04-02,PIE,20131,8298,11833,11704,8427,ITC,ITC1,1,Piemonte
2021-04-28,SAR,9019,4277,4742,5320,3699,ITG,ITG2,20,Sardegna
2021-02-12,ABR,1228,567,661,1039,189,ITF,ITF1,13,Abruzzo
2021-01-18,SAR,904,326,578,780,124,ITG,ITG2,20,Sardegna
2021-05-29,PIE,32762,15217,17545,20608,12154,ITC,ITC1,1,Piemonte
2021-02-23,SIC,8684,4588,4096,8220,464,ITG,ITG1,19,Sicilia
2021-05-23,ABR,9886,4700,5186,7189,2697,ITF,ITF1,13,Abruzzo
2021-02-18,PIE,4790,2093,2697,4360,430,ITC,ITC1,1,Piemonte
2021-03-16,SAR,4374,1949,2425,3452,922,ITG,ITG2,20,Sardegna
2021-03-17,PAB,581,213,368,580,1,ITH,ITH1,4,Provincia Autonoma Bolzano / Bozen
2021-03-09,SIC,13079,5699,7380,10880,2199,ITG,ITG1,19,Sicilia
2021-05-10,VEN,36428,17028,19400,26551,9877,ITH,ITH3,5,Veneto
2021-06-06,ABR,11019,5254,5765,8829,2190,ITF,ITF1,13,Abruzzo
2021-04-16,PIE,28395,13210,15185,23410,4985,ITC,ITC1,1,Piemonte
2021-05-05,CAM,51158,24851,26307,44779,6379,ITF,ITF3,15,Campania
2021-05-13,PAB,2994,1355,1639,1064,1930,ITH,ITH1,4,Provincia Autonoma Bolzano / Bozen
2021-01-11,SIC,5758,2533,3225,5758,0,ITG,ITG1,19,Sicilia
2021-01-30,VEN,8747,2672,6075,693,8054,ITH,ITH3,5,Veneto
2021-04-10,ABR,8772,4057,4715,6264,2508,ITF,ITF1,13,Abruzzo
2021-01-25,LAZ,8111,3246,4865,770,7341,ITI,ITI4,12,Lazio
2021-05-05,LAZ,46757,21451,25306,30938,15819,ITI,ITI4,12,Lazio
2021-03-09,LOM,33200,12849,20351,25806,7394,ITC,ITC4,3,Lombardia
2021-05-05,LOM,87831,41882,45949,72568,15263,ITC,ITC4,3,Lombardia
2021-03-13,VDA,147,88,59,147,0,ITC,ITC2,2,Valle d'Aosta / Vallée d'Aoste
2021-02-12,PAB,730,217,513,482,248,ITH,ITH1,4,Provincia Autonoma Bolzano / Bozen
2021-03-23,PIE,13077,5451,7626,6832,6245,ITC,ITC1,1,Piemonte
2021-04-19,PUG,27594,12814,14780,24550,3044,ITF,ITF4,16,Puglia
2021-04-10,PAB,5391,2664,2727,4803,588,ITH,ITH1,4,Provincia Autonoma Bolzano / Bozen
2021-06-07,CAM,55682,26763,28919,51683,3999,ITF,ITF3,15,Campania
2021-04-06,UMB,5290,2169,3121,2901,2389,ITI,ITI2,10,Umbria
2021-05-20,MAR,12364,5813,6551,7666,4698,ITI,ITI3,11,Marche
2021-01-10,ABR,1139,409,730,1139,0,ITF,ITF1,13,Abruzzo
2021-05-30,VDA,865,429,436,694,171,ITC,ITC2,2,Valle d'Aosta / Vallée d'Aoste
2021-01-16,PIE,7771,2630,5141,7771,0,ITC,ITC1,1,Piemonte
2021-02-11,SAR,1315,490,825,1204,111,ITG,ITG2,20,Sardegna
2021-01-23,PAT,577,334,243,388,189,ITH,ITH2,4,Provincia Autonoma Trento
2021-01-30,SIC,7627,3496,4131,168,7459,ITG,ITG1,19,Sicilia
2021-03-28,UMB,1096,442,654,1072,24,ITI,ITI2,10,Umbria
2021-04-28,FVG,7260,3201,4059,3796,3464,ITH,ITH4,6,Friuli-Venezia Giulia
2021-04-29,ABR,12668,5850,6818,9573,3095,ITF,ITF1,13,Abruzzo
2021-06-05,LIG,8093,4120,3973,4941,3152,ITC,ITC3,7,Liguria
2021-01-30,UMB,1590,490,1100,44,1546,ITI,ITI2,10,Umbria
2021-04-09,LIG,12422,5554,6868,10683,1739,ITC,ITC3,7,Liguria
2021-05-03,PAT,4244,2185,2059,4091,153,ITH,ITH2,4,Provincia Autonoma Trento
2021-06-05,TOS,28377,13575,14802,20771,7606,ITI,ITI1,9,Toscana
2020-12-31,PAB,913,519,394,913,0,ITH,ITH1,4,Provincia Autonoma Bolzano / Bozen
2021-02-04,LOM,27676,8074,19602,1991,25685,ITC,ITC4,3,Lombardia
2021-03-28,SIC,10913,5132,5781,6902,4011,ITG,ITG1,19,Sicilia
2021-03-04,CAL,5484,3191,2293,4687,797,ITF,ITF6,18,Calabria
2021-02-20,LAZ,9206,4274,4932,8438,768,ITI,ITI4,12,Lazio
2021-02-25,CAM,12425,4478,7947,11237,1188,ITF,ITF3,15,Campania
2021-03-31,LIG,11993,5331,6662,9223,2770,ITC,ITC3,7,Liguria
2021-04-24,PUG,29294,13335,15959,25349,3945,ITF,ITF4,16,Puglia
2021-04-09,LOM,52314,22358,29956,36325,15989,ITC,ITC4,3,Lombardia
2021-05-31,LAZ,52374,23757,28617,32028,20346,ITI,ITI4,12,Lazio
2021-01-10,BAS,77,24,53,77,0,ITF,ITF5,17,Basilicata
2021-01-15,ABR,379,149,230,379,0,ITF,ITF1,13,Abruzzo
2021-02-07,MAR,1870,734,1136,344,1526,ITI,ITI3,11,Marche
2021-04-20,BAS,4033,1920,2113,2202,1831,ITF,ITF5,17,Basilicata
2021-01-11,TOS,5094,1691,3403,5094,0,ITI,ITI1,9,Toscana
2021-04-11,EMR,15276,6933,8343,12228,3048,ITH,ITH5,8,Emilia-Romagna
2021-04-19,PAB,1871,858,1013,1689,182,ITH,ITH1,4,Provincia Autonoma Bolzano / Bozen
2021-05-28,VDA,975,414,561,563,412,ITC,ITC2,2,Valle d'Aosta / Vallée d'Aoste
2021-05-24,SAR,14044,6903,7141,8481,5563,ITG,ITG2,20,Sardegna
2021-02-17,VDA,327,144,183,227,100,ITC,ITC2,2,Valle d'Aosta / Vallée d'Aoste
2021-04-21,TOS,29602,12664,16938,17517,12085,ITI,ITI1,9,Toscana
2021-04-23,VEN,31174,13810,17364,22471,8703,ITH,ITH3,5,Veneto
2021-01-23,FVG,816,324,492,4,812,ITH,ITH4,6,Friuli-Venezia Giulia
2021-02-13,SAR,1456,565,891,1454,2,ITG,ITG2,20,Sardegna
2021-02-23,TOS,7721,3324,4397,7560,161,ITI,ITI1,9,Toscana
2021-04-04,LAZ,17462,8035,9427,12196,5266,ITI,ITI4,12,Lazio
2021-04-09,CAM,30147,14256,15891,24019,6128,ITF,ITF3,15,Campania
2021-04-05,MOL,391,189,202,292,99,ITF,ITF2,14,Molise
2021-05-05,PAT,4979,2576,2403,4689,290,ITH,ITH2,4,Provincia Autonoma Trento
2021-06-03,TOS,31943,15396,16547,27407,4536,ITI,ITI1,9,Toscana
2021-06-05,CAM,76973,37248,39725,70960,6013,ITF,ITF3,15,Campania
2021-01-08,BAS,554,219,335,554,0,ITF,ITF5,17,Basilicata
2021-03-29,MOL,2033,835,1198,1547,486,ITF,ITF2,14,Molise
2021-02-16,VEN,6642,2871,3771,6465,177,ITH,ITH3,5,Veneto
2021-04-04,LOM,7611,3230,4381,3716,3895,ITC,ITC4,3,Lombardia
2021-01-31,MOL,268,70,198,6,262,ITF,ITF2,14,Molise
2021-02-11,EMR,4256,1416,2840,3415,841,ITH,ITH5,8,Emilia-Romagna
2021-04-27,ABR,9085,4370,4715,6617,2468,ITF,ITF1,13,Abruzzo
2021-03-15,BAS,2355,983,1372,524,1831,ITF,ITF5,17,Basilicata
2021-05-29,SAR,17971,8638,9333,13379,4592,ITG,ITG2,20,Sardegna
2021-01-16,PAT,319,148,171,319,0,ITH,ITH2,4,Provincia Autonoma Trento
2021-01-17,BAS,328,133,195,327,1,ITF,ITF5,17,Basilicata
2021-05-05,FVG,9720,4234,5486,6279,3441,ITH,ITH4,6,Friuli-Venezia Giulia
2021-02-18,SAR,1878,732,1146,1814,64,ITG,ITG2,20,Sardegna
2021-04-04,SIC,6824,3325,3499,5532,1292,ITG,ITG1,19,Sicilia
2021-01-23,PIE,4257,1325,2932,879,3378,ITC,ITC1,1,Piemonte
2021-04-17,PAB,5233,2599,2634,5189,44,ITH,ITH1,4,Provincia Autonoma Bolzano / Bozen
2021-01-07,PAB,918,327,591,918,0,ITH,ITH1,4,Provincia Autonoma Bolzano / Bozen
2021-01-14,PUG,4070,1589,2481,4070,0,ITF,ITF4,16,Puglia
2021-03-21,PIE,10724,4739,5985,4191,6533,ITC,ITC1,1,Piemonte
2021-01-07,PUG,5717,2458,3259,5717,0,ITF,ITF4,16,Puglia
2021-01-31,MAR,1918,769,1149,103,1815,ITI,ITI3,11,Marche
2021-04-02,LOM,41156,16840,24316,26709,14447,ITC,ITC4,3,Lombardia
2021-04-17,PUG,39874,18892,20982,36306,3568,ITF,ITF4,16,Puglia
2021-02-25,CAL,2882,1551,1331,2287,595,ITF,ITF6,18,Calabria
2021-05-29,VEN,32862,16604,16258,25304,7558,ITH,ITH3,5,Veneto
2020-12-28,LIG,80,30,50,80,0,ITC,ITC3,7,Liguria
2021-01-25,FVG,1583,567,1016,194,1389,ITH,ITH4,6,Friuli-Venezia Giulia
2021-02-19,PUG,4731,2010,2721,4339,392,ITF,ITF4,16,Puglia
2021-04-27,BAS,4727,2242,2485,4402,325,ITF,ITF5,17,Basilicata
2021-06-03,LIG,15461,7665,7796,9123,6338,ITC,ITC3,7,Liguria
2021-03-23,FVG,4131,1907,2224,1991,2140,ITH,ITH4,6,Friuli-Venezia Giulia
2021-04-07,LIG,13663,6103,7560,11372,2291,ITC,ITC3,7,Liguria
2021-03-15,ABR,3740,1503,2237,1932,1808,ITF,ITF1,13,Abruzzo
2021-04-07,MAR,7810,3435,4375,7475,335,ITI,ITI3,11,Marche
2021-02-10,VDA,248,77,171,141,107,ITC,ITC2,2,Valle d'Aosta / Vallée d'Aoste
2021-01-17,ABR,188,59,129,181,7,ITF,ITF1,13,Abruzzo
2021-02-09,MAR,124,42,82,46,78,ITI,ITI3,11,Marche
2021-02-23,LIG,3806,1559,2247,3697,109,ITC,ITC3,7,Liguria
2021-05-12,UMB,6480,3016,3464,4337,2143,ITI,ITI2,10,Umbria
2021-04-18,EMR,17509,8400,9109,12581,4928,ITH,ITH5,8,Emilia-Romagna
2021-04-28,PAT,4244,1973,2271,4106,138,ITH,ITH2,4,Provincia Autonoma Trento
2021-04-26,PUG,26187,11998,14189,22954,3233,ITF,ITF4,16,Puglia
2021-05-05,PIE,32161,15066,17095,19145,13016,ITC,ITC1,1,Piemonte
2021-05-31,SAR,11637,5670,5967,8253,3384,ITG,ITG2,20,Sardegna
2021-02-18,VEN,5828,2455,3373,5764,64,ITH,ITH3,5,Veneto
2021-04-14,TOS,20165,8335,11830,15058,5107,ITI,ITI1,9,Toscana
2021-05-12,PAT,3299,1491,1808,2114,1185,ITH,ITH2,4,Provincia Autonoma Trento
2021-02-18,CAM,9081,3813,5268,8373,708,ITF,ITF3,15,Campania
2021-02-28,PUG,6048,1806,4242,5862,186,ITF,ITF4,16,Puglia
2021-06-03,MAR,14650,7483,7167,12387,2263,ITI,ITI3,11,Marche
2021-03-16,PAT,1391,506,885,608,783,ITH,ITH2,4,Provincia Autonoma Trento
2021-05-25,MOL,1963,887,1076,1333,630,ITF,ITF2,14,Molise
2021-06-08,PAB,4143,2115,2028,828,3315,ITH,ITH1,4,Provincia Autonoma Bolzano / Bozen
2021-01-15,EMR,7750,2404,5346,7750,0,ITH,ITH5,8,Emilia-Romagna
2021-05-14,PAT,5306,2536,2770,3932,1374,ITH,ITH2,4,Provincia Autonoma Trento
2021-02-02,ABR,1761,667,1094,222,1539,ITF,ITF1,13,Abruzzo
2021-05-13,ABR,11152,5045,6107,7192,3960,ITF,ITF1,13,Abruzzo
2021-02-08,PIE,6917,2356,4561,666,6251,ITC,ITC1,1,Piemonte
2021-01-03,LAZ,5251,1973,3278,5251,0,ITI,ITI4,12,Lazio
2021-05-12,PUG,36336,16215,20121,23877,12459,ITF,ITF4,16,Puglia
2021-01-04,MOL,314,131,183,314,0,ITF,ITF2,14,Molise
2021-04-25,CAM,30731,15171,15560,25339,5392,ITF,ITF3,15,Campania
2021-01-01,SIC,817,437,380,817,0,ITG,ITG1,19,Sicilia
2021-03-31,ABR,6769,2992,3777,4699,2070,ITF,ITF1,13,Abruzzo
2021-04-13,LAZ,25672,11873,13799,17959,7713,ITI,ITI4,12,Lazio
2021-04-14,MOL,1806,767,1039,1145,661,ITF,ITF2,14,Molise
2021-04-08,FVG,7379,3173,4206,5457,1922,ITH,ITH4,6,Friuli-Venezia Giulia
2021-02-16,MOL,156,70,86,150,6,ITF,ITF2,14,Molise
2021-04-20,SIC,19122,9011,10111,13874,5248,ITG,ITG1,19,Sicilia
2021-02-18,MAR,2101,745,1356,1815,286,ITI,ITI3,11,Marche
2021-05-27,MOL,2834,1348,1486,1998,836,ITF,ITF2,14,Molise
2021-04-23,LIG,14673,6638,8035,8553,6120,ITC,ITC3,7,Liguria
2021-05-21,FVG,11130,4981,6149,8170,2960,ITH,ITH4,6,Friuli-Venezia Giulia
2021-06-09,EMR,41290,21013,20277,35490,5800,ITH,ITH5,8,Emilia-Romagna
2021-05-29,MAR,12788,6194,6594,8260,4528,ITI,ITI3,11,Marche
2021-01-24,BAS,837,300,537,58,779,ITF,ITF5,17,Basilicata
2021-02-10,FVG,1352,496,856,1266,86,ITH,ITH4,6,Friuli-Venezia Giulia
2021-03-01,EMR,10099,3582,6517,7841,2258,ITH,ITH5,8,Emilia-Romagna
2021-05-02,VEN,37238,17263,19975,26903,10335,ITH,ITH3,5,Veneto
2021-05-15,ABR,11421,5174,6247,6126,5295,ITF,ITF1,13,Abruzzo
2021-02-01,FVG,2097,688,1409,16,2081,ITH,ITH4,6,Friuli-Venezia Giulia
2021-03-11,LIG,6427,3119,3308,4421,2006,ITC,ITC3,7,Liguria
2021-05-28,UMB,9601,4459,5142,7268,2333,ITI,ITI2,10,Umbria
2021-01-13,LIG,2754,1013,1741,2754,0,ITC,ITC3,7,Liguria
2021-05-13,BAS,5982,2966,3016,3385,2597,ITF,ITF5,17,Basilicata
2021-06-08,VDA,712,356,356,679,33,ITC,ITC2,2,Valle d'Aosta / Vallée d'Aoste
2021-05-04,EMR,29263,13701,15562,15604,13659,ITH,ITH5,8,Emilia-Romagna
2021-01-08,LAZ,7729,2895,4834,7729,0,ITI,ITI4,12,Lazio
2021-01-13,CAM,8020,3666,4354,8020,0,ITF,ITF3,15,Campania
2021-04-15,UMB,7630,3484,4146,5744,1886,ITI,ITI2,10,Umbria
2021-02-08,PAT,1151,318,833,342,809,ITH,ITH2,4,Provincia Autonoma Trento
2021-03-04,TOS,18062,7134,10928,14980,3082,ITI,ITI1,9,Toscana
2021-03-06,VEN,10667,4356,6311,7405,3262,ITH,ITH3,5,Veneto
2021-04-28,PAB,2464,1302,1162,2459,5,ITH,ITH1,4,Provincia Autonoma Bolzano / Bozen
2021-02-17,UMB,1618,748,870,1267,351,ITI,ITI2,10,Umbria
2021-05-21,PIE,36000,16729,19271,20381,15619,ITC,ITC1,1,Piemonte
2021-01-04,LIG,2615,854,1761,2615,0,ITC,ITC3,7,Liguria
2021-01-23,PUG,3040,1294,1746,886,2154,ITF,ITF4,16,Puglia
2021-05-29,MOL,2328,1207,1121,1941,387,ITF,ITF2,14,Molise
2021-03-13,CAL,6846,2987,3859,5876,970,ITF,ITF6,18,Calabria
2021-05-03,PUG,33251,14868,18383,22630,10621,ITF,ITF4,16,Puglia
2021-02-27,EMR,10967,3999,6968,9229,1738,ITH,ITH5,8,Emilia-Romagna
2021-03-07,PUG,4982,1999,2983,4411,571,ITF,ITF4,16,Puglia
2020-12-30,VEN,699,245,454,699,0,ITH,ITH3,5,Veneto
2021-04-25,EMR,22345,10240,12105,14837,7508,ITH,ITH5,8,Emilia-Romagna
2021-01-01,SAR,32,17,15,32,0,ITG,ITG2,20,Sardegna
2021-02-16,MAR,1288,475,813,1258,30,ITI,ITI3,11,Marche
2021-02-26,VDA,207,58,149,122,85,ITC,ITC2,2,Valle d'Aosta / Vallée d'Aoste
2021-04-13,UMB,7680,3401,4279,6011,1669,ITI,ITI2,10,Umbria
2021-05-14,FVG,10709,5333,5376,8135,2574,ITH,ITH4,6,Friuli-Venezia Giulia
2021-02-25,MAR,3510,1434,2076,3331,179,ITI,ITI3,11,Marche
2021-02-27,SAR,1921,647,1274,1366,555,ITG,ITG2,20,Sardegna
2021-02-03,FVG,2647,791,1856,23,2624,ITH,ITH4,6,Friuli-Venezia Giulia
2021-02-15,UMB,1368,692,676,1367,1,ITI,ITI2,10,Umbria
2021-02-01,PIE,8645,3055,5590,579,8066,ITC,ITC1,1,Piemonte
2021-04-18,CAM,27218,13283,13935,18318,8900,ITF,ITF3,15,Campania
2021-05-08,BAS,4835,2399,2436,3429,1406,ITF,ITF5,17,Basilicata
2021-06-05,MAR,13853,6963,6890,11795,2058,ITI,ITI3,11,Marche
2021-01-15,CAL,2799,1258,1541,2799,0,ITF,ITF6,18,Calabria
2021-04-10,VDA,404,190,214,399,5,ITC,ITC2,2,Valle d'Aosta / Vallée d'Aoste
2021-01-08,CAM,10454,4967,5487,10454,0,ITF,ITF3,15,Campania
2021-01-16,PAB,2840,1265,1575,2840,0,ITH,ITH1,4,Provincia Autonoma Bolzano / Bozen
2020-12-31,VDA,18,4,14,18,0,ITC,ITC2,2,Valle d'Aosta / Vallée d'Aoste
2021-01-03,UMB,270,112,158,270,0,ITI,ITI2,10,Umbria
2021-02-20,LOM,9335,3867,5468,9038,297,ITC,ITC4,3,Lombardia
2021-04-25,CAL,15828,8032,7796,14694,1134,ITF,ITF6,18,Calabria
2021-05-05,PUG,39035,17108,21927,24890,14145,ITF,ITF4,16,Puglia
2021-06-06,VDA,1160,582,578,787,373,ITC,ITC2,2,Valle d'Aosta / Vallée d'Aoste
2021-04-23,MAR,11159,5140,6019,8104,3055,ITI,ITI3,11,Marche
2021-05-21,PAT,5033,2414,2619,3337,1696,ITH,ITH2,4,Provincia Autonoma Trento
2021-01-06,TOS,4520,1460,3060,4520,0,ITI,ITI1,9,Toscana
2021-03-10,ABR,5073,1707,3366,4117,956,ITF,ITF1,13,Abruzzo
2021-04-16,LIG,11970,5280,6690,10160,1810,ITC,ITC3,7,Liguria
2021-04-18,LOM,36344,16204,20140,31114,5230,ITC,ITC4,3,Lombardia
2021-04-27,CAM,32154,15621,16533,24234,7920,ITF,ITF3,15,Campania
2021-06-07,VEN,44276,23111,21165,37323,6953,ITH,ITH3,5,Veneto
2021-01-08,LOM,12698,3918,8780,12698,0,ITC,ITC4,3,Lombardia
2021-06-10,PAB,4387,2273,2114,1302,3085,ITH,ITH1,4,Provincia Autonoma Bolzano / Bozen
2021-02-27,VEN,8988,2691,6297,8141,847,ITH,ITH3,5,Veneto
2021-01-26,ABR,1542,567,975,30,1512,ITF,ITF1,13,Abruzzo
2021-02-09,MOL,359,170,189,197,162,ITF,ITF2,14,Molise
2021-01-06,LIG,1660,616,1044,1660,0,ITC,ITC3,7,Liguria
2021-05-07,SIC,36492,17245,19247,24921,11571,ITG,ITG1,19,Sicilia
2021-06-02,TOS,27545,13598,13947,22041,5504,ITI,ITI1,9,Toscana
2021-01-02,ABR,549,219,330,549,0,ITF,ITF1,13,Abruzzo
2021-03-11,SIC,15569,6838,8731,13199,2370,ITG,ITG1,19,Sicilia
2021-04-06,TOS,22214,9815,12399,18500,3714,ITI,ITI1,9,Toscana
2021-04-25,FVG,2365,990,1375,2354,11,ITH,ITH4,6,Friuli-Venezia Giulia
2021-05-23,EMR,25451,11854,13597,13885,11566,ITH,ITH5,8,Emilia-Romagna
2021-06-08,ABR,12640,6499,6141,10444,2196,ITF,ITF1,13,Abruzzo
2021-02-08,TOS,4097,1360,2737,3638,459,ITI,ITI1,9,Toscana
2021-04-01,CAL,8486,3844,4642,3983,4503,ITF,ITF6,18,Calabria
2021-01-27,SIC,7278,3711,3567,180,7098,ITG,ITG1,19,Sicilia
2021-04-26,ABR,8563,4066,4497,7349,1214,ITF,ITF1,13,Abruzzo
2021-05-19,TOS,27914,13556,14358,18882,9032,ITI,ITI1,9,Toscana
2021-05-21,CAM,63610,29544,34066,43180,20430,ITF,ITF3,15,Campania
2021-01-30,LIG,1660,566,1094,24,1636,ITC,ITC3,7,Liguria
2021-03-23,VEN,22301,10319,11982,17582,4719,ITH,ITH3,5,Veneto
2021-05-15,PAB,6997,3685,3312,6702,295,ITH,ITH1,4,Provincia Autonoma Bolzano / Bozen
2021-02-03,LAZ,6487,2487,4000,963,5524,ITI,ITI4,12,Lazio
2021-02-04,PAB,1958,593,1365,8,1950,ITH,ITH1,4,Provincia Autonoma Bolzano / Bozen
2021-05-19,VEN,32779,15015,17764,16896,15883,ITH,ITH3,5,Veneto
2021-01-13,SIC,5120,2422,2698,5120,0,ITG,ITG1,19,Sicilia
2021-01-15,FVG,2021,605,1416,2021,0,ITH,ITH4,6,Friuli-Venezia Giulia
2021-06-01,ABR,10994,4879,6115,6630,4364,ITF,ITF1,13,Abruzzo
2021-03-28,LIG,1141,511,630,390,751,ITC,ITC3,7,Liguria
2021-05-07,SAR,14196,6491,7705,9696,4500,ITG,ITG2,20,Sardegna
2021-04-13,TOS,8488,3507,4981,6030,2458,ITI,ITI1,9,Toscana
2021-01-20,LAZ,4806,1942,2864,3263,1543,ITI,ITI4,12,Lazio
2021-01-27,SAR,1411,496,915,79,1332,ITG,ITG2,20,Sardegna
2021-03-28,MAR,4126,1739,2387,2435,1691,ITI,ITI3,11,Marche
2021-01-08,PAT,1449,313,1136,1449,0,ITH,ITH2,4,Provincia Autonoma Trento
2021-01-31,VDA,291,91,200,58,233,ITC,ITC2,2,Valle d'Aosta / Vallée d'Aoste
2021-01-30,MAR,1905,668,1237,28,1877,ITI,ITI3,11,Marche
2021-02-27,PIE,12691,4851,7840,12346,345,ITC,ITC1,1,Piemonte
2021-03-25,SAR,9407,4224,5183,8100,1307,ITG,ITG2,20,Sardegna
2021-06-08,BAS,4574,2185,2389,4217,357,ITF,ITF5,17,Basilicata
2021-04-18,PAT,1855,845,1010,1846,9,ITH,ITH2,4,Provincia Autonoma Trento
2021-04-16,PUG,35880,16867,19013,32599,3281,ITF,ITF4,16,Puglia
2021-04-25,PIE,20232,9305,10927,17731,2501,ITC,ITC1,1,Piemonte
2021-05-14,LAZ,51030,23306,27724,32760,18270,ITI,ITI4,12,Lazio
2021-05-21,SAR,21140,10362,10778,15489,5651,ITG,ITG2,20,Sardegna
2021-02-08,VEN,4976,1541,3435,1929,3047,ITH,ITH3,5,Veneto
2021-04-02,PAB,2077,837,1240,720,1357,ITH,ITH1,4,Provincia Autonoma Bolzano / Bozen
2021-01-15,PIE,9114,3012,6102,9114,0,ITC,ITC1,1,Piemonte
2021-02-18,PUG,4378,1845,2533,3774,604,ITF,ITF4,16,Puglia
2021-03-18,LAZ,14227,6079,8148,7836,6391,ITI,ITI4,12,Lazio
2021-05-07,LOM,92205,43667,48538,69879,22326,ITC,ITC4,3,Lombardia
2021-03-06,PAT,785,277,508,634,151,ITH,ITH2,4,Provincia Autonoma Trento
2021-04-06,VEN,28904,13301,15603,23836,5068,ITH,ITH3,5,Veneto
2021-05-29,PAB,7131,3767,3364,3994,3137,ITH,ITH1,4,Provincia Autonoma Bolzano / Bozen
2021-01-28,MOL,613,217,396,17,596,ITF,ITF2,14,Molise
2021-03-13,PIE,13045,4721,8324,11601,1444,ITC,ITC1,1,Piemonte
2021-04-01,CAM,24596,11928,12668,20463,4133,ITF,ITF3,15,Campania
2021-03-18,LOM,27377,10951,16426,16146,11231,ITC,ITC4,3,Lombardia
2021-04-08,CAL,9389,4426,4963,5801,3588,ITF,ITF6,18,Calabria
2021-04-09,PUG,21991,9476,12515,17369,4622,ITF,ITF4,16,Puglia
2021-05-28,CAM,73495,35787,37708,27134,46361,ITF,ITF3,15,Campania
2021-02-10,CAL,2510,1078,1432,884,1626,ITF,ITF6,18,Calabria
2021-02-11,PUG,3699,1401,2298,2421,1278,ITF,ITF4,16,Puglia
2021-05-14,LOM,85738,41314,44424,55607,30131,ITC,ITC4,3,Lombardia
2021-03-12,MOL,1459,637,822,1423,36,ITF,ITF2,14,Molise
2021-04-11,PAT,2340,1135,1205,2249,91,ITH,ITH2,4,Provincia Autonoma Trento
2021-04-12,BAS,2170,1051,1119,1679,491,ITF,ITF5,17,Basilicata
2021-05-10,MAR,9446,4335,5111,4895,4551,ITI,ITI3,11,Marche
2021-05-22,PUG,34249,15679,18570,23939,10310,ITF,ITF4,16,Puglia
2021-01-14,MOL,646,239,407,646,0,ITF,ITF2,14,Molise
2021-03-14,MAR,2499,1032,1467,1907,592,ITI,ITI3,11,Marche
2021-06-04,CAL,17317,8060,9257,12774,4543,ITF,ITF6,18,Calabria
2021-01-20,SIC,785,398,387,531,254,ITG,ITG1,19,Sicilia
2021-04-18,FVG,6038,2799,3239,5631,407,ITH,ITH4,6,Friuli-Venezia Giulia
2021-04-19,ABR,6227,2858,3369,3855,2372,ITF,ITF1,13,Abruzzo
2021-01-08,FVG,2322,747,1575,2322,0,ITH,ITH4,6,Friuli-Venezia Giulia
2021-02-21,ABR,1218,550,668,1217,1,ITF,ITF1,13,Abruzzo
2021-05-26,TOS,35451,17017,18434,20305,15146,ITI,ITI1,9,Toscana
2021-05-11,UMB,6230,2828,3402,4028,2202,ITI,ITI2,10,Umbria
2021-05-14,CAM,60870,27529,33341,36320,24550,ITF,ITF3,15,Campania
2021-03-30,TOS,17170,7782,9388,13607,3563,ITI,ITI1,9,Toscana
2021-05-21,CAL,21346,10866,10480,13979,7367,ITF,ITF6,18,Calabria
2021-02-20,FVG,2068,933,1135,1924,144,ITH,ITH4,6,Friuli-Venezia Giulia
2021-03-18,SIC,15284,7663,7621,9789,5495,ITG,ITG1,19,Sicilia
2021-01-22,FVG,90,30,60,0,90,ITH,ITH4,6,Friuli-Venezia Giulia
2021-02-01,VEN,8560,2502,6058,161,8399,ITH,ITH3,5,Veneto
2021-03-26,PAB,1655,731,924,522,1133,ITH,ITH1,4,Provincia Autonoma Bolzano / Bozen
2021-04-12,ABR,6226,2951,3275,5051,1175,ITF,ITF1,13,Abruzzo
2021-02-06,LIG,1892,768,1124,145,1747,ITC,ITC3,7,Liguria
2021-03-06,FVG,3500,1196,2304,3175,325,ITH,ITH4,6,Friuli-Venezia Giulia
2021-03-18,SAR,7257,3071,4186,5652,1605,ITG,ITG2,20,Sardegna
2021-02-15,VEN,4389,1824,2565,4149,240,ITH,ITH3,5,Veneto
2021-02-27,PAT,1029,457,572,608,421,ITH,ITH2,4,Provincia Autonoma Trento
2021-04-09,PAB,2937,1301,1636,2207,730,ITH,ITH1,4,Provincia Autonoma Bolzano / Bozen
2021-04-19,BAS,4164,1911,2253,2526,1638,ITF,ITF5,17,Basilicata
2021-05-14,SAR,14013,6490,7523,10728,3285,ITG,ITG2,20,Sardegna
2021-01-01,PAT,213,50,163,213,0,ITH,ITH2,4,Provincia Autonoma Trento
2021-06-07,PAT,5778,2874,2904,2795,2983,ITH,ITH2,4,Provincia Autonoma Trento
2021-02-03,SAR,1119,419,700,426,693,ITG,ITG2,20,Sardegna
2021-03-21,MAR,4504,1873,2631,1629,2875,ITI,ITI3,11,Marche
2021-04-18,PIE,22961,10819,12142,20205,2756,ITC,ITC1,1,Piemonte
2021-03-30,VEN,35955,15306,20649,30703,5252,ITH,ITH3,5,Veneto
2021-01-25,LIG,2722,888,1834,477,2245,ITC,ITC3,7,Liguria
2021-01-23,PAB,197,117,80,0,197,ITH,ITH1,4,Provincia Autonoma Bolzano / Bozen
2021-04-03,UMB,2111,716,1395,1058,1053,ITI,ITI2,10,Umbria
2021-03-18,VEN,12611,5137,7474,7385,5226,ITH,ITH3,5,Veneto
2021-05-05,LIG,13717,6136,7581,5296,8421,ITC,ITC3,7,Liguria
2021-03-06,SAR,2639,1079,1560,858,1781,ITG,ITG2,20,Sardegna
2021-02-27,SIC,12241,5502,6739,11037,1204,ITG,ITG1,19,Sicilia
2021-03-11,FVG,3587,1612,1975,1836,1751,ITH,ITH4,6,Friuli-Venezia Giulia
2021-05-27,ABR,13012,5959,7053,8331,4681,ITF,ITF1,13,Abruzzo
2021-05-03,PAB,1830,847,983,417,1413,ITH,ITH1,4,Provincia Autonoma Bolzano / Bozen
2021-03-05,BAS,1855,857,998,1109,746,ITF,ITF5,17,Basilicata
2021-06-02,PIE,26522,12997,13525,22056,4466,ITC,ITC1,1,Piemonte
2021-02-23,PAB,769,324,445,763,6,ITH,ITH1,4,Provincia Autonoma Bolzano / Bozen
2021-02-04,MAR,2342,809,1533,112,2230,ITI,ITI3,11,Marche
2021-02-22,PIE,8483,3472,5011,7893,590,ITC,ITC1,1,Piemonte
2021-04-13,PAT,2554,1058,1496,2047,507,ITH,ITH2,4,Provincia Autonoma Trento
2021-01-20,PAT,291,73,218,279,12,ITH,ITH2,4,Provincia Autonoma Trento
2021-05-17,PAB,3134,1516,1618,2440,694,ITH,ITH1,4,Provincia Autonoma Bolzano / Bozen
2021-03-02,PUG,16371,6084,10287,15071,1300,ITF,ITF4,16,Puglia
2021-04-06,SAR,7457,3122,4335,5028,2429,ITG,ITG2,20,Sardegna
2021-04-25,LOM,51484,23609,27875,46748,4736,ITC,ITC4,3,Lombardia
2021-03-13,LAZ,21776,8705,13071,15882,5894,ITI,ITI4,12,Lazio
2021-03-17,VDA,433,185,248,273,160,ITC,ITC2,2,Valle d'Aosta / Vallée d'Aoste
2021-04-30,PAT,4922,2401,2521,4771,151,ITH,ITH2,4,Provincia Autonoma Trento
2020-12-27,SAR,65,34,31,65,0,ITG,ITG2,20,Sardegna
2021-03-11,PIE,13772,5074,8698,10675,3097,ITC,ITC1,1,Piemonte
2021-06-03,PAB,4720,2564,2156,3774,946,ITH,ITH1,4,Provincia Autonoma Bolzano / Bozen
2021-06-10,PUG,45280,22549,22731,28722,16558,ITF,ITF4,16,Puglia
2021-03-03,VDA,255,118,137,187,68,ITC,ITC2,2,Valle d'Aosta / Vallée d'Aoste
2021-04-06,CAM,24459,11507,12952,19935,4524,ITF,ITF3,15,Campania
2021-05-19,PAT,5095,2454,2641,3842,1253,ITH,ITH2,4,Provincia Autonoma Trento
2021-04-04,PUG,5948,2953,2995,5943,5,ITF,ITF4,16,Puglia
2020-12-27,CAM,720,422,298,720,0,ITF,ITF3,15,Campania
2021-03-19,ABR,5795,2584,3211,2775,3020,ITF,ITF1,13,Abruzzo
2021-05-23,CAL,11368,5548,5820,7034,4334,ITF,ITF6,18,Calabria
2021-02-08,SIC,3882,1678,2204,2129,1753,ITG,ITG1,19,Sicilia
2021-01-18,MAR,677,233,444,547,130,ITI,ITI3,11,Marche
2021-03-01,CAL,2724,1546,1178,2269,455,ITF,ITF6,18,Calabria
2021-03-25,PIE,17062,7203,9859,8423,8639,ITC,ITC1,1,Piemonte
2021-05-27,BAS,3604,1856,1748,1072,2532,ITF,ITF5,17,Basilicata
2021-01-08,UMB,1190,345,845,1190,0,ITI,ITI2,10,Umbria
2021-01-09,MOL,450,152,298,450,0,ITF,ITF2,14,Molise
2021-04-20,CAM,32037,15499,16538,20727,11310,ITF,ITF3,15,Campania
2021-03-21,PUG,2692,1226,1466,588,2104,ITF,ITF4,16,Puglia
2021-04-06,LOM,43052,17581,25471,25118,17934,ITC,ITC4,3,Lombardia
2021-04-28,MAR,10734,4890,5844,6003,4731,ITI,ITI3,11,Marche
2021-06-09,CAL,17515,8216,9299,15280,2235,ITF,ITF6,18,Calabria
2021-03-05,ABR,5347,1958,3389,4650,697,ITF,ITF1,13,Abruzzo
2021-04-19,MOL,1827,842,985,1049,778,ITF,ITF2,14,Molise
2021-02-20,TOS,4640,1789,2851,4127,513,ITI,ITI1,9,Toscana
2021-04-13,FVG,7363,3289,4074,5759,1604,ITH,ITH4,6,Friuli-Venezia Giulia
2021-01-03,FVG,312,122,190,312,0,ITH,ITH4,6,Friuli-Venezia Giulia
2021-05-31,TOS,30401,14747,15654,19488,10913,ITI,ITI1,9,Toscana
2021-03-20,CAM,13975,6517,7458,10236,3739,ITF,ITF3,15,Campania
2021-06-04,EMR,45436,22927,22509,37338,8098,ITH,ITH5,8,Emilia-Romagna
2021-01-22,SIC,1250,630,620,243,1007,ITG,ITG1,19,Sicilia
2021-05-14,TOS,33267,15384,17883,20637,12630,ITI,ITI1,9,Toscana
2021-05-07,VEN,48357,23184,25173,39691,8666,ITH,ITH3,5,Veneto
2021-03-16,LIG,6073,2722,3351,2349,3724,ITC,ITC3,7,Liguria
2021-05-23,UMB,5068,1855,3213,652,4416,ITI,ITI2,10,Umbria
2021-01-27,VEN,7138,2062,5076,241,6897,ITH,ITH3,5,Veneto
2021-02-08,LAZ,9740,4153,5587,4508,5232,ITI,ITI4,12,Lazio
2021-04-25,SAR,4497,2269,2228,3718,779,ITG,ITG2,20,Sardegna
2021-01-08,SIC,8104,3776,4328,8104,0,ITG,ITG1,19,Sicilia
2021-01-20,FVG,748,320,428,13,735,ITH,ITH4,6,Friuli-Venezia Giulia
2021-04-07,ABR,7238,3365,3873,4477,2761,ITF,ITF1,13,Abruzzo
2021-01-15,SAR,1563,573,990,1563,0,ITG,ITG2,20,Sardegna
2021-04-18,SIC,19706,9849,9857,15346,4360,ITG,ITG1,19,Sicilia
2021-03-14,PAB,758,336,422,25,733,ITH,ITH1,4,Provincia Autonoma Bolzano / Bozen
2021-02-01,SAR,1524,605,919,225,1299,ITG,ITG2,20,Sardegna
2021-04-14,PAB,3593,1645,1948,3502,91,ITH,ITH1,4,Provincia Autonoma Bolzano / Bozen
2021-01-26,VDA,139,48,91,0,139,ITC,ITC2,2,Valle d'Aosta / Vallée d'Aoste
2021-04-24,BAS,4543,2197,2346,3531,1012,ITF,ITF5,17,Basilicata
2021-05-02,LAZ,32629,14336,18293,23268,9361,ITI,ITI4,12,Lazio
2021-05-09,SAR,6129,2874,3255,5203,926,ITG,ITG2,20,Sardegna
2021-01-04,PAB,508,201,307,508,0,ITH,ITH1,4,Provincia Autonoma Bolzano / Bozen
2021-01-11,PUG,3753,1588,2165,3753,0,ITF,ITF4,16,Puglia
2021-02-12,VDA,263,96,167,217,46,ITC,ITC2,2,Valle d'Aosta / Vallée d'Aoste
2021-06-02,PAT,2837,1358,1479,944,1893,ITH,ITH2,4,Provincia Autonoma Trento
2021-03-26,MAR,6331,2606,3725,3523,2808,ITI,ITI3,11,Marche
2021-04-13,PIE,25929,11608,14321,22469,3460,ITC,ITC1,1,Piemonte
2021-04-21,PUG,23074,10647,12427,19342,3732,ITF,ITF4,16,Puglia
2021-05-26,SAR,14913,7654,7259,9873,5040,ITG,ITG2,20,Sardegna
2021-02-13,VEN,3266,1473,1793,3246,20,ITH,ITH3,5,Veneto
2021-01-20,PIE,6617,2089,4528,5899,718,ITC,ITC1,1,Piemonte
2021-02-15,SAR,958,349,609,927,31,ITG,ITG2,20,Sardegna
2021-01-22,LAZ,4004,1635,2369,489,3515,ITI,ITI4,12,Lazio
2021-03-11,PAT,2298,851,1447,1474,824,ITH,ITH2,4,Provincia Autonoma Trento
2021-01-20,EMR,1325,270,1055,1324,1,ITH,ITH5,8,Emilia-Romagna
2021-05-24,PUG,36450,17545,18905,25187,11263,ITF,ITF4,16,Puglia
2021-02-15,CAM,5470,2516,2954,5297,173,ITF,ITF3,15,Campania
2021-01-12,VDA,302,72,230,302,0,ITC,ITC2,2,Valle d'Aosta / Vallée d'Aoste
2021-02-16,PUG,3380,1453,1927,2736,644,ITF,ITF4,16,Puglia
2021-05-08,ABR,10300,4876,5424,6465,3835,ITF,ITF1,13,Abruzzo
2021-01-10,CAL,931,525,406,931,0,ITF,ITF6,18,Calabria
2021-01-30,PUG,5527,2514,3013,410,5117,ITF,ITF4,16,Puglia
2021-02-03,PIE,10199,3303,6896,611,9588,ITC,ITC1,1,Piemonte
2021-02-18,TOS,8820,3284,5536,7925,895,ITI,ITI1,9,Toscana
2021-04-04,CAM,7965,4017,3948,6919,1046,ITF,ITF3,15,Campania
2021-01-02,MAR,454,139,315,454,0,ITI,ITI3,11,Marche
2021-02-13,CAL,1397,604,793,1032,365,ITF,ITF6,18,Calabria
2021-05-11,BAS,2654,1353,1301,1621,1033,ITF,ITF5,17,Basilicata
2021-05-29,TOS,31530,15243,16287,23387,8143,ITI,ITI1,9,Toscana
2021-06-10,VEN,50810,26335,24475,42119,8691,ITH,ITH3,5,Veneto
2021-02-17,ABR,2071,948,1123,1789,282,ITF,ITF1,13,Abruzzo
2021-03-04,SAR,4699,2610,2089,3444,1255,ITG,ITG2,20,Sardegna
2021-04-02,VEN,24018,10585,13433,17688,6330,ITH,ITH3,5,Veneto
2021-04-16,SIC,28554,14334,14220,20290,8264,ITG,ITG1,19,Sicilia
2021-05-17,PIE,30828,14552,16276,17716,13112,ITC,ITC1,1,Piemonte
2021-02-06,PIE,7995,2666,5329,400,7595,ITC,ITC1,1,Piemonte
2021-01-23,SIC,4375,2254,2121,214,4161,ITG,ITG1,19,Sicilia
2021-02-23,PIE,9234,3713,5521,8653,581,ITC,ITC1,1,Piemonte
2021-03-04,CAM,14752,5438,9314,8857,5895,ITF,ITF3,15,Campania
2021-03-12,PAB,1664,734,930,1251,413,ITH,ITH1,4,Provincia Autonoma Bolzano / Bozen
2021-03-21,SAR,4030,1809,2221,2590,1440,ITG,ITG2,20,Sardegna
2021-06-11,ABR,7326,3631,3695,5681,1645,ITF,ITF1,13,Abruzzo
2021-01-06,SIC,6230,3281,2949,6230,0,ITG,ITG1,19,Sicilia
2021-03-29,PAB,1171,499,672,412,759,ITH,ITH1,4,Provincia Autonoma Bolzano / Bozen
2021-05-31,PIE,29123,14092,15031,20493,8630,ITC,ITC1,1,Piemonte
2021-01-18,PAT,643,154,489,588,55,ITH,ITH2,4,Provincia Autonoma Trento
2021-03-09,PIE,13967,5428,8539,11624,2343,ITC,ITC1,1,Piemonte
2021-03-21,LOM,23506,8492,15014,18313,5193,ITC,ITC4,3,Lombardia
2021-05-11,ABR,10739,5098,5641,5909,4830,ITF,ITF1,13,Abruzzo
2021-04-02,SIC,13852,6531,7321,9119,4733,ITG,ITG1,19,Sicilia
2021-02-10,SIC,4355,1777,2578,3973,382,ITG,ITG1,19,Sicilia
2021-03-23,TOS,10002,4917,5085,7728,2274,ITI,ITI1,9,Toscana
2021-03-07,MAR,5179,2106,3073,4425,754,ITI,ITI3,11,Marche
2021-03-13,EMR,16176,6401,9775,10863,5313,ITH,ITH5,8,Emilia-Romagna
2021-05-21,SIC,45756,21570,24186,24373,21383,ITG,ITG1,19,Sicilia
2021-03-02,MOL,667,383,284,509,158,ITF,ITF2,14,Molise
2021-06-09,VEN,41959,21518,20441,34791,7168,ITH,ITH3,5,Veneto
2021-06-11,CAL,10028,4970,5058,8330,1698,ITF,ITF6,18,Calabria
2021-02-13,LOM,6417,2441,3976,4941,1476,ITC,ITC4,3,Lombardia
2021-04-20,UMB,5439,2356,3083,3492,1947,ITI,ITI2,10,Umbria
2021-06-10,MOL,2477,1134,1343,1189,1288,ITF,ITF2,14,Molise
2021-01-08,CAL,2136,1024,1112,2136,0,ITF,ITF6,18,Calabria
2021-04-05,BAS,723,233,490,421,302,ITF,ITF5,17,Basilicata
2021-01-27,UMB,840,330,510,13,827,ITI,ITI2,10,Umbria
2021-03-27,EMR,21652,9063,12589,14743,6909,ITH,ITH5,8,Emilia-Romagna
2021-05-07,CAM,59745,29194,30551,43800,15945,ITF,ITF3,15,Campania
2021-03-18,CAL,4399,2052,2347,2344,2055,ITF,ITF6,18,Calabria
2020-12-30,TOS,327,104,223,327,0,ITI,ITI1,9,Toscana
2021-01-10,UMB,1070,277,793,1070,0,ITI,ITI2,10,Umbria
2021-01-27,CAM,7738,3820,3918,162,7576,ITF,ITF3,15,Campania
2021-04-13,EMR,23680,11108,12572,19377,4303,ITH,ITH5,8,Emilia-Romagna
2021-06-04,FVG,11795,6140,5655,10516,1279,ITH,ITH4,6,Friuli-Venezia Giulia
2021-05-21,UMB,8958,3663,5295,4124,4834,ITI,ITI2,10,Umbria
2021-01-03,EMR,2763,943,1820,2763,0,ITH,ITH5,8,Emilia-Romagna
2021-03-22,BAS,1181,532,649,633,548,ITF,ITF5,17,Basilicata
2021-05-04,UMB,5534,2544,2990,2410,3124,ITI,ITI2,10,Umbria
2021-04-01,LAZ,29408,13856,15552,22267,7141,ITI,ITI4,12,Lazio
2021-01-13,SAR,573,178,395,573,0,ITG,ITG2,20,Sardegna
2021-04-01,UMB,4374,1836,2538,2366,2008,ITI,ITI2,10,Umbria
2021-05-24,LIG,11952,5683,6269,9468,2484,ITC,ITC3,7,Liguria
2021-01-21,PAB,953,442,511,139,814,ITH,ITH1,4,Provincia Autonoma Bolzano / Bozen
2021-05-25,VDA,1115,530,585,541,574,ITC,ITC2,2,Valle d'Aosta / Vallée d'Aoste
2021-03-13,FVG,2937,1122,1815,1666,1271,ITH,ITH4,6,Friuli-Venezia Giulia
2021-01-25,VEN,6468,2075,4393,159,6309,ITH,ITH3,5,Veneto
2021-02-14,VDA,48,16,32,1,47,ITC,ITC2,2,Valle d'Aosta / Vallée d'Aoste
2021-04-05,ABR,2693,1147,1546,1813,880,ITF,ITF1,13,Abruzzo
2021-05-07,LIG,13590,6036,7554,5803,7787,ITC,ITC3,7,Liguria
2021-01-01,PIE,1038,395,643,1038,0,ITC,ITC1,1,Piemonte
2021-05-08,VDA,904,540,364,526,378,ITC,ITC2,2,Valle d'Aosta / Vallée d'Aoste
2021-01-13,LOM,26358,8053,18305,26358,0,ITC,ITC4,3,Lombardia
2021-02-13,LIG,1080,508,572,800,280,ITC,ITC3,7,Liguria
2021-03-03,BAS,1745,815,930,1186,559,ITF,ITF5,17,Basilicata
2021-04-02,MOL,1453,708,745,676,777,ITF,ITF2,14,Molise
2021-05-02,PAT,3512,1955,1557,3475,37,ITH,ITH2,4,Provincia Autonoma Trento
2021-06-07,LIG,15609,7633,7976,8625,6984,ITC,ITC3,7,Liguria
2021-01-16,MAR,2034,732,1302,2034,0,ITI,ITI3,11,Marche
2021-02-27,CAL,3994,2057,1937,3614,380,ITF,ITF6,18,Calabria
2021-05-25,BAS,4194,2110,2084,874,3320,ITF,ITF5,17,Basilicata
2021-04-01,SIC,14249,6612,7637,9585,4664,ITG,ITG1,19,Sicilia
2021-05-02,EMR,25574,11648,13926,13585,11989,ITH,ITH5,8,Emilia-Romagna
2021-05-12,TOS,34132,15549,18583,14160,19972,ITI,ITI1,9,Toscana
2021-05-08,MOL,2973,1454,1519,1729,1244,ITF,ITF2,14,Molise
2021-01-22,EMR,1829,477,1352,1088,741,ITH,ITH5,8,Emilia-Romagna
2021-03-01,UMB,1503,774,729,1389,114,ITI,ITI2,10,Umbria
2021-01-18,TOS,1119,636,483,1021,98,ITI,ITI1,9,Toscana
2021-04-20,VEN,22414,9488,12926,8416,13998,ITH,ITH3,5,Veneto
2021-04-21,MOL,1863,789,1074,968,895,ITF,ITF2,14,Molise
2021-02-08,EMR,5230,1534,3696,2318,2912,ITH,ITH5,8,Emilia-Romagna
2021-02-14,BAS,151,48,103,151,0,ITF,ITF5,17,Basilicata
2021-06-09,UMB,8013,3880,4133,7310,703,ITI,ITI2,10,Umbria
2021-05-16,EMR,25842,12167,13675,18730,7112,ITH,ITH5,8,Emilia-Romagna
2021-01-27,CAL,1459,734,725,397,1062,ITF,ITF6,18,Calabria
2021-01-28,PUG,5474,2278,3196,471,5003,ITF,ITF4,16,Puglia
2021-01-12,ABR,1804,666,1138,1804,0,ITF,ITF1,13,Abruzzo
2021-03-18,CAM,12174,5380,6794,5986,6188,ITF,ITF3,15,Campania
2021-04-15,LAZ,31907,14299,17608,21102,10805,ITI,ITI4,12,Lazio
2021-01-31,BAS,77,24,53,0,77,ITF,ITF5,17,Basilicata
2021-02-22,EMR,7482,3091,4391,7210,272,ITH,ITH5,8,Emilia-Romagna
2021-03-15,UMB,4636,1970,2666,2868,1768,ITI,ITI2,10,Umbria
2021-02-01,TOS,5509,1958,3551,521,4988,ITI,ITI1,9,Toscana
2021-05-03,LOM,83652,39736,43916,71531,12121,ITC,ITC4,3,Lombardia
2021-04-23,FVG,7459,3376,4083,3599,3860,ITH,ITH4,6,Friuli-Venezia Giulia
2021-01-11,EMR,9349,3274,6075,9349,0,ITH,ITH5,8,Emilia-Romagna
2021-01-23,LOM,1114,357,757,916,198,ITC,ITC4,3,Lombardia
2021-02-23,SAR,1537,1026,511,1285,252,ITG,ITG2,20,Sardegna
2021-04-12,MOL,1299,557,742,1048,251,ITF,ITF2,14,Molise
2021-06-10,TOS,26252,13527,12725,25669,583,ITI,ITI1,9,Toscana
2021-05-24,TOS,34045,16990,17055,24188,9857,ITI,ITI1,9,Toscana
2021-01-19,PUG,1221,452,769,1211,10,ITF,ITF4,16,Puglia
2021-02-15,LAZ,8026,3540,4486,7395,631,ITI,ITI4,12,Lazio
2021-01-25,TOS,5127,1896,3231,248,4879,ITI,ITI1,9,Toscana
2021-01-29,LAZ,8042,3079,4963,813,7229,ITI,ITI4,12,Lazio
2021-03-18,PAT,2319,957,1362,1239,1080,ITH,ITH2,4,Provincia Autonoma Trento
2021-03-21,PAB,768,285,483,14,754,ITH,ITH1,4,Provincia Autonoma Bolzano / Bozen
2021-01-09,MAR,1710,605,1105,1710,0,ITI,ITI3,11,Marche
2021-04-30,VEN,49967,23469,26498,34312,15655,ITH,ITH3,5,Veneto
2021-04-06,PIE,20240,8810,11430,15044,5196,ITC,ITC1,1,Piemonte
2021-05-02,SAR,5886,2669,3217,5305,581,ITG,ITG2,20,Sardegna
2021-05-30,UMB,5971,2992,2979,5780,191,ITI,ITI2,10,Umbria
2021-01-20,VEN,1038,368,670,386,652,ITH,ITH3,5,Veneto
2021-04-18,TOS,8338,4083,4255,7342,996,ITI,ITI1,9,Toscana
2020-12-27,PIE,913,369,544,913,0,ITC,ITC1,1,Piemonte
2021-04-02,MAR,6885,2983,3902,6146,739,ITI,ITI3,11,Marche
2021-05-14,CAL,19945,9592,10353,13071,6874,ITF,ITF6,18,Calabria
2021-03-08,UMB,3722,1847,1875,2359,1363,ITI,ITI2,10,Umbria
2021-06-09,PAT,6208,3066,3142,2157,4051,ITH,ITH2,4,Provincia Autonoma Trento
2021-01-14,PAB,1946,575,1371,1946,0,ITH,ITH1,4,Provincia Autonoma Bolzano / Bozen
2021-02-08,SAR,1470,533,937,856,614,ITG,ITG2,20,Sardegna
2021-03-16,MAR,3471,1485,1986,290,3181,ITI,ITI3,11,Marche
2021-04-27,CAL,9947,4890,5057,8003,1944,ITF,ITF6,18,Calabria
2021-01-19,VDA,256,77,179,256,0,ITC,ITC2,2,Valle d'Aosta / Vallée d'Aoste
2021-03-25,SIC,20388,9497,10891,14923,5465,ITG,ITG1,19,Sicilia
2021-04-07,PAB,1798,823,975,1258,540,ITH,ITH1,4,Provincia Autonoma Bolzano / Bozen
2021-02-03,CAL,2770,1429,1341,578,2192,ITF,ITF6,18,Calabria
2021-03-25,UMB,3904,1699,2205,2840,1064,ITI,ITI2,10,Umbria
2021-06-02,LIG,8531,4343,4188,5364,3167,ITC,ITC3,7,Liguria
2021-01-04,PUG,4508,2016,2492,4508,0,ITF,ITF4,16,Puglia
2021-04-12,VDA,486,186,300,323,163,ITC,ITC2,2,Valle d'Aosta / Vallée d'Aoste
2021-04-29,VDA,1291,634,657,757,534,ITC,ITC2,2,Valle d'Aosta / Vallée d'Aoste
2021-06-02,CAM,42736,20104,22632,38107,4629,ITF,ITF3,15,Campania
2021-02-17,LAZ,9184,4605,4579,8310,874,ITI,ITI4,12,Lazio
2021-02-22,CAM,10680,3294,7386,10417,263,ITF,ITF3,15,Campania
2021-03-02,PAB,695,200,495,693,2,ITH,ITH1,4,Provincia Autonoma Bolzano / Bozen
2021-03-07,MOL,1132,501,631,1130,2,ITF,ITF2,14,Molise
2021-04-06,PAT,2259,949,1310,1494,765,ITH,ITH2,4,Provincia Autonoma Trento
2021-04-17,BAS,3461,1655,1806,2199,1262,ITF,ITF5,17,Basilicata
2021-05-28,LAZ,56987,26543,30444,43694,13293,ITI,ITI4,12,Lazio
2021-03-11,CAM,18151,9213,8938,10872,7279,ITF,ITF3,15,Campania
2021-03-19,PAB,1906,773,1133,799,1107,ITH,ITH1,4,Provincia Autonoma Bolzano / Bozen
2021-06-02,LOM,84621,43570,41051,78294,6327,ITC,ITC4,3,Lombardia
2021-03-06,SIC,12641,5059,7582,9859,2782,ITG,ITG1,19,Sicilia
2021-06-09,FVG,10475,5452,5023,9335,1140,ITH,ITH4,6,Friuli-Venezia Giulia
2021-03-11,LOM,36184,13464,22720,26291,9893,ITC,ITC4,3,Lombardia
2021-05-16,CAM,51144,23225,27919,33572,17572,ITF,ITF3,15,Campania
2021-06-11,EMR,22258,11472,10786,19068,3190,ITH,ITH5,8,Emilia-Romagna
2021-02-20,CAM,8573,3080,5493,8270,303,ITF,ITF3,15,Campania
2021-03-29,BAS,2436,881,1555,2149,287,ITF,ITF5,17,Basilicata
2021-03-27,UMB,4253,1512,2741,3913,340,ITI,ITI2,10,Umbria
2021-01-05,BAS,946,409,537,946,0,ITF,ITF5,17,Basilicata
2021-03-01,FVG,2957,1041,1916,2905,52,ITH,ITH4,6,Friuli-Venezia Giulia
2021-03-20,EMR,16089,6832,9257,9125,6964,ITH,ITH5,8,Emilia-Romagna
2021-03-18,FVG,3372,1421,1951,1691,1681,ITH,ITH4,6,Friuli-Venezia Giulia
2021-03-26,PUG,12224,6060,6164,7579,4645,ITF,ITF4,16,Puglia
2021-05-28,SIC,51400,23148,28252,24749,26651,ITG,ITG1,19,Sicilia
2021-03-09,PUG,13532,6020,7512,11523,2009,ITF,ITF4,16,Puglia
2021-04-06,EMR,24783,11193,13590,20044,4739,ITH,ITH5,8,Emilia-Romagna
2021-01-01,VEN,1528,471,1057,1528,0,ITH,ITH3,5,Veneto
2021-01-13,PAT,421,123,298,421,0,ITH,ITH2,4,Provincia Autonoma Trento
2020-12-27,EMR,971,373,598,971,0,ITH,ITH5,8,Emilia-Romagna
2021-02-18,LIG,2765,1126,1639,2431,334,ITC,ITC3,7,Liguria
2021-03-06,LAZ,18354,7083,11271,14097,4257,ITI,ITI4,12,Lazio
2021-03-25,VEN,25999,11114,14885,19893,6106,ITH,ITH3,5,Veneto
2021-06-09,PIE,38153,20102,18051,35506,2647,ITC,ITC1,1,Piemonte
2021-02-03,CAM,8903,4003,4900,878,8025,ITF,ITF3,15,Campania
2021-04-11,VEN,21005,8874,12131,14698,6307,ITH,ITH3,5,Veneto
2021-01-11,MAR,1176,411,765,1176,0,ITI,ITI3,11,Marche
2021-02-22,CAL,2039,1033,1006,1480,559,ITF,ITF6,18,Calabria
2021-03-18,PIE,11759,4805,6954,4029,7730,ITC,ITC1,1,Piemonte
2021-04-14,PUG,31847,15039,16808,28541,3306,ITF,ITF4,16,Puglia
2021-05-07,TOS,32103,14683,17420,11995,20108,ITI,ITI1,9,Toscana
2021-03-28,PUG,3528,1650,1878,1203,2325,ITF,ITF4,16,Puglia
2021-03-29,ABR,5790,2674,3116,3151,2639,ITF,ITF1,13,Abruzzo
2021-03-30,LOM,39609,15608,24001,24836,14773,ITC,ITC4,3,Lombardia
2021-04-21,MAR,10782,4968,5814,9588,1194,ITI,ITI3,11,Marche
2021-06-02,CAL,12081,5795,6286,8816,3265,ITF,ITF6,18,Calabria
2021-03-20,FVG,3455,1462,1993,1364,2091,ITH,ITH4,6,Friuli-Venezia Giulia
2021-05-14,LIG,13100,5825,7275,8788,4312,ITC,ITC3,7,Liguria
2021-01-20,SAR,210,77,133,208,2,ITG,ITG2,20,Sardegna
2021-01-28,MAR,2086,725,1361,165,1921,ITI,ITI3,11,Marche
2021-05-18,VDA,970,484,486,353,617,ITC,ITC2,2,Valle d'Aosta / Vallée d'Aoste
2021-01-06,LOM,7058,2491,4567,7058,0,ITC,ITC4,3,Lombardia
2021-05-31,LIG,14841,7521,7320,9285,5556,ITC,ITC3,7,Liguria
2021-02-07,VDA,292,120,172,190,102,ITC,ITC2,2,Valle d'Aosta / Vallée d'Aoste
2021-04-13,VEN,14020,6320,7700,8534,5486,ITH,ITH3,5,Veneto
2021-06-03,ABR,13042,6216,6826,9270,3772,ITF,ITF1,13,Abruzzo
2021-01-13,FVG,2650,834,1816,2650,0,ITH,ITH4,6,Friuli-Venezia Giulia
2021-02-13,TOS,7785,2360,5425,7558,227,ITI,ITI1,9,Toscana
2021-02-18,UMB,1496,582,914,1030,466,ITI,ITI2,10,Umbria
2021-03-03,PAB,1179,393,786,1166,13,ITH,ITH1,4,Provincia Autonoma Bolzano / Bozen
2021-05-17,LOM,94590,45329,49261,30209,64381,ITC,ITC4,3,Lombardia
2021-01-27,FVG,1272,425,847,450,822,ITH,ITH4,6,Friuli-Venezia Giulia
2021-02-07,BAS,373,159,214,49,324,ITF,ITF5,17,Basilicata
2021-01-01,CAM,919,506,413,919,0,ITF,ITF3,15,Campania
2021-04-28,MOL,1686,916,770,469,1217,ITF,ITF2,14,Molise
2021-05-14,VEN,46533,22121,24412,25731,20802,ITH,ITH3,5,Veneto
2021-05-18,BAS,5896,2855,3041,3403,2493,ITF,ITF5,17,Basilicata
2021-02-04,PUG,5927,2366,3561,1195,4732,ITF,ITF4,16,Puglia
2021-05-09,EMR,25605,12249,13356,18638,6967,ITH,ITH5,8,Emilia-Romagna
2021-01-29,EMR,10415,3497,6918,290,10125,ITH,ITH5,8,Emilia-Romagna
2021-04-08,SIC,16574,8208,8366,8121,8453,ITG,ITG1,19,Sicilia
2021-05-07,FVG,10583,4840,5743,7091,3492,ITH,ITH4,6,Friuli-Venezia Giulia
2021-01-15,LAZ,6577,2705,3872,6577,0,ITI,ITI4,12,Lazio
2021-02-20,VEN,6424,2014,4410,6353,71,ITH,ITH3,5,Veneto
2021-03-04,PAT,2359,794,1565,1581,778,ITH,ITH2,4,Provincia Autonoma Trento
2020-12-30,LIG,12,5,7,12,0,ITC,ITC3,7,Liguria
2021-02-15,EMR,2904,851,2053,2779,125,ITH,ITH5,8,Emilia-Romagna
2021-04-25,LAZ,24513,11243,13270,16702,7811,ITI,ITI4,12,Lazio
2021-04-20,PIE,25472,11661,13811,19126,6346,ITC,ITC1,1,Piemonte
2021-03-25,CAM,20402,9728,10674,16899,3503,ITF,ITF3,15,Campania
2021-05-01,BAS,4703,2136,2567,3952,751,ITF,ITF5,17,Basilicata
2021-01-19,ABR,111,55,56,91,20,ITF,ITF1,13,Abruzzo
2021-03-18,TOS,9979,3984,5995,6007,3972,ITI,ITI1,9,Toscana
2021-05-09,FVG,7343,3295,4048,3487,3856,ITH,ITH4,6,Friuli-Venezia Giulia
2021-02-07,ABR,778,307,471,201,577,ITF,ITF1,13,Abruzzo
2021-02-22,SAR,1639,949,690,1411,228,ITG,ITG2,20,Sardegna
2021-03-02,MAR,4953,1941,3012,4387,566,ITI,ITI3,11,Marche
2021-04-13,CAL,6774,3267,3507,5463,1311,ITF,ITF6,18,Calabria
2021-05-07,PIE,33004,15593,17411,18904,14100,ITC,ITC1,1,Piemonte
2021-01-27,EMR,8361,2947,5414,462,7899,ITH,ITH5,8,Emilia-Romagna
2021-01-27,PIE,4196,1453,2743,999,3197,ITC,ITC1,1,Piemonte
2021-05-19,LOM,82704,39522,43182,33786,48918,ITC,ITC4,3,Lombardia
2021-06-10,MAR,14597,7528,7069,12584,2013,ITI,ITI3,11,Marche
2021-01-20,CAL,1399,626,773,1398,1,ITF,ITF6,18,Calabria
2021-02-13,PIE,4153,1334,2819,2931,1222,ITC,ITC1,1,Piemonte
2021-03-11,SAR,6781,3423,3358,5580,1201,ITG,ITG2,20,Sardegna
2021-02-08,LOM,10077,2917,7160,2130,7947,ITC,ITC4,3,Lombardia
2021-05-17,PUG,32647,15130,17517,20817,11830,ITF,ITF4,16,Puglia
2021-06-09,TOS,34603,17448,17155,34193,410,ITI,ITI1,9,Toscana
2021-02-25,LOM,15226,6313,8913,13668,1558,ITC,ITC4,3,Lombardia
2021-01-03,CAL,6,3,3,6,0,ITF,ITF6,18,Calabria
2021-04-11,LIG,4248,1930,2318,3999,249,ITC,ITC3,7,Liguria
2021-06-02,VEN,20304,10234,10070,15957,4347,ITH,ITH3,5,Veneto
2021-02-21,MOL,574,227,347,572,2,ITF,ITF2,14,Molise
2021-03-29,VDA,493,233,260,453,40,ITC,ITC2,2,Valle d'Aosta / Vallée d'Aoste
2021-01-21,ABR,157,47,110,157,0,ITF,ITF1,13,Abruzzo
2021-03-27,CAL,8593,3893,4700,4592,4001,ITF,ITF6,18,Calabria
2021-05-16,UMB,5318,2535,2783,5266,52,ITI,ITI2,10,Umbria
2021-02-04,MOL,758,295,463,77,681,ITF,ITF2,14,Molise
2021-04-04,TOS,13914,6604,7310,13661,253,ITI,ITI1,9,Toscana
2021-05-26,FVG,12929,6471,6458,9536,3393,ITH,ITH4,6,Friuli-Venezia Giulia
2021-03-12,VDA,531,175,356,305,226,ITC,ITC2,2,Valle d'Aosta / Vallée d'Aoste
2021-05-01,ABR,10746,5052,5694,5772,4974,ITF,ITF1,13,Abruzzo
2021-05-24,MAR,10796,5111,5685,8122,2674,ITI,ITI3,11,Marche
2021-02-15,FVG,2453,911,1542,2201,252,ITH,ITH4,6,Friuli-Venezia Giulia
2021-05-15,MOL,2979,1398,1581,2595,384,ITF,ITF2,14,Molise
2021-02-06,LOM,15251,5536,9715,1014,14237,ITC,ITC4,3,Lombardia
2021-02-20,SIC,7139,3692,3447,6897,242,ITG,ITG1,19,Sicilia
2021-04-06,LAZ,24317,11051,13266,17208,7109,ITI,ITI4,12,Lazio
2021-05-20,ABR,12625,5849,6776,7335,5290,ITF,ITF1,13,Abruzzo
2021-05-10,PAB,3018,1300,1718,1413,1605,ITH,ITH1,4,Provincia Autonoma Bolzano / Bozen
2021-05-09,PIE,27055,12900,14155,13447,13608,ITC,ITC1,1,Piemonte
2021-06-04,SAR,14478,6968,7510,9871,4607,ITG,ITG2,20,Sardegna
2021-01-18,LIG,2137,745,1392,1980,157,ITC,ITC3,7,Liguria
2021-01-27,PAT,803,277,526,92,711,ITH,ITH2,4,Provincia Autonoma Trento
2021-02-03,SIC,5918,2776,3142,721,5197,ITG,ITG1,19,Sicilia
2021-03-16,TOS,4899,1882,3017,2648,2251,ITI,ITI1,9,Toscana
2020-12-27,LAZ,274,132,142,274,0,ITI,ITI4,12,Lazio
2021-02-13,PAT,537,333,204,172,365,ITH,ITH2,4,Provincia Autonoma Trento
2021-02-27,TOS,1984,756,1228,1082,902,ITI,ITI1,9,Toscana
2021-03-11,VEN,19927,8983,10944,14358,5569,ITH,ITH3,5,Veneto
2021-03-13,SAR,2755,1076,1679,2474,281,ITG,ITG2,20,Sardegna
2021-05-26,PIE,32665,15084,17581,15625,17040,ITC,ITC1,1,Piemonte
2021-01-20,CAM,1257,650,607,1257,0,ITF,ITF3,15,Campania
2021-04-27,SIC,26211,12631,13580,15517,10694,ITG,ITG1,19,Sicilia
2021-02-15,PIE,4432,1597,2835,3227,1205,ITC,ITC1,1,Piemonte
2021-05-22,MAR,11933,5718,6215,7485,4448,ITI,ITI3,11,Marche
2021-03-04,PIE,14497,5734,8763,11549,2948,ITC,ITC1,1,Piemonte
2021-03-08,CAL,5419,2904,2515,4353,1066,ITF,ITF6,18,Calabria
2021-03-30,SAR,8906,3715,5191,6630,2276,ITG,ITG2,20,Sardegna
2021-04-27,UMB,5666,2403,3263,3089,2577,ITI,ITI2,10,Umbria
2021-02-26,BAS,2149,904,1245,2069,80,ITF,ITF5,17,Basilicata
2021-02-03,UMB,725,174,551,67,658,ITI,ITI2,10,Umbria
2021-03-10,VDA,438,183,255,225,213,ITC,ITC2,2,Valle d'Aosta / Vallée d'Aoste
2021-03-20,LAZ,19088,7537,11551,13204,5884,ITI,ITI4,12,Lazio
2021-05-07,PAT,5988,3080,2908,5149,839,ITH,ITH2,4,Provincia Autonoma Trento
2021-05-14,SIC,52001,24373,27628,36303,15698,ITG,ITG1,19,Sicilia
2021-02-16,PAB,530,205,325,530,0,ITH,ITH1,4,Provincia Autonoma Bolzano / Bozen
2021-02-23,PUG,9349,4421,4928,8873,476,ITF,ITF4,16,Puglia
2021-04-20,PAT,2877,1376,1501,2841,36,ITH,ITH2,4,Provincia Autonoma Trento
2021-05-02,LOM,83496,38331,45165,61035,22461,ITC,ITC4,3,Lombardia
2021-01-06,SAR,1615,549,1066,1615,0,ITG,ITG2,20,Sardegna
2021-02-11,MAR,1987,657,1330,1598,389,ITI,ITI3,11,Marche
2021-03-25,CAL,7413,3475,3938,4566,2847,ITF,ITF6,18,Calabria
2021-01-28,PAB,871,308,563,9,862,ITH,ITH1,4,Provincia Autonoma Bolzano / Bozen
2021-03-28,TOS,6212,2808,3404,5958,254,ITI,ITI1,9,Toscana
2021-05-29,PAT,2231,1164,1067,840,1391,ITH,ITH2,4,Provincia Autonoma Trento
2021-02-11,FVG,1930,664,1266,1738,192,ITH,ITH4,6,Friuli-Venezia Giulia
2021-03-02,LAZ,17397,7787,9610,13463,3934,ITI,ITI4,12,Lazio
2021-03-12,MAR,4640,1972,2668,3402,1238,ITI,ITI3,11,Marche
2021-01-30,TOS,4622,1622,3000,198,4424,ITI,ITI1,9,Toscana
2021-04-02,PAT,2802,1146,1656,2127,675,ITH,ITH2,4,Provincia Autonoma Trento
2021-01-14,MAR,2010,692,1318,2010,0,ITI,ITI3,11,Marche
2021-04-09,FVG,8019,3764,4255,6775,1244,ITH,ITH4,6,Friuli-Venezia Giulia
2021-05-23,BAS,4517,2302,2215,1533,2984,ITF,ITF5,17,Basilicata
2021-04-16,PAT,2837,1344,1493,2692,145,ITH,ITH2,4,Provincia Autonoma Trento
2021-05-10,TOS,26184,12383,13801,15566,10618,ITI,ITI1,9,Toscana
2021-01-18,LAZ,6268,2557,3711,5290,978,ITI,ITI4,12,Lazio
2021-04-25,UMB,4364,1685,2679,4282,82,ITI,ITI2,10,Umbria
2021-01-15,VDA,218,82,136,218,0,ITC,ITC2,2,Valle d'Aosta / Vallée d'Aoste
2021-02-18,PAT,1208,426,782,1146,62,ITH,ITH2,4,Provincia Autonoma Trento
2021-03-14,TOS,7174,2569,4605,3239,3935,ITI,ITI1,9,Toscana
2021-03-31,PUG,14861,7125,7736,9304,5557,ITF,ITF4,16,Puglia
2021-04-28,LAZ,32899,15016,17883,21346,11553,ITI,ITI4,12,Lazio
2021-03-07,VEN,4485,1766,2719,3924,561,ITH,ITH3,5,Veneto
2021-04-29,PAB,2630,1351,1279,1936,694,ITH,ITH1,4,Provincia Autonoma Bolzano / Bozen
2021-05-19,CAL,18347,9085,9262,11358,6989,ITF,ITF6,18,Calabria
2021-01-14,LIG,2980,1055,1925,2980,0,ITC,ITC3,7,Liguria
2021-02-02,PUG,4345,1847,2498,593,3752,ITF,ITF4,16,Puglia
2021-05-12,CAM,40843,19927,20916,31693,9150,ITF,ITF3,15,Campania
2021-01-19,PAB,853,371,482,723,130,ITH,ITH1,4,Provincia Autonoma Bolzano / Bozen
2021-03-03,MOL,672,316,356,590,82,ITF,ITF2,14,Molise
2021-03-23,CAL,5253,2459,2794,3443,1810,ITF,ITF6,18,Calabria
2021-05-03,VEN,40635,19780,20855,34202,6433,ITH,ITH3,5,Veneto
2021-05-13,PUG,38497,17168,21329,21396,17101,ITF,ITF4,16,Puglia
2021-01-05,MOL,449,180,269,449,0,ITF,ITF2,14,Molise
2020-12-30,FVG,626,244,382,626,0,ITH,ITH4,6,Friuli-Venezia Giulia
2021-03-17,PUG,10344,4701,5643,4171,6173,ITF,ITF4,16,Puglia
2021-03-27,BAS,2240,858,1382,1817,423,ITF,ITF5,17,Basilicata
2021-04-21,SAR,12074,5557,6517,6541,5533,ITG,ITG2,20,Sardegna
2021-04-24,MAR,12022,5303,6719,7558,4464,ITI,ITI3,11,Marche
2021-06-05,FVG,10249,5298,4951,8716,1533,ITH,ITH4,6,Friuli-Venezia Giulia
2021-01-11,SAR,1183,505,678,1183,0,ITG,ITG2,20,Sardegna
2021-02-25,FVG,3164,1651,1513,3135,29,ITH,ITH4,6,Friuli-Venezia Giulia
2021-02-26,MAR,3630,1499,2131,3154,476,ITI,ITI3,11,Marche
2021-03-12,LIG,6338,2983,3355,3869,2469,ITC,ITC3,7,Liguria
2021-03-27,LAZ,26189,10529,15660,19717,6472,ITI,ITI4,12,Lazio
2021-02-09,PAB,317,126,191,1,316,ITH,ITH1,4,Provincia Autonoma Bolzano / Bozen
2021-03-31,VDA,555,302,253,529,26,ITC,ITC2,2,Valle d'Aosta / Vallée d'Aoste
2021-04-17,ABR,7346,3398,3948,4293,3053,ITF,ITF1,13,Abruzzo
2021-05-19,LIG,13570,5961,7609,10451,3119,ITC,ITC3,7,Liguria
2021-01-25,SAR,589,213,376,22,567,ITG,ITG2,20,Sardegna
2021-02-19,ABR,3301,1551,1750,3201,100,ITF,ITF1,13,Abruzzo
2021-03-23,LIG,9558,4406,5152,6349,3209,ITC,ITC3,7,Liguria
2021-05-23,LAZ,47024,22787,24237,39681,7343,ITI,ITI4,12,Lazio
2021-05-27,VDA,1089,497,592,586,503,ITC,ITC2,2,Valle d'Aosta / Vallée d'Aoste
2021-05-13,VDA,1139,556,583,540,599,ITC,ITC2,2,Valle d'Aosta / Vallée d'Aoste
2021-05-12,MAR,10424,4686,5738,4922,5502,ITI,ITI3,11,Marche
2021-05-28,VEN,46438,22791,23647,24788,21650,ITH,ITH3,5,Veneto
2021-01-07,BAS,640,319,321,640,0,ITF,ITF5,17,Basilicata
2021-01-06,PAT,42,13,29,42,0,ITH,ITH2,4,Provincia Autonoma Trento
2021-01-18,LOM,9144,2968,6176,8169,975,ITC,ITC4,3,Lombardia
2021-02-02,VDA,272,70,202,2,270,ITC,ITC2,2,Valle d'Aosta / Vallée d'Aoste
2021-05-09,LAZ,37528,17251,20277,26259,11269,ITI,ITI4,12,Lazio
2021-05-16,SAR,8186,3818,4368,6026,2160,ITG,ITG2,20,Sardegna
2021-01-13,PIE,10080,3223,6857,10080,0,ITC,ITC1,1,Piemonte
2021-05-10,MOL,2889,1285,1604,2516,373,ITF,ITF2,14,Molise
2021-03-23,LOM,42677,15572,27105,29819,12858,ITC,ITC4,3,Lombardia
2021-05-03,MOL,2484,1164,1320,2321,163,ITF,ITF2,14,Molise
2021-05-16,SIC,33131,16133,16998,21807,11324,ITG,ITG1,19,Sicilia
2021-02-15,CAL,1141,540,601,991,150,ITF,ITF6,18,Calabria
2021-03-06,UMB,4316,1153,3163,4173,143,ITI,ITI2,10,Umbria
2021-03-25,EMR,21503,9447,12056,14516,6987,ITH,ITH5,8,Emilia-Romagna
2021-02-19,BAS,1623,738,885,1561,62,ITF,ITF5,17,Basilicata
2021-05-21,EMR,39124,17498,21626,22196,16928,ITH,ITH5,8,Emilia-Romagna
2021-01-22,UMB,276,105,171,32,244,ITI,ITI2,10,Umbria
2021-05-02,SIC,24621,11432,13189,18021,6600,ITG,ITG1,19,Sicilia
2021-02-10,EMR,4022,1385,2637,2766,1256,ITH,ITH5,8,Emilia-Romagna
2021-01-07,ABR,1603,552,1051,1603,0,ITF,ITF1,13,Abruzzo
2021-05-02,UMB,3787,1868,1919,1333,2454,ITI,ITI2,10,Umbria
2021-04-08,EMR,31201,14329,16872,25900,5301,ITH,ITH5,8,Emilia-Romagna
2021-03-20,SIC,18591,8984,9607,13455,5136,ITG,ITG1,19,Sicilia
2021-02-08,CAM,5113,2449,2664,4310,803,ITF,ITF3,15,Campania
2021-03-20,UMB,2318,851,1467,2293,25,ITI,ITI2,10,Umbria
2021-02-06,TOS,4527,1550,2977,1294,3233,ITI,ITI1,9,Toscana
2021-02-02,PAB,1745,506,1239,8,1737,ITH,ITH1,4,Provincia Autonoma Bolzano / Bozen
2021-05-16,LAZ,50901,24510,26391,37425,13476,ITI,ITI4,12,Lazio
2021-02-01,LIG,2557,922,1635,90,2467,ITC,ITC3,7,Liguria
2021-05-20,VDA,807,363,444,367,440,ITC,ITC2,2,Valle d'Aosta / Vallée d'Aoste
2021-04-27,FVG,8080,3704,4376,3622,4458,ITH,ITH4,6,Friuli-Venezia Giulia
2021-05-12,LIG,12016,5443,6573,6676,5340,ITC,ITC3,7,Liguria
2021-01-06,PIE,3116,1111,2005,3116,0,ITC,ITC1,1,Piemonte
2021-05-26,LIG,16638,8402,8236,12267,4371,ITC,ITC3,7,Liguria
2021-03-24,VDA,515,230,285,258,257,ITC,ITC2,2,Valle d'Aosta / Vallée d'Aoste
2021-03-30,LIG,12233,5456,6777,8845,3388,ITC,ITC3,7,Liguria
2021-05-17,MOL,2228,1092,1136,1732,496,ITF,ITF2,14,Molise
2021-03-21,MOL,1246,542,704,479,767,ITF,ITF2,14,Molise
2021-05-21,VEN,44672,21971,22701,20930,23742,ITH,ITH3,5,Veneto
2021-01-25,LOM,7011,2367,4644,473,6538,ITC,ITC4,3,Lombardia
2021-05-06,VDA,1063,509,554,679,384,ITC,ITC2,2,Valle d'Aosta / Vallée d'Aoste
2021-05-31,PUG,38444,18971,19473,23830,14614,ITF,ITF4,16,Puglia
2021-02-01,LOM,16058,5319,10739,303,15755,ITC,ITC4,3,Lombardia
2021-03-25,VDA,389,154,235,379,10,ITC,ITC2,2,Valle d'Aosta / Vallée d'Aoste
2021-04-12,PAB,2105,946,1159,2098,7,ITH,ITH1,4,Provincia Autonoma Bolzano / Bozen
2021-01-16,FVG,1230,360,870,1230,0,ITH,ITH4,6,Friuli-Venezia Giulia
2021-03-28,LAZ,18838,7543,11295,13528,5310,ITI,ITI4,12,Lazio
2021-03-30,UMB,3992,1745,2247,2460,1532,ITI,ITI2,10,Umbria
2021-02-16,TOS,9280,3340,5940,8559,721,ITI,ITI1,9,Toscana
2021-04-16,VEN,24419,10481,13938,12538,11881,ITH,ITH3,5,Veneto
2021-05-21,VDA,917,433,484,531,386,ITC,ITC2,2,Valle d'Aosta / Vallée d'Aoste
2021-04-18,SAR,5127,2225,2902,2258,2869,ITG,ITG2,20,Sardegna
2020-12-27,UMB,86,45,41,86,0,ITI,ITI2,10,Umbria
2021-04-17,VDA,638,407,231,636,2,ITC,ITC2,2,Valle d'Aosta / Vallée d'Aoste
2021-05-02,TOS,11167,4931,6236,9204,1963,ITI,ITI1,9,Toscana
2021-01-08,SAR,3258,1184,2074,3258,0,ITG,ITG2,20,Sardegna
2021-04-16,MAR,10082,4702,5380,9557,525,ITI,ITI3,11,Marche
2021-01-07,VDA,276,111,165,276,0,ITC,ITC2,2,Valle d'Aosta / Vallée d'Aoste
2021-03-25,FVG,5553,2488,3065,3420,2133,ITH,ITH4,6,Friuli-Venezia Giulia
2021-02-27,CAM,13950,4473,9477,12308,1642,ITF,ITF3,15,Campania
2021-03-07,PAB,114,13,101,9,105,ITH,ITH1,4,Provincia Autonoma Bolzano / Bozen
2021-04-01,PAT,2895,1228,1667,1801,1094,ITH,ITH2,4,Provincia Autonoma Trento
2021-06-04,SIC,57565,26649,30916,45711,11854,ITG,ITG1,19,Sicilia
2021-03-06,CAL,8426,4340,4086,7633,793,ITF,ITF6,18,Calabria
2021-06-09,LAZ,69098,32490,36608,36070,33028,ITI,ITI4,12,Lazio
2021-02-19,VDA,292,102,190,268,24,ITC,ITC2,2,Valle d'Aosta / Vallée d'Aoste
2021-02-22,UMB,1889,807,1082,1803,86,ITI,ITI2,10,Umbria
2021-03-16,PUG,9870,4687,5183,3511,6359,ITF,ITF4,16,Puglia
2021-04-11,LOM,32195,13935,18260,24806,7389,ITC,ITC4,3,Lombardia
2021-01-01,LOM,24,7,17,24,0,ITC,ITC4,3,Lombardia
2021-02-25,TOS,10634,4306,6328,9635,999,ITI,ITI1,9,Toscana
2021-06-07,LOM,98447,50163,48284,85182,13265,ITC,ITC4,3,Lombardia
2021-04-18,VEN,17513,7253,10260,9946,7567,ITH,ITH3,5,Veneto
2021-02-27,LOM,13944,5869,8075,13303,641,ITC,ITC4,3,Lombardia
2021-04-21,PAB,3012,1468,1544,2164,848,ITH,ITH1,4,Provincia Autonoma Bolzano / Bozen
2021-04-28,PUG,19757,8853,10904,15007,4750,ITF,ITF4,16,Puglia
2021-03-17,ABR,4539,1873,2666,2799,1740,ITF,ITF1,13,Abruzzo
2021-03-31,MOL,2193,919,1274,1374,819,ITF,ITF2,14,Molise
2021-02-25,LIG,3456,1349,2107,3326,130,ITC,ITC3,7,Liguria
2021-06-02,SAR,9784,4690,5094,8143,1641,ITG,ITG2,20,Sardegna
2021-01-10,EMR,7171,2684,4487,7171,0,ITH,ITH5,8,Emilia-Romagna
2021-04-06,SIC,17668,8460,9208,13386,4282,ITG,ITG1,19,Sicilia
2021-01-20,TOS,1331,637,694,1083,248,ITI,ITI1,9,Toscana
2021-03-08,EMR,12255,5123,7132,9579,2676,ITH,ITH5,8,Emilia-Romagna
2021-03-23,PAT,2446,944,1502,1706,740,ITH,ITH2,4,Provincia Autonoma Trento
2021-01-04,MAR,1508,570,938,1508,0,ITI,ITI3,11,Marche
2021-03-30,FVG,7264,3297,3967,6341,923,ITH,ITH4,6,Friuli-Venezia Giulia
2021-04-20,SAR,10993,4993,6000,7779,3214,ITG,ITG2,20,Sardegna
2020-12-30,LOM,114,42,72,114,0,ITC,ITC4,3,Lombardia
2021-01-08,VEN,9405,2835,6570,9405,0,ITH,ITH3,5,Veneto
2021-04-30,TOS,40170,17769,22401,20320,19850,ITI,ITI1,9,Toscana
2021-02-22,SIC,7888,4091,3797,7398,490,ITG,ITG1,19,Sicilia
2021-01-05,VDA,150,54,96,150,0,ITC,ITC2,2,Valle d'Aosta / Vallée d'Aoste
2020-12-27,SIC,92,55,37,92,0,ITG,ITG1,19,Sicilia
2021-06-02,SIC,35252,16293,18959,27480,7772,ITG,ITG1,19,Sicilia
2021-05-09,CAL,9616,4480,5136,6088,3528,ITF,ITF6,18,Calabria
2021-04-27,LAZ,30669,13842,16827,19823,10846,ITI,ITI4,12,Lazio
2021-04-29,BAS,4831,2385,2446,4410,421,ITF,ITF5,17,Basilicata
2021-05-02,CAM,43492,21539,21953,32138,11354,ITF,ITF3,15,Campania
2021-01-09,PAB,612,326,286,612,0,ITH,ITH1,4,Provincia Autonoma Bolzano / Bozen
2021-05-28,PAT,3680,1721,1959,1478,2202,ITH,ITH2,4,Provincia Autonoma Trento
2021-01-22,CAM,1524,776,748,673,851,ITF,ITF3,15,Campania
2021-03-01,LAZ,17103,7356,9747,13218,3885,ITI,ITI4,12,Lazio
2021-06-11,UMB,4853,2424,2429,4213,640,ITI,ITI2,10,Umbria
2021-01-14,VDA,237,69,168,237,0,ITC,ITC2,2,Valle d'Aosta / Vallée d'Aoste
2021-01-25,PAT,818,215,603,24,794,ITH,ITH2,4,Provincia Autonoma Trento
2021-03-17,BAS,1453,609,844,28,1425,ITF,ITF5,17,Basilicata
2021-04-14,MAR,10214,4563,5651,9842,372,ITI,ITI3,11,Marche
2021-01-29,CAL,2049,988,1061,230,1819,ITF,ITF6,18,Calabria
2021-01-09,PUG,4885,2250,2635,4885,0,ITF,ITF4,16,Puglia
2021-01-19,BAS,199,84,115,199,0,ITF,ITF5,17,Basilicata
2021-03-25,PAT,2874,1104,1770,1825,1049,ITH,ITH2,4,Provincia Autonoma Trento
2021-03-24,ABR,6385,2784,3601,4133,2252,ITF,ITF1,13,Abruzzo
2021-04-24,VDA,722,400,322,555,167,ITC,ITC2,2,Valle d'Aosta / Vallée d'Aoste
2020-12-30,MAR,17,5,12,17,0,ITI,ITI3,11,Marche
2021-01-13,VEN,5985,1606,4379,5985,0,ITH,ITH3,5,Veneto
2021-02-22,LAZ,11459,4993,6466,10957,502,ITI,ITI4,12,Lazio
2021-04-25,TOS,11054,5248,5806,8917,2137,ITI,ITI1,9,Toscana
2021-03-30,PIE,16893,7035,9858,9021,7872,ITC,ITC1,1,Piemonte
2021-02-09,ABR,908,311,597,499,409,ITF,ITF1,13,Abruzzo
2021-06-02,LAZ,43207,21469,21738,31731,11476,ITI,ITI4,12,Lazio
2021-02-23,MOL,582,223,359,363,219,ITF,ITF2,14,Molise
2021-03-06,CAM,16371,6814,9557,10702,5669,ITF,ITF3,15,Campania
2021-05-04,CAL,16353,7532,8821,11717,4636,ITF,ITF6,18,Calabria
2021-06-11,LAZ,53420,25182,28238,27919,25501,ITI,ITI4,12,Lazio
2021-06-03,MOL,3153,1503,1650,2611,542,ITF,ITF2,14,Molise
2021-03-01,SIC,12691,6012,6679,11037,1654,ITG,ITG1,19,Sicilia
2021-04-07,MOL,1688,847,841,1413,275,ITF,ITF2,14,Molise
2021-03-04,LIG,4738,2118,2620,3891,847,ITC,ITC3,7,Liguria
2021-03-06,LOM,21307,9086,12221,16795,4512,ITC,ITC4,3,Lombardia
2021-04-01,FVG,6374,3043,3331,5359,1015,ITH,ITH4,6,Friuli-Venezia Giulia
2021-04-09,MAR,9560,4189,5371,9360,200,ITI,ITI3,11,Marche
2021-04-20,EMR,22617,10401,12216,14264,8353,ITH,ITH5,8,Emilia-Romagna
2021-05-28,FVG,10679,5263,5416,6479,4200,ITH,ITH4,6,Friuli-Venezia Giulia
2021-04-08,UMB,5887,2520,3367,4092,1795,ITI,ITI2,10,Umbria
2021-03-30,PAT,2387,973,1414,1750,637,ITH,ITH2,4,Provincia Autonoma Trento
2021-03-24,BAS,1788,697,1091,1390,398,ITF,ITF5,17,Basilicata
2021-04-19,VDA,751,325,426,542,209,ITC,ITC2,2,Valle d'Aosta / Vallée d'Aoste
2021-04-30,LIG,14421,6442,7979,5853,8568,ITC,ITC3,7,Liguria
2021-06-09,SIC,48968,23347,25621,41929,7039,ITG,ITG1,19,Sicilia
2021-05-06,ABR,13009,6089,6920,7980,5029,ITF,ITF1,13,Abruzzo
2021-02-15,SIC,3730,1733,1997,3166,564,ITG,ITG1,19,Sicilia
2021-04-13,SAR,7607,3593,4014,5781,1826,ITG,ITG2,20,Sardegna
2021-04-27,EMR,32088,14858,17230,19627,12461,ITH,ITH5,8,Emilia-Romagna
2021-02-08,FVG,2357,694,1663,92,2265,ITH,ITH4,6,Friuli-Venezia Giulia
2021-05-14,PIE,33338,16246,17092,17943,15395,ITC,ITC1,1,Piemonte
2021-05-26,SIC,44555,20850,23705,24083,20472,ITG,ITG1,19,Sicilia
2021-06-09,SAR,15397,7324,8073,11653,3744,ITG,ITG2,20,Sardegna
2021-02-01,PAT,1221,335,886,92,1129,ITH,ITH2,4,Provincia Autonoma Trento
2021-03-11,TOS,16260,6673,9587,12933,3327,ITI,ITI1,9,Toscana
2021-01-03,SIC,4710,2464,2246,4710,0,ITG,ITG1,19,Sicilia
2021-01-01,LAZ,3554,1382,2172,3554,0,ITI,ITI4,12,Lazio
2021-04-13,SIC,19682,9586,10096,10932,8750,ITG,ITG1,19,Sicilia
2021-01-10,LAZ,4041,1701,2340,4041,0,ITI,ITI4,12,Lazio
2021-01-15,CAM,4980,2381,2599,4980,0,ITF,ITF3,15,Campania
2021-03-10,BAS,1681,843,838,842,839,ITF,ITF5,17,Basilicata
2021-03-13,CAM,14779,7277,7502,9497,5282,ITF,ITF3,15,Campania
2021-04-20,LAZ,31040,14250,16790,19750,11290,ITI,ITI4,12,Lazio
2021-04-22,UMB,5432,2233,3199,2768,2664,ITI,ITI2,10,Umbria
2021-03-04,VEN,13039,4938,8101,9567,3472,ITH,ITH3,5,Veneto
2021-04-26,PAB,1543,771,772,1538,5,ITH,ITH1,4,Provincia Autonoma Bolzano / Bozen
2021-01-26,BAS,797,352,445,101,696,ITF,ITF5,17,Basilicata
2021-02-23,MAR,3267,1397,1870,3211,56,ITI,ITI3,11,Marche
2021-03-05,VDA,275,124,151,53,222,ITC,ITC2,2,Valle d'Aosta / Vallée d'Aoste
2021-03-08,LAZ,21545,9670,11875,16272,5273,ITI,ITI4,12,Lazio
2021-05-06,BAS,5052,2435,2617,3483,1569,ITF,ITF5,17,Basilicata
2021-03-20,CAL,6703,3072,3631,4199,2504,ITF,ITF6,18,Calabria
2021-03-22,CAM,13760,6905,6855,11720,2040,ITF,ITF3,15,Campania
2021-05-15,BAS,6527,3341,3186,3955,2572,ITF,ITF5,17,Basilicata
2021-03-30,PUG,12637,6208,6429,6742,5895,ITF,ITF4,16,Puglia
2021-02-01,PUG,3964,1660,2304,373,3591,ITF,ITF4,16,Puglia
2021-02-07,CAM,2929,1382,1547,2158,771,ITF,ITF3,15,Campania
2021-04-02,BAS,2318,1046,1272,1714,604,ITF,ITF5,17,Basilicata
2021-02-03,PAT,847,315,532,414,433,ITH,ITH2,4,Provincia Autonoma Trento
2021-02-04,BAS,1096,442,654,63,1033,ITF,ITF5,17,Basilicata
2021-04-17,FVG,7449,3232,4217,5966,1483,ITH,ITH4,6,Friuli-Venezia Giulia
2021-05-06,EMR,35914,16598,19316,22857,13057,ITH,ITH5,8,Emilia-Romagna
2021-01-10,SIC,3533,1578,1955,3533,0,ITG,ITG1,19,Sicilia
2021-01-26,EMR,8334,3000,5334,215,8119,ITH,ITH5,8,Emilia-Romagna
2021-02-05,TOS,5749,2245,3504,1924,3825,ITI,ITI1,9,Toscana
2021-04-09,ABR,8868,4211,4657,6329,2539,ITF,ITF1,13,Abruzzo
2021-04-22,LAZ,38792,19163,19629,24189,14603,ITI,ITI4,12,Lazio
2021-01-15,MAR,1771,500,1271,1771,0,ITI,ITI3,11,Marche
2021-04-17,UMB,6665,3059,3606,5325,1340,ITI,ITI2,10,Umbria
2021-05-23,PAT,1955,993,962,447,1508,ITH,ITH2,4,Provincia Autonoma Trento
2021-03-20,LIG,2316,995,1321,1142,1174,ITC,ITC3,7,Liguria
2021-03-24,EMR,21181,9387,11794,13798,7383,ITH,ITH5,8,Emilia-Romagna
2021-05-16,TOS,26661,12879,13782,24201,2460,ITI,ITI1,9,Toscana
2021-02-28,VDA,260,86,174,77,183,ITC,ITC2,2,Valle d'Aosta / Vallée d'Aoste
2021-03-10,LAZ,24517,11735,12782,18869,5648,ITI,ITI4,12,Lazio
2021-03-11,MOL,1465,637,828,1459,6,ITF,ITF2,14,Molise
2021-04-10,PAT,2798,1307,1491,2004,794,ITH,ITH2,4,Provincia Autonoma Trento
2021-05-11,VEN,33058,16461,16597,28333,4725,ITH,ITH3,5,Veneto
2021-01-12,LAZ,5413,1981,3432,5413,0,ITI,ITI4,12,Lazio
2021-01-15,LOM,25199,7428,17771,25199,0,ITC,ITC4,3,Lombardia
2021-03-15,CAL,3554,1688,1866,2112,1442,ITF,ITF6,18,Calabria
2021-01-18,PAB,1772,687,1085,1767,5,ITH,ITH1,4,Provincia Autonoma Bolzano / Bozen
2021-05-14,PUG,44703,20423,24280,28608,16095,ITF,ITF4,16,Puglia
2021-02-02,BAS,367,143,224,175,192,ITF,ITF5,17,Basilicata
2021-04-17,PIE,30450,14145,16305,27135,3315,ITC,ITC1,1,Piemonte
2021-01-22,VEN,1080,332,748,25,1055,ITH,ITH3,5,Veneto
2021-01-06,MOL,689,260,429,689,0,ITF,ITF2,14,Molise
2021-04-29,LOM,115430,53565,61865,85611,29819,ITC,ITC4,3,Lombardia
2021-04-02,ABR,6682,3092,3590,5195,1487,ITF,ITF1,13,Abruzzo
2021-04-25,MAR,8600,3994,4606,7025,1575,ITI,ITI3,11,Marche
2021-04-16,MOL,2430,1033,1397,1198,1232,ITF,ITF2,14,Molise
2021-05-05,VDA,1038,566,472,456,582,ITC,ITC2,2,Valle d'Aosta / Vallée d'Aoste
2021-01-24,EMR,2443,885,1558,298,2145,ITH,ITH5,8,Emilia-Romagna
2021-02-04,ABR,1679,615,1064,609,1070,ITF,ITF1,13,Abruzzo
2021-03-08,SAR,5325,3035,2290,4105,1220,ITG,ITG2,20,Sardegna
2021-05-20,CAL,16893,8434,8459,11286,5607,ITF,ITF6,18,Calabria
2021-01-05,SIC,10275,5045,5230,10275,0,ITG,ITG1,19,Sicilia
2021-02-10,PIE,7535,2371,5164,1316,6219,ITC,ITC1,1,Piemonte
2021-04-09,BAS,1152,350,802,1089,63,ITF,ITF5,17,Basilicata
2021-05-04,SAR,9538,4386,5152,7685,1853,ITG,ITG2,20,Sardegna
2021-04-10,FVG,5026,2201,2825,3801,1225,ITH,ITH4,6,Friuli-Venezia Giulia
2021-01-05,UMB,854,429,425,854,0,ITI,ITI2,10,Umbria
2021-01-24,SAR,90,34,56,5,85,ITG,ITG2,20,Sardegna
2021-04-08,PIE,25144,10930,14214,20414,4730,ITC,ITC1,1,Piemonte
2021-04-15,SIC,21062,10261,10801,11731,9331,ITG,ITG1,19,Sicilia
2021-05-11,TOS,27938,12981,14957,12481,15457,ITI,ITI1,9,Toscana
2021-04-20,LOM,67628,30819,36809,57293,10335,ITC,ITC4,3,Lombardia
2021-05-23,FVG,10263,4851,5412,6115,4148,ITH,ITH4,6,Friuli-Venezia Giulia
2021-01-10,LOM,10513,3957,6556,10513,0,ITC,ITC4,3,Lombardia
2021-04-25,MOL,792,395,397,559,233,ITF,ITF2,14,Molise
2021-01-15,LIG,2256,754,1502,2256,0,ITC,ITC3,7,Liguria
2021-01-17,LOM,8336,3340,4996,8136,200,ITC,ITC4,3,Lombardia
2021-02-07,CAL,860,428,432,148,712,ITF,ITF6,18,Calabria
2021-03-13,TOS,9295,3317,5978,5332,3963,ITI,ITI1,9,Toscana
2021-03-17,LAZ,13793,5899,7894,7538,6255,ITI,ITI4,12,Lazio
2021-03-15,LOM,31545,11326,20219,23030,8515,ITC,ITC4,3,Lombardia
2021-04-25,LIG,1936,921,1015,1521,415,ITC,ITC3,7,Liguria
2021-05-18,CAL,15380,7681,7699,11917,3463,ITF,ITF6,18,Calabria
2021-05-04,VEN,42882,20312,22570,34854,8028,ITH,ITH3,5,Veneto
2021-01-25,PUG,3825,1681,2144,423,3402,ITF,ITF4,16,Puglia
2021-01-13,MAR,2105,746,1359,2105,0,ITI,ITI3,11,Marche
2021-02-10,PAT,853,291,562,511,342,ITH,ITH2,4,Provincia Autonoma Trento
2021-05-22,PAB,6821,3552,3269,4654,2167,ITH,ITH1,4,Provincia Autonoma Bolzano / Bozen
2021-01-08,PIE,5532,1762,3770,5532,0,ITC,ITC1,1,Piemonte
2021-02-25,PUG,11965,5060,6905,10799,1166,ITF,ITF4,16,Puglia
2021-03-25,LAZ,30180,14402,15778,23572,6608,ITI,ITI4,12,Lazio
2021-04-01,SAR,10148,4060,6088,7135,3013,ITG,ITG2,20,Sardegna
2021-02-11,PAB,1093,431,662,239,854,ITH,ITH1,4,Provincia Autonoma Bolzano / Bozen
2021-03-22,VDA,560,205,355,333,227,ITC,ITC2,2,Valle d'Aosta / Vallée d'Aoste
2021-04-25,PAT,1970,939,1031,1963,7,ITH,ITH2,4,Provincia Autonoma Trento
2021-01-27,LAZ,6114,2387,3727,997,5117,ITI,ITI4,12,Lazio
2021-02-06,MAR,2462,902,1560,522,1940,ITI,ITI3,11,Marche
2021-03-06,PIE,13994,5211,8783,11205,2789,ITC,ITC1,1,Piemonte
2021-06-05,PUG,41393,20312,21081,29313,12080,ITF,ITF4,16,Puglia
2021-06-11,LIG,13152,6624,6528,8187,4965,ITC,ITC3,7,Liguria
2021-04-15,LIG,11819,5219,6600,9967,1852,ITC,ITC3,7,Liguria
2021-01-22,PIE,3867,1249,2618,2526,1341,ITC,ITC1,1,Piemonte
2021-01-05,CAL,1471,688,783,1471,0,ITF,ITF6,18,Calabria
2021-02-07,SIC,2331,985,1346,674,1657,ITG,ITG1,19,Sicilia
2021-04-10,VEN,27443,11970,15473,18963,8480,ITH,ITH3,5,Veneto
2021-02-10,LOM,14391,4503,9888,7574,6817,ITC,ITC4,3,Lombardia
2021-02-24,CAM,11785,4149,7636,11097,688,ITF,ITF3,15,Campania
2021-05-18,SIC,36089,17345,18744,23559,12530,ITG,ITG1,19,Sicilia
2021-06-06,VEN,37229,19071,18158,32555,4674,ITH,ITH3,5,Veneto
2020-12-27,TOS,620,267,353,620,0,ITI,ITI1,9,Toscana
2021-06-01,LAZ,48346,23238,25108,30134,18212,ITI,ITI4,12,Lazio
2021-04-05,LAZ,19813,9033,10780,13634,6179,ITI,ITI4,12,Lazio
2021-01-16,ABR,932,429,503,932,0,ITF,ITF1,13,Abruzzo
2021-02-12,EMR,5323,1679,3644,3920,1403,ITH,ITH5,8,Emilia-Romagna
2021-06-05,VDA,925,476,449,737,188,ITC,ITC2,2,Valle d'Aosta / Vallée d'Aoste
2021-04-10,EMR,20921,9300,11621,16776,4145,ITH,ITH5,8,Emilia-Romagna
2021-02-11,VDA,231,107,124,222,9,ITC,ITC2,2,Valle d'Aosta / Vallée d'Aoste
2021-03-29,UMB,3930,1764,2166,2451,1479,ITI,ITI2,10,Umbria
2021-04-17,EMR,27306,13077,14229,17955,9351,ITH,ITH5,8,Emilia-Romagna
2021-01-31,UMB,1058,276,782,25,1033,ITI,ITI2,10,Umbria
2021-04-09,VDA,237,111,126,204,33,ITC,ITC2,2,Valle d'Aosta / Vallée d'Aoste
2021-01-07,EMR,10273,3406,6867,10273,0,ITH,ITH5,8,Emilia-Romagna
2021-05-21,MAR,12951,6113,6838,6695,6256,ITI,ITI3,11,Marche
2021-01-03,TOS,3335,1051,2284,3335,0,ITI,ITI1,9,Toscana
2021-05-25,LAZ,47031,21949,25082,35616,11415,ITI,ITI4,12,Lazio
2021-05-22,VDA,940,494,446,540,400,ITC,ITC2,2,Valle d'Aosta / Vallée d'Aoste
2021-05-25,UMB,8797,4289,4508,7736,1061,ITI,ITI2,10,Umbria
2021-05-26,MOL,1544,693,851,794,750,ITF,ITF2,14,Molise
2021-01-05,CAM,7237,3637,3600,7237,0,ITF,ITF3,15,Campania
2021-02-28,BAS,804,343,461,775,29,ITF,ITF5,17,Basilicata
2021-03-30,MOL,2003,857,1146,1491,512,ITF,ITF2,14,Molise
2020-12-27,VEN,880,395,485,880,0,ITH,ITH3,5,Veneto
2021-01-12,CAL,2065,1020,1045,2065,0,ITF,ITF6,18,Calabria
2021-02-18,PAB,1839,457,1382,1832,7,ITH,ITH1,4,Provincia Autonoma Bolzano / Bozen
2021-01-02,BAS,949,380,569,949,0,ITF,ITF5,17,Basilicata
2021-01-06,PUG,3945,1669,2276,3945,0,ITF,ITF4,16,Puglia
2021-02-01,MOL,562,201,361,14,548,ITF,ITF2,14,Molise
2021-01-16,BAS,721,304,417,721,0,ITF,ITF5,17,Basilicata
2021-05-12,MOL,2847,1291,1556,2751,96,ITF,ITF2,14,Molise
2021-04-08,LIG,13723,6156,7567,11680,2043,ITC,ITC3,7,Liguria
2021-05-06,FVG,11870,5514,6356,7916,3954,ITH,ITH4,6,Friuli-Venezia Giulia
2021-02-10,SAR,1959,765,1194,1441,518,ITG,ITG2,20,Sardegna
2021-04-26,BAS,4464,2164,2300,4244,220,ITF,ITF5,17,Basilicata
2021-06-04,LIG,14939,7453,7486,9374,5565,ITC,ITC3,7,Liguria
2021-02-17,CAM,7388,3210,4178,6328,1060,ITF,ITF3,15,Campania
2021-05-25,SIC,33393,15282,18111,14095,19298,ITG,ITG1,19,Sicilia
2021-05-30,VEN,22533,11263,11270,15842,6691,ITH,ITH3,5,Veneto
2021-02-03,LOM,25625,7911,17714,1072,24553,ITC,ITC4,3,Lombardia
2021-02-24,CAL,1856,945,911,1378,478,ITF,ITF6,18,Calabria
2021-03-29,SIC,15064,7139,7925,10567,4497,ITG,ITG1,19,Sicilia
2021-04-15,CAM,34337,16659,17678,24439,9898,ITF,ITF3,15,Campania
2021-04-01,LOM,42937,17219,25718,26744,16193,ITC,ITC4,3,Lombardia
2021-02-15,TOS,8771,3375,5396,7946,825,ITI,ITI1,9,Toscana
2021-04-12,LAZ,23768,10685,13083,16870,6898,ITI,ITI4,12,Lazio
2021-04-03,EMR,19938,8766,11172,16198,3740,ITH,ITH5,8,Emilia-Romagna
2021-03-07,ABR,2522,630,1892,2522,0,ITF,ITF1,13,Abruzzo
2021-05-30,EMR,27044,12775,14269,13356,13688,ITH,ITH5,8,Emilia-Romagna
2021-01-09,ABR,1483,565,918,1483,0,ITF,ITF1,13,Abruzzo
2021-02-19,EMR,7327,3010,4317,6813,514,ITH,ITH5,8,Emilia-Romagna
2021-04-16,VDA,599,261,338,597,2,ITC,ITC2,2,Valle d'Aosta / Vallée d'Aoste
2021-06-08,LAZ,65532,31045,34487,36276,29256,ITI,ITI4,12,Lazio
2020-12-31,EMR,2215,780,1435,2215,0,ITH,ITH5,8,Emilia-Romagna
2021-05-28,MAR,13955,6734,7221,9096,4859,ITI,ITI3,11,Marche
2021-06-06,EMR,36389,18903,17486,31984,4405,ITH,ITH5,8,Emilia-Romagna
2021-04-02,VDA,873,344,529,648,225,ITC,ITC2,2,Valle d'Aosta / Vallée d'Aoste
2021-05-18,UMB,7723,3342,4381,3885,3838,ITI,ITI2,10,Umbria
2021-02-26,EMR,9634,3673,5961,8586,1048,ITH,ITH5,8,Emilia-Romagna
2021-04-01,MAR,7576,3182,4394,4160,3416,ITI,ITI3,11,Marche
2021-03-22,UMB,3560,1655,1905,2314,1246,ITI,ITI2,10,Umbria
2021-05-29,VDA,798,434,364,561,237,ITC,ITC2,2,Valle d'Aosta / Vallée d'Aoste
2021-04-05,UMB,4250,1728,2522,2195,2055,ITI,ITI2,10,Umbria
2021-04-06,MOL,1494,701,793,1151,343,ITF,ITF2,14,Molise
2021-02-22,TOS,9818,4254,5564,9541,277,ITI,ITI1,9,Toscana
2021-02-07,UMB,54,17,37,1,53,ITI,ITI2,10,Umbria
2021-02-08,MOL,334,141,193,216,118,ITF,ITF2,14,Molise
2021-05-19,MOL,2340,1205,1135,1915,425,ITF,ITF2,14,Molise
2021-06-01,SIC,38715,17620,21095,24953,13762,ITG,ITG1,19,Sicilia
2020-12-30,PAB,388,182,206,388,0,ITH,ITH1,4,Provincia Autonoma Bolzano / Bozen
2021-03-03,CAL,5031,2748,2283,3950,1081,ITF,ITF6,18,Calabria
2021-02-21,BAS,284,113,171,284,0,ITF,ITF5,17,Basilicata
2021-03-23,MOL,1642,694,948,1435,207,ITF,ITF2,14,Molise
2021-04-05,SIC,8023,3958,4065,6583,1440,ITG,ITG1,19,Sicilia
2021-01-15,PAT,595,132,463,595,0,ITH,ITH2,4,Provincia Autonoma Trento
2021-02-17,LIG,2688,1181,1507,2262,426,ITC,ITC3,7,Liguria
2021-02-27,LAZ,11425,4267,7158,10470,955,ITI,ITI4,12,Lazio
2021-05-26,LOM,93349,44520,48829,43564,49785,ITC,ITC4,3,Lombardia
2021-06-09,CAM,52403,25730,26673,41542,10861,ITF,ITF3,15,Campania
2021-02-15,LOM,8939,3129,5810,8522,417,ITC,ITC4,3,Lombardia
2021-03-09,MAR,5427,2290,3137,4547,880,ITI,ITI3,11,Marche
2021-04-20,CAL,7847,3956,3891,6120,1727,ITF,ITF6,18,Calabria
2021-05-10,PUG,37483,16545,20938,19586,17897,ITF,ITF4,16,Puglia
2021-02-28,MOL,832,334,498,790,42,ITF,ITF2,14,Molise
2021-03-01,CAM,12130,4247,7883,8017,4113,ITF,ITF3,15,Campania
2021-01-01,TOS,2369,787,1582,2369,0,ITI,ITI1,9,Toscana
2021-02-22,FVG,2485,1193,1292,2067,418,ITH,ITH4,6,Friuli-Venezia Giulia
2021-04-24,ABR,8709,3970,4739,7179,1530,ITF,ITF1,13,Abruzzo
2021-04-11,TOS,3642,1679,1963,3487,155,ITI,ITI1,9,Toscana
2021-03-30,SIC,14580,6820,7760,9817,4763,ITG,ITG1,19,Sicilia
2021-05-09,CAM,43178,20276,22902,32085,11093,ITF,ITF3,15,Campania
2021-01-11,LIG,2653,989,1664,2653,0,ITC,ITC3,7,Liguria
2021-04-15,EMR,29333,13978,15355,19658,9675,ITH,ITH5,8,Emilia-Romagna
2021-06-02,FVG,9390,4945,4445,9117,273,ITH,ITH4,6,Friuli-Venezia Giulia
2021-01-14,ABR,530,189,341,530,0,ITF,ITF1,13,Abruzzo
2021-03-13,SIC,12207,5385,6822,7717,4490,ITG,ITG1,19,Sicilia
2021-02-27,MOL,1366,568,798,1347,19,ITF,ITF2,14,Molise
2021-03-19,BAS,2290,992,1298,262,2028,ITF,ITF5,17,Basilicata
2021-03-06,TOS,7107,2851,4256,2914,4193,ITI,ITI1,9,Toscana
2021-03-17,UMB,3331,1313,2018,1859,1472,ITI,ITI2,10,Umbria
2021-05-24,VDA,1135,516,619,688,447,ITC,ITC2,2,Valle d'Aosta / Vallée d'Aoste
2021-06-07,MOL,1938,855,1083,1128,810,ITF,ITF2,14,Molise
2021-03-10,EMR,18848,7790,11058,13206,5642,ITH,ITH5,8,Emilia-Romagna
2021-05-10,VDA,782,381,401,547,235,ITC,ITC2,2,Valle d'Aosta / Vallée d'Aoste
2021-05-20,LAZ,51586,25013,26573,37539,14047,ITI,ITI4,12,Lazio
2021-02-13,MOL,132,80,52,132,0,ITF,ITF2,14,Molise
2021-04-13,MAR,9838,4259,5579,9605,233,ITI,ITI3,11,Marche
2021-01-07,UMB,1300,387,913,1300,0,ITI,ITI2,10,Umbria
2021-01-10,CAM,8165,3736,4429,8165,0,ITF,ITF3,15,Campania
2021-02-07,FVG,1562,483,1079,385,1177,ITH,ITH4,6,Friuli-Venezia Giulia
2021-04-17,SIC,26034,13153,12881,18968,7066,ITG,ITG1,19,Sicilia
2021-01-03,PAT,492,160,332,492,0,ITH,ITH2,4,Provincia Autonoma Trento
2021-05-24,MOL,1959,851,1108,1293,666,ITF,ITF2,14,Molise
2021-03-20,SAR,5194,2074,3120,2917,2277,ITG,ITG2,20,Sardegna
2021-02-16,BAS,906,377,529,808,98,ITF,ITF5,17,Basilicata
2021-05-07,MOL,2641,1226,1415,2044,597,ITF,ITF2,14,Molise
2021-02-06,PAB,2626,1171,1455,19,2607,ITH,ITH1,4,Provincia Autonoma Bolzano / Bozen
2021-02-13,PUG,3727,1456,2271,3031,696,ITF,ITF4,16,Puglia
2021-05-18,FVG,10670,5344,5326,8607,2063,ITH,ITH4,6,Friuli-Venezia Giulia
2021-01-10,LIG,648,262,386,648,0,ITC,ITC3,7,Liguria
2021-02-12,CAL,1713,668,1045,948,765,ITF,ITF6,18,Calabria
2021-03-03,VEN,12094,4647,7447,8595,3499,ITH,ITH3,5,Veneto
2021-03-17,SIC,14879,7353,7526,9188,5691,ITG,ITG1,19,Sicilia
2021-03-20,LOM,32500,12144,20356,22653,9847,ITC,ITC4,3,Lombardia
2021-04-20,LIG,14214,6505,7709,9867,4347,ITC,ITC3,7,Liguria
2021-04-03,CAM,21114,10314,10800,18733,2381,ITF,ITF3,15,Campania
2021-06-01,FVG,9960,5047,4913,7849,2111,ITH,ITH4,6,Friuli-Venezia Giulia
2021-06-11,VEN,31484,16286,15198,23762,7722,ITH,ITH3,5,Veneto
2021-05-18,PIE,32001,14752,17249,19372,12629,ITC,ITC1,1,Piemonte
2021-06-06,LAZ,57740,27774,29966,35360,22380,ITI,ITI4,12,Lazio
2020-12-27,LOM,717,413,304,717,0,ITC,ITC4,3,Lombardia
2021-05-18,EMR,29035,13229,15806,18568,10467,ITH,ITH5,8,Emilia-Romagna
2021-02-16,ABR,1917,842,1075,1905,12,ITF,ITF1,13,Abruzzo
2021-02-03,TOS,4221,1452,2769,241,3980,ITI,ITI1,9,Toscana
2021-02-07,EMR,4794,1538,3256,1733,3061,ITH,ITH5,8,Emilia-Romagna
2021-03-02,ABR,3962,1675,2287,3278,684,ITF,ITF1,13,Abruzzo
2021-02-26,LAZ,13090,5714,7376,11728,1362,ITI,ITI4,12,Lazio
2021-02-24,EMR,9351,3566,5785,8467,884,ITH,ITH5,8,Emilia-Romagna
2021-04-21,VDA,868,410,458,620,248,ITC,ITC2,2,Valle d'Aosta / Vallée d'Aoste
2021-06-10,ABR,12379,6165,6214,10216,2163,ITF,ITF1,13,Abruzzo
2021-01-05,EMR,9361,3170,6191,9361,0,ITH,ITH5,8,Emilia-Romagna
2021-06-02,MAR,11898,5937,5961,11221,677,ITI,ITI3,11,Marche
2021-01-28,BAS,903,401,502,119,784,ITF,ITF5,17,Basilicata
2021-01-15,TOS,3878,1347,2531,3878,0,ITI,ITI1,9,Toscana
2021-01-26,UMB,816,390,426,18,798,ITI,ITI2,10,Umbria
2021-04-18,MOL,1083,483,600,149,934,ITF,ITF2,14,Molise
2021-03-21,VDA,355,165,190,355,0,ITC,ITC2,2,Valle d'Aosta / Vallée d'Aoste
2021-04-29,EMR,44947,21133,23814,27400,17547,ITH,ITH5,8,Emilia-Romagna
2021-01-19,EMR,2045,505,1540,2028,17,ITH,ITH5,8,Emilia-Romagna
2021-02-22,MAR,3415,1501,1914,3338,77,ITI,ITI3,11,Marche
2021-02-12,UMB,671,224,447,665,6,ITI,ITI2,10,Umbria
2021-02-22,PAT,745,259,486,661,84,ITH,ITH2,4,Provincia Autonoma Trento
2021-04-04,MOL,253,141,112,238,15,ITF,ITF2,14,Molise
2021-02-26,UMB,660,253,407,652,8,ITI,ITI2,10,Umbria
2021-03-29,FVG,7087,3211,3876,5508,1579,ITH,ITH4,6,Friuli-Venezia Giulia
2021-06-06,SIC,49503,23918,25585,41683,7820,ITG,ITG1,19,Sicilia
2021-01-29,SAR,2955,1069,1886,48,2907,ITG,ITG2,20,Sardegna
2021-03-18,MOL,1156,476,680,692,464,ITF,ITF2,14,Molise
2021-01-03,PIE,3063,967,2096,3063,0,ITC,ITC1,1,Piemonte
2021-03-28,PAB,569,212,357,11,558,ITH,ITH1,4,Provincia Autonoma Bolzano / Bozen
2021-05-23,LIG,2305,1119,1186,1182,1123,ITC,ITC3,7,Liguria
2021-01-14,BAS,969,413,556,969,0,ITF,ITF5,17,Basilicata
2021-02-26,SIC,11883,5811,6072,10202,1681,ITG,ITG1,19,Sicilia
2021-04-22,VEN,31933,13898,18035,16191,15742,ITH,ITH3,5,Veneto
2021-01-28,ABR,1433,495,938,12,1421,ITF,ITF1,13,Abruzzo
2021-03-01,LIG,3526,1444,2082,3404,122,ITC,ITC3,7,Liguria
2021-04-03,CAL,8888,3812,5076,4287,4601,ITF,ITF6,18,Calabria
2021-05-06,SIC,29220,13925,15295,18506,10714,ITG,ITG1,19,Sicilia
2021-05-23,CAM,58733,28633,30100,37839,20894,ITF,ITF3,15,Campania
2021-05-01,LAZ,37939,17078,20861,25988,11951,ITI,ITI4,12,Lazio
2021-05-09,LOM,69539,32815,36724,56427,13112,ITC,ITC4,3,Lombardia
2021-06-09,LIG,18561,9327,9234,12053,6508,ITC,ITC3,7,Liguria
2021-02-12,CAM,6529,2861,3668,6343,186,ITF,ITF3,15,Campania
2021-05-25,ABR,11320,5264,6056,8187,3133,ITF,ITF1,13,Abruzzo
2021-02-10,LAZ,8187,3398,4789,4849,3338,ITI,ITI4,12,Lazio
2021-02-10,UMB,715,349,366,700,15,ITI,ITI2,10,Umbria
2021-03-13,PAT,831,381,450,783,48,ITH,ITH2,4,Provincia Autonoma Trento
2021-05-09,VEN,35015,16098,18917,24954,10061,ITH,ITH3,5,Veneto
2021-05-21,LAZ,51159,24450,26709,37485,13674,ITI,ITI4,12,Lazio
2021-05-31,MAR,11780,5941,5839,8851,2929,ITI,ITI3,11,Marche
2021-04-05,VDA,462,222,240,458,4,ITC,ITC2,2,Valle d'Aosta / Vallée d'Aoste
2021-06-04,LAZ,61383,30107,31276,44059,17324,ITI,ITI4,12,Lazio
2021-05-02,FVG,6839,3210,3629,3939,2900,ITH,ITH4,6,Friuli-Venezia Giulia
2021-02-20,PIE,3834,1254,2580,3660,174,ITC,ITC1,1,Piemonte
2021-05-17,MAR,11853,5568,6285,7690,4163,ITI,ITI3,11,Marche
2021-01-12,BAS,217,88,129,217,0,ITF,ITF5,17,Basilicata
2021-02-11,MOL,293,133,160,257,36,ITF,ITF2,14,Molise
2021-06-05,PAB,6065,3021,3044,4972,1093,ITH,ITH1,4,Provincia Autonoma Bolzano / Bozen
2021-03-04,LOM,29296,12099,17197,20241,9055,ITC,ITC4,3,Lombardia
2021-04-04,LIG,756,366,390,507,249,ITC,ITC3,7,Liguria
2021-04-23,PUG,29362,13641,15721,24151,5211,ITF,ITF4,16,Puglia
2021-01-31,ABR,1521,493,1028,288,1233,ITF,ITF1,13,Abruzzo
2021-05-04,LAZ,39800,18310,21490,26318,13482,ITI,ITI4,12,Lazio
2021-05-22,MOL,1311,709,602,1227,84,ITF,ITF2,14,Molise
2021-04-18,LIG,2613,1164,1449,2145,468,ITC,ITC3,7,Liguria
2021-05-16,FVG,9943,4762,5181,8546,1397,ITH,ITH4,6,Friuli-Venezia Giulia
2021-05-26,VEN,30959,15135,15824,14545,16414,ITH,ITH3,5,Veneto
2021-05-28,SAR,18162,8901,9261,13692,4470,ITG,ITG2,20,Sardegna
2021-05-10,ABR,10106,4783,5323,5458,4648,ITF,ITF1,13,Abruzzo
2021-02-17,SAR,1407,577,830,1333,74,ITG,ITG2,20,Sardegna
2021-04-30,PAB,3337,1592,1745,1562,1775,ITH,ITH1,4,Provincia Autonoma Bolzano / Bozen
2021-04-29,PIE,48349,21885,26464,35731,12618,ITC,ITC1,1,Piemonte
2021-05-25,SAR,14324,7024,7300,8594,5730,ITG,ITG2,20,Sardegna
2021-01-08,LIG,2926,999,1927,2926,0,ITC,ITC3,7,Liguria
2021-01-20,PAB,617,252,365,409,208,ITH,ITH1,4,Provincia Autonoma Bolzano / Bozen
2021-01-24,SIC,4309,2253,2056,138,4171,ITG,ITG1,19,Sicilia
2021-04-23,ABR,7382,3387,3995,5080,2302,ITF,ITF1,13,Abruzzo
2021-04-30,MAR,13939,6100,7839,5398,8541,ITI,ITI3,11,Marche
2021-01-06,PAB,59,18,41,59,0,ITH,ITH1,4,Provincia Autonoma Bolzano / Bozen
2021-02-14,CAL,464,211,253,434,30,ITF,ITF6,18,Calabria
2021-06-11,SAR,9840,4656,5184,5896,3944,ITG,ITG2,20,Sardegna
2021-01-30,ABR,1510,567,943,69,1441,ITF,ITF1,13,Abruzzo
2021-03-01,VEN,9394,3716,5678,7572,1822,ITH,ITH3,5,Veneto
2021-04-05,CAM,11639,5544,6095,9216,2423,ITF,ITF3,15,Campania
2021-03-03,SAR,4063,2265,1798,2815,1248,ITG,ITG2,20,Sardegna
2021-03-22,LOM,40308,14293,26015,29769,10539,ITC,ITC4,3,Lombardia
2021-05-16,PIE,28114,12763,15351,15057,13057,ITC,ITC1,1,Piemonte
2021-05-25,CAL,16366,7988,8378,10289,6077,ITF,ITF6,18,Calabria
2021-04-08,LOM,52297,21742,30555,35851,16446,ITC,ITC4,3,Lombardia
2021-02-05,PIE,9604,3139,6465,659,8945,ITC,ITC1,1,Piemonte
2020-12-29,LOM,104,44,60,104,0,ITC,ITC4,3,Lombardia
2021-02-24,LAZ,12048,5208,6840,11054,994,ITI,ITI4,12,Lazio
2021-01-24,UMB,258,106,152,1,257,ITI,ITI2,10,Umbria
2021-05-04,SIC,26752,12462,14290,17531,9221,ITG,ITG1,19,Sicilia
2021-04-22,LOM,73828,33349,40479,57511,16317,ITC,ITC4,3,Lombardia
2021-03-17,CAM,11590,5101,6489,5010,6580,ITF,ITF3,15,Campania
2021-04-29,PAT,4627,2233,2394,4420,207,ITH,ITH2,4,Provincia Autonoma Trento
2021-05-10,BAS,4805,2383,2422,2765,2040,ITF,ITF5,17,Basilicata
2021-03-03,LOM,26954,11506,15448,19678,7276,ITC,ITC4,3,Lombardia
2021-04-27,TOS,10348,4910,5438,3866,6482,ITI,ITI1,9,Toscana
2021-03-18,PUG,9404,4256,5148,3286,6118,ITF,ITF4,16,Puglia
2021-04-11,MAR,7117,3115,4002,6831,286,ITI,ITI3,11,Marche
2021-01-22,PAT,1668,433,1235,329,1339,ITH,ITH2,4,Provincia Autonoma Trento
2021-01-26,CAL,1811,862,949,278,1533,ITF,ITF6,18,Calabria
2021-03-10,FVG,3790,1881,1909,1998,1792,ITH,ITH4,6,Friuli-Venezia Giulia
2021-01-27,LIG,1744,603,1141,141,1603,ITC,ITC3,7,Liguria
2021-02-05,PAT,802,272,530,283,519,ITH,ITH2,4,Provincia Autonoma Trento
2021-02-24,FVG,2522,1086,1436,2504,18,ITH,ITH4,6,Friuli-Venezia Giulia
2021-03-29,LAZ,26057,12665,13392,19019,7038,ITI,ITI4,12,Lazio
2021-05-01,EMR,28400,12772,15628,15628,12772,ITH,ITH5,8,Emilia-Romagna
2021-05-16,PAT,1329,735,594,1091,238,ITH,ITH2,4,Provincia Autonoma Trento
2021-03-04,PUG,15515,6247,9268,14096,1419,ITF,ITF4,16,Puglia
2021-03-30,PAB,1298,532,766,218,1080,ITH,ITH1,4,Provincia Autonoma Bolzano / Bozen
2021-06-08,UMB,7252,3580,3672,6740,512,ITI,ITI2,10,Umbria
2021-06-11,CAM,47104,22740,24364,41892,5212,ITF,ITF3,15,Campania
2021-05-21,LIG,12844,5954,6890,9714,3130,ITC,ITC3,7,Liguria
2021-06-09,PUG,40352,20009,20343,29551,10801,ITF,ITF4,16,Puglia
2021-01-28,VDA,291,123,168,56,235,ITC,ITC2,2,Valle d'Aosta / Vallée d'Aoste
2021-03-03,CAM,13922,5495,8427,7292,6630,ITF,ITF3,15,Campania
2021-04-03,VEN,21941,9624,12317,14226,7715,ITH,ITH3,5,Veneto
2021-03-11,MAR,6592,2785,3807,5222,1370,ITI,ITI3,11,Marche
2021-04-16,PAB,2949,1418,1531,2438,511,ITH,ITH1,4,Provincia Autonoma Bolzano / Bozen
2021-04-22,CAL,9625,4798,4827,6777,2848,ITF,ITF6,18,Calabria
2021-01-05,PAT,709,232,477,709,0,ITH,ITH2,4,Provincia Autonoma Trento
2021-02-27,LIG,1888,921,967,1759,129,ITC,ITC3,7,Liguria
2021-03-20,VEN,13020,5419,7601,10936,2084,ITH,ITH3,5,Veneto
2021-03-27,FVG,5589,3128,2461,4178,1411,ITH,ITH4,6,Friuli-Venezia Giulia
2021-02-15,PUG,3252,1268,1984,2632,620,ITF,ITF4,16,Puglia
2021-03-15,LAZ,21899,10701,11198,15156,6743,ITI,ITI4,12,Lazio
2021-03-22,SAR,3973,1756,2217,3459,514,ITG,ITG2,20,Sardegna
2021-03-25,MAR,6657,2772,3885,3248,3409,ITI,ITI3,11,Marche
2021-05-06,CAL,13253,6272,6981,8994,4259,ITF,ITF6,18,Calabria
2021-03-16,MOL,614,230,384,267,347,ITF,ITF2,14,Molise
2021-04-15,PAT,3185,1438,1747,3031,154,ITH,ITH2,4,Provincia Autonoma Trento
2021-01-17,TOS,2536,871,1665,2023,513,ITI,ITI1,9,Toscana
2021-02-10,LIG,2314,837,1477,1019,1295,ITC,ITC3,7,Liguria
2021-05-26,PUG,38176,18327,19849,26571,11605,ITF,ITF4,16,Puglia
2021-04-08,SAR,13439,5936,7503,8319,5120,ITG,ITG2,20,Sardegna
2020-12-29,SAR,57,32,25,57,0,ITG,ITG2,20,Sardegna
2021-03-11,PAB,1684,825,859,1146,538,ITH,ITH1,4,Provincia Autonoma Bolzano / Bozen
2021-03-09,LIG,5930,2753,3177,4499,1431,ITC,ITC3,7,Liguria
2021-04-06,FVG,6639,3102,3537,5489,1150,ITH,ITH4,6,Friuli-Venezia Giulia
2021-03-12,ABR,6015,1987,4028,4433,1582,ITF,ITF1,13,Abruzzo
2021-04-04,MAR,3824,1792,2032,2655,1169,ITI,ITI3,11,Marche
2021-05-16,CAL,13771,6722,7049,9961,3810,ITF,ITF6,18,Calabria
2020-12-27,FVG,262,149,113,262,0,ITH,ITH4,6,Friuli-Venezia Giulia
2021-03-26,MOL,2575,1045,1530,1933,642,ITF,ITF2,14,Molise
2021-02-20,LIG,1335,637,698,1334,1,ITC,ITC3,7,Liguria
2021-05-01,VDA,940,563,377,456,484,ITC,ITC2,2,Valle d'Aosta / Vallée d'Aoste
2021-03-03,PIE,12120,4644,7476,11301,819,ITC,ITC1,1,Piemonte
2021-03-29,SAR,4995,2075,2920,4405,590,ITG,ITG2,20,Sardegna
2021-05-13,UMB,5905,2660,3245,3832,2073,ITI,ITI2,10,Umbria
2021-03-14,ABR,1873,731,1142,1207,666,ITF,ITF1,13,Abruzzo
2021-04-14,VDA,941,430,511,717,224,ITC,ITC2,2,Valle d'Aosta / Vallée d'Aoste
2021-05-18,CAM,52122,23192,28930,32511,19611,ITF,ITF3,15,Campania
2021-04-15,SAR,11821,5525,6296,6865,4956,ITG,ITG2,20,Sardegna
2021-01-03,VEN,5157,1562,3595,5157,0,ITH,ITH3,5,Veneto
2021-02-19,UMB,743,293,450,526,217,ITI,ITI2,10,Umbria
2021-01-05,SAR,1327,446,881,1327,0,ITG,ITG2,20,Sardegna
2021-01-08,TOS,5946,1642,4304,5946,0,ITI,ITI1,9,Toscana
2021-03-20,PIE,11922,4899,7023,6024,5898,ITC,ITC1,1,Piemonte
2021-06-09,MAR,14046,7304,6742,12176,1870,ITI,ITI3,11,Marche
2021-03-04,PAB,1716,1006,710,1487,229,ITH,ITH1,4,Provincia Autonoma Bolzano / Bozen
2021-01-22,SAR,83,47,36,55,28,ITG,ITG2,20,Sardegna
2021-02-12,PAT,1010,340,670,589,421,ITH,ITH2,4,Provincia Autonoma Trento
2021-01-17,CAL,896,430,466,801,95,ITF,ITF6,18,Calabria
2021-05-16,LIG,3705,1861,1844,2145,1560,ITC,ITC3,7,Liguria
2021-05-18,LOM,88109,42125,45984,32593,55516,ITC,ITC4,3,Lombardia
2021-02-19,SIC,4909,2649,2260,4344,565,ITG,ITG1,19,Sicilia
2021-06-04,LOM,104306,54182,50124,94779,9527,ITC,ITC4,3,Lombardia
2021-02-22,LIG,3334,1467,1867,3192,142,ITC,ITC3,7,Liguria
2021-02-24,LOM,14655,5922,8733,13730,925,ITC,ITC4,3,Lombardia
2021-02-25,ABR,3042,1330,1712,2514,528,ITF,ITF1,13,Abruzzo
2021-03-01,PAT,1237,454,783,942,295,ITH,ITH2,4,Provincia Autonoma Trento
2021-03-08,SIC,13603,6056,7547,10990,2613,ITG,ITG1,19,Sicilia
2021-06-05,ABR,14604,6859,7745,10553,4051,ITF,ITF1,13,Abruzzo
2021-06-07,MAR,13158,6497,6661,10709,2449,ITI,ITI3,11,Marche
2021-01-31,LAZ,4460,1854,2606,477,3983,ITI,ITI4,12,Lazio
2021-02-05,CAM,7260,3463,3797,2133,5127,ITF,ITF3,15,Campania
2021-03-20,PAT,874,403,471,671,203,ITH,ITH2,4,Provincia Autonoma Trento
2021-03-24,CAL,7624,3477,4147,4377,3247,ITF,ITF6,18,Calabria
2021-03-03,PAT,1659,622,1037,1141,518,ITH,ITH2,4,Provincia Autonoma Trento
2021-03-14,BAS,1010,477,533,541,469,ITF,ITF5,17,Basilicata
2021-01-02,VDA,6,5,1,6,0,ITC,ITC2,2,Valle d'Aosta / Vallée d'Aoste
2021-05-11,LAZ,48208,22150,26058,31711,16497,ITI,ITI4,12,Lazio
2021-03-26,VDA,498,204,294,491,7,ITC,ITC2,2,Valle d'Aosta / Vallée d'Aoste
2021-05-16,LOM,68652,32492,36160,36483,32169,ITC,ITC4,3,Lombardia
2021-05-30,SIC,35837,16199,19638,17789,18048,ITG,ITG1,19,Sicilia
2021-03-05,EMR,17929,5903,12026,14476,3453,ITH,ITH5,8,Emilia-Romagna
2021-02-05,LOM,25668,7448,18220,2408,23260,ITC,ITC4,3,Lombardia
2021-02-27,MAR,3356,1435,1921,3147,209,ITI,ITI3,11,Marche
2021-04-10,CAL,11372,5129,6243,6573,4799,ITF,ITF6,18,Calabria
2021-04-17,SAR,10082,4502,5580,5483,4599,ITG,ITG2,20,Sardegna
2021-02-18,MOL,319,74,245,306,13,ITF,ITF2,14,Molise
2021-03-31,BAS,3095,1258,1837,2313,782,ITF,ITF5,17,Basilicata
2021-05-13,SIC,47216,22141,25075,30721,16495,ITG,ITG1,19,Sicilia
2021-02-12,FVG,1193,428,765,1146,47,ITH,ITH4,6,Friuli-Venezia Giulia
2021-03-22,EMR,17921,8054,9867,11057,6864,ITH,ITH5,8,Emilia-Romagna
2021-04-01,TOS,27022,11204,15818,16390,10632,ITI,ITI1,9,Toscana
2021-05-26,PAB,4934,2490,2444,2961,1973,ITH,ITH1,4,Provincia Autonoma Bolzano / Bozen
2021-02-22,LOM,11894,4807,7087,11589,305,ITC,ITC4,3,Lombardia
2021-04-24,LAZ,33348,15032,18316,20595,12753,ITI,ITI4,12,Lazio
2021-04-29,CAM,41321,20033,21288,24844,16477,ITF,ITF3,15,Campania
2021-06-11,PAT,4651,2198,2453,894,3757,ITH,ITH2,4,Provincia Autonoma Trento
2021-03-15,TOS,9019,3939,5080,4576,4443,ITI,ITI1,9,Toscana
2021-01-19,CAM,1095,474,621,1092,3,ITF,ITF3,15,Campania
2021-06-05,BAS,4796,2206,2590,3853,943,ITF,ITF5,17,Basilicata
2021-01-31,SIC,4031,1926,2105,113,3918,ITG,ITG1,19,Sicilia
2021-03-08,VEN,13708,6347,7361,9639,4069,ITH,ITH3,5,Veneto
2021-03-09,MOL,1329,579,750,1177,152,ITF,ITF2,14,Molise
2021-03-03,EMR,15842,5254,10588,13365,2477,ITH,ITH5,8,Emilia-Romagna
2021-05-11,SIC,32268,15355,16913,19796,12472,ITG,ITG1,19,Sicilia
2021-02-20,MOL,1018,441,577,998,20,ITF,ITF2,14,Molise
2021-02-17,SIC,5215,3203,2012,4546,669,ITG,ITG1,19,Sicilia
2021-05-17,ABR,11038,5041,5997,6179,4859,ITF,ITF1,13,Abruzzo
2021-05-30,LAZ,41075,17537,23538,33819,7256,ITI,ITI4,12,Lazio
2021-05-13,LAZ,49800,22364,27436,32076,17724,ITI,ITI4,12,Lazio
2021-05-31,MOL,2287,1078,1209,1923,364,ITF,ITF2,14,Molise
2021-05-06,PIE,33313,15697,17616,19770,13543,ITC,ITC1,1,Piemonte
2021-02-23,BAS,1901,771,1130,1763,138,ITF,ITF5,17,Basilicata
2021-05-23,PIE,28693,13129,15564,15750,12943,ITC,ITC1,1,Piemonte
2021-05-14,MOL,2644,1215,1429,1926,718,ITF,ITF2,14,Molise
2020-12-27,PAT,103,40,63,103,0,ITH,ITH2,4,Provincia Autonoma Trento
2021-02-12,PIE,6891,2215,4676,3930,2961,ITC,ITC1,1,Piemonte
2021-06-03,BAS,4918,2255,2663,3737,1181,ITF,ITF5,17,Basilicata
2021-05-25,FVG,12847,6349,6498,9536,3311,ITH,ITH4,6,Friuli-Venezia Giulia
2021-03-12,BAS,1905,980,925,805,1100,ITF,ITF5,17,Basilicata
2021-04-24,SIC,31135,14697,16438,23523,7612,ITG,ITG1,19,Sicilia
2021-03-01,PIE,12043,4846,7197,11234,809,ITC,ITC1,1,Piemonte
2021-03-13,LOM,27165,9767,17398,21076,6089,ITC,ITC4,3,Lombardia
2021-01-03,SAR,90,36,54,90,0,ITG,ITG2,20,Sardegna
2021-01-10,TOS,3001,1104,1897,3001,0,ITI,ITI1,9,Toscana
2021-02-05,CAL,3807,1713,2094,489,3318,ITF,ITF6,18,Calabria
2021-06-02,MOL,2778,1346,1432,2706,72,ITF,ITF2,14,Molise
2021-04-20,TOS,18155,8110,10045,12599,5556,ITI,ITI1,9,Toscana
2021-06-11,FVG,4572,2566,2006,4050,522,ITH,ITH4,6,Friuli-Venezia Giulia
2021-05-17,BAS,5539,2733,2806,3406,2133,ITF,ITF5,17,Basilicata
2021-02-02,MOL,539,176,363,216,323,ITF,ITF2,14,Molise
2021-02-21,VDA,18,3,15,0,18,ITC,ITC2,2,Valle d'Aosta / Vallée d'Aoste
2021-05-09,PAT,2322,1210,1112,1978,344,ITH,ITH2,4,Provincia Autonoma Trento
2021-05-20,BAS,5855,2964,2891,2890,2965,ITF,ITF5,17,Basilicata
2021-01-16,MOL,420,166,254,420,0,ITF,ITF2,14,Molise
2021-04-13,CAM,26602,12683,13919,21071,5531,ITF,ITF3,15,Campania
2021-05-05,MAR,11647,5300,6347,5218,6429,ITI,ITI3,11,Marche
2021-01-03,CAM,3836,2009,1827,3836,0,ITF,ITF3,15,Campania
2021-02-15,PAT,534,188,346,420,114,ITH,ITH2,4,Provincia Autonoma Trento
2021-04-26,MOL,1157,521,636,826,331,ITF,ITF2,14,Molise
2021-06-06,BAS,4500,2068,2432,3722,778,ITF,ITF5,17,Basilicata
2021-06-01,VDA,871,469,402,518,353,ITC,ITC2,2,Valle d'Aosta / Vallée d'Aoste
2021-04-08,LAZ,26710,12225,14485,19024,7686,ITI,ITI4,12,Lazio
2021-05-26,PAT,3903,1838,2065,1225,2678,ITH,ITH2,4,Provincia Autonoma Trento
2021-04-09,MOL,2321,1249,1072,2130,191,ITF,ITF2,14,Molise
2021-04-13,LOM,47575,21238,26337,33505,14070,ITC,ITC4,3,Lombardia
2021-06-07,TOS,34776,17033,17743,31180,3596,ITI,ITI1,9,Toscana
2021-01-15,SIC,4719,2056,2663,4719,0,ITG,ITG1,19,Sicilia
2021-04-20,FVG,7107,3059,4048,3204,3903,ITH,ITH4,6,Friuli-Venezia Giulia
2021-05-28,EMR,41328,19093,22235,17846,23482,ITH,ITH5,8,Emilia-Romagna
2021-04-25,SIC,21352,10183,11169,16375,4977,ITG,ITG1,19,Sicilia
2021-05-21,TOS,28859,13441,15418,17459,11400,ITI,ITI1,9,Toscana
2021-04-30,LOM,117062,54711,62351,89728,27334,ITC,ITC4,3,Lombardia
2021-02-01,SIC,5888,2614,3274,294,5594,ITG,ITG1,19,Sicilia
2021-01-20,LOM,5663,1377,4286,5549,114,ITC,ITC4,3,Lombardia
2021-01-18,MOL,114,48,66,114,0,ITF,ITF2,14,Molise
2021-04-27,VEN,28115,12749,15366,21198,6917,ITH,ITH3,5,Veneto
2021-03-22,SIC,16645,7916,8729,11283,5362,ITG,ITG1,19,Sicilia
2021-04-22,EMR,29044,13446,15598,14967,14077,ITH,ITH5,8,Emilia-Romagna
2021-01-17,VEN,1933,781,1152,1584,349,ITH,ITH3,5,Veneto
2021-02-05,UMB,780,234,546,18,762,ITI,ITI2,10,Umbria
2021-01-12,EMR,9476,3124,6352,9476,0,ITH,ITH5,8,Emilia-Romagna
2020-12-29,SIC,241,150,91,241,0,ITG,ITG1,19,Sicilia
2021-01-10,FVG,2939,918,2021,2939,0,ITH,ITH4,6,Friuli-Venezia Giulia
2021-03-28,ABR,2414,1016,1398,2043,371,ITF,ITF1,13,Abruzzo
2021-04-11,MOL,1196,591,605,1182,14,ITF,ITF2,14,Molise
2021-01-18,PUG,1845,770,1075,1496,349,ITF,ITF4,16,Puglia
2021-04-14,BAS,2042,998,1044,1368,674,ITF,ITF5,17,Basilicata
2021-04-05,FVG,2870,1427,1443,2855,15,ITH,ITH4,6,Friuli-Venezia Giulia
2021-04-03,PIE,19431,8157,11274,10884,8547,ITC,ITC1,1,Piemonte
2021-01-21,BAS,30,10,20,30,0,ITF,ITF5,17,Basilicata
2021-02-03,VEN,5943,1665,4278,480,5463,ITH,ITH3,5,Veneto
2021-01-10,PIE,5214,2275,2939,5214,0,ITC,ITC1,1,Piemonte
2021-01-04,BAS,607,271,336,607,0,ITF,ITF5,17,Basilicata
2021-01-22,LOM,3103,865,2238,3034,69,ITC,ITC4,3,Lombardia
2021-01-12,FVG,2260,713,1547,2260,0,ITH,ITH4,6,Friuli-Venezia Giulia
2021-04-25,PAB,3072,1497,1575,2401,671,ITH,ITH1,4,Provincia Autonoma Bolzano / Bozen
2021-01-29,FVG,2414,814,1600,264,2150,ITH,ITH4,6,Friuli-Venezia Giulia
2021-02-06,PUG,4547,1928,2619,1591,2956,ITF,ITF4,16,Puglia
2021-03-01,TOS,4473,1733,2740,832,3641,ITI,ITI1,9,Toscana
2021-04-29,VEN,50215,23360,26855,37034,13181,ITH,ITH3,5,Veneto
2021-01-20,PUG,1545,540,1005,1537,8,ITF,ITF4,16,Puglia
2021-03-08,LIG,5630,2460,3170,3941,1689,ITC,ITC3,7,Liguria
2021-04-30,PUG,34846,15608,19238,22894,11952,ITF,ITF4,16,Puglia
2021-04-22,FVG,6770,3078,3692,3083,3687,ITH,ITH4,6,Friuli-Venezia Giulia
2021-02-05,VEN,8372,2534,5838,1415,6957,ITH,ITH3,5,Veneto
2021-04-14,ABR,6615,2958,3657,4497,2118,ITF,ITF1,13,Abruzzo
2021-05-07,MAR,12836,5804,7032,3658,9178,ITI,ITI3,11,Marche
2021-04-12,UMB,7088,3078,4010,5370,1718,ITI,ITI2,10,Umbria
2021-02-22,VEN,7013,3040,3973,6626,387,ITH,ITH3,5,Veneto
2021-03-25,LIG,9896,4355,5541,6503,3393,ITC,ITC3,7,Liguria
2021-04-13,PUG,28660,13586,15074,25259,3401,ITF,ITF4,16,Puglia
2021-02-13,MAR,1093,462,631,1011,82,ITI,ITI3,11,Marche
2021-01-19,UMB,103,23,80,103,0,ITI,ITI2,10,Umbria
2021-02-23,VDA,216,123,93,216,0,ITC,ITC2,2,Valle d'Aosta / Vallée d'Aoste
2021-01-01,LIG,144,55,89,144,0,ITC,ITC3,7,Liguria
2021-04-05,EMR,14862,6811,8051,11970,2892,ITH,ITH5,8,Emilia-Romagna
2021-05-16,VEN,28402,14004,14398,21318,7084,ITH,ITH3,5,Veneto
2021-01-04,ABR,1403,576,827,1403,0,ITF,ITF1,13,Abruzzo
2021-01-27,MAR,2121,781,1340,122,1999,ITI,ITI3,11,Marche
2021-03-10,CAL,6553,3314,3239,5271,1282,ITF,ITF6,18,Calabria
2021-04-29,UMB,5215,2248,2967,2889,2326,ITI,ITI2,10,Umbria
2021-05-18,SAR,14036,6778,7258,9502,4534,ITG,ITG2,20,Sardegna
2021-01-13,PAB,1691,557,1134,1691,0,ITH,ITH1,4,Provincia Autonoma Bolzano / Bozen
2021-03-24,UMB,4106,1792,2314,2783,1323,ITI,ITI2,10,Umbria
2021-01-23,ABR,264,115,149,57,207,ITF,ITF1,13,Abruzzo
2021-04-22,PIE,27651,12725,14926,20952,6699,ITC,ITC1,1,Piemonte
2021-01-12,PIE,10090,3415,6675,10090,0,ITC,ITC1,1,Piemonte
2021-01-30,PAB,498,245,253,4,494,ITH,ITH1,4,Provincia Autonoma Bolzano / Bozen
2021-03-29,CAM,19640,9809,9831,18094,1546,ITF,ITF3,15,Campania
2021-05-03,ABR,11108,5238,5870,7260,3848,ITF,ITF1,13,Abruzzo
2021-06-03,VDA,1305,666,639,896,409,ITC,ITC2,2,Valle d'Aosta / Vallée d'Aoste
2021-01-29,PIE,5944,1887,4057,455,5489,ITC,ITC1,1,Piemonte
2021-02-24,SAR,2413,1294,1119,2223,190,ITG,ITG2,20,Sardegna
2021-04-20,MAR,10696,4995,5701,9279,1417,ITI,ITI3,11,Marche
2021-06-01,CAL,12813,5942,6871,7917,4896,ITF,ITF6,18,Calabria
2021-04-10,UMB,7469,3512,3957,7334,135,ITI,ITI2,10,Umbria
2021-05-02,PUG,21274,9648,11626,14020,7254,ITF,ITF4,16,Puglia
2021-04-23,PAB,4542,2151,2391,3251,1291,ITH,ITH1,4,Provincia Autonoma Bolzano / Bozen
2021-05-17,VDA,809,417,392,375,434,ITC,ITC2,2,Valle d'Aosta / Vallée d'Aoste
2021-01-17,UMB,54,17,37,54,0,ITI,ITI2,10,Umbria
2021-03-27,LIG,3941,1557,2384,2546,1395,ITC,ITC3,7,Liguria
2021-05-23,TOS,28372,13644,14728,25807,2565,ITI,ITI1,9,Toscana
2021-01-25,MAR,1597,560,1037,96,1501,ITI,ITI3,11,Marche
2020-12-31,UMB,322,127,195,322,0,ITI,ITI2,10,Umbria
2021-04-10,SIC,20404,9960,10444,11438,8966,ITG,ITG1,19,Sicilia
2021-01-10,PAT,84,19,65,84,0,ITH,ITH2,4,Provincia Autonoma Trento
2021-03-13,LIG,3871,1658,2213,3016,855,ITC,ITC3,7,Liguria
2021-05-03,VDA,839,400,439,488,351,ITC,ITC2,2,Valle d'Aosta / Vallée d'Aoste
2021-05-02,MAR,8899,3936,4963,3161,5738,ITI,ITI3,11,Marche
2021-03-10,SAR,6086,2985,3101,5236,850,ITG,ITG2,20,Sardegna
2021-01-17,CAM,1155,551,604,702,453,ITF,ITF3,15,Campania
2021-01-29,TOS,6144,1700,4444,304,5840,ITI,ITI1,9,Toscana
2021-03-22,CAL,4889,2292,2597,3135,1754,ITF,ITF6,18,Calabria
2021-04-10,PIE,30165,13416,16749,25887,4278,ITC,ITC1,1,Piemonte
2021-05-06,SAR,12945,6008,6937,9799,3146,ITG,ITG2,20,Sardegna
2021-05-07,PAB,4192,2061,2131,3664,528,ITH,ITH1,4,Provincia Autonoma Bolzano / Bozen
2021-01-24,VEN,4117,1219,2898,28,4089,ITH,ITH3,5,Veneto
2021-03-15,CAM,13664,6804,6860,8919,4745,ITF,ITF3,15,Campania
2021-03-07,VDA,64,30,34,11,53,ITC,ITC2,2,Valle d'Aosta / Vallée d'Aoste
2021-05-09,TOS,22527,9765,12762,9668,12859,ITI,ITI1,9,Toscana
2021-04-24,UMB,4562,1963,2599,3384,1178,ITI,ITI2,10,Umbria
2021-01-13,MOL,474,160,314,474,0,ITF,ITF2,14,Molise
2021-05-05,PAB,4154,1945,2209,2038,2116,ITH,ITH1,4,Provincia Autonoma Bolzano / Bozen
2021-04-23,MOL,2050,882,1168,1391,659,ITF,ITF2,14,Molise
2021-01-17,EMR,2890,887,2003,2644,246,ITH,ITH5,8,Emilia-Romagna
2021-01-25,PAB,487,183,304,3,484,ITH,ITH1,4,Provincia Autonoma Bolzano / Bozen
2021-03-01,SAR,2264,1153,1111,1605,659,ITG,ITG2,20,Sardegna
2021-01-12,UMB,838,248,590,838,0,ITI,ITI2,10,Umbria
2021-04-22,SIC,26881,12673,14208,20422,6459,ITG,ITG1,19,Sicilia
2021-04-04,ABR,1636,771,865,1507,129,ITF,ITF1,13,Abruzzo
2021-04-08,PAT,3114,1294,1820,1996,1118,ITH,ITH2,4,Provincia Autonoma Trento
2021-03-10,SIC,14117,6296,7821,11935,2182,ITG,ITG1,19,Sicilia
2021-04-15,PIE,29637,13574,16063,24153,5484,ITC,ITC1,1,Piemonte
2021-03-23,PAB,1553,759,794,1552,1,ITH,ITH1,4,Provincia Autonoma Bolzano / Bozen
2021-01-05,PIE,5381,1603,3778,5381,0,ITC,ITC1,1,Piemonte
2021-01-12,SIC,4299,2105,2194,4299,0,ITG,ITG1,19,Sicilia
2021-04-27,LOM,85948,39960,45988,69410,16538,ITC,ITC4,3,Lombardia
2021-03-14,UMB,66,48,18,66,0,ITI,ITI2,10,Umbria
2021-04-07,VEN,35960,16166,19794,28631,7329,ITH,ITH3,5,Veneto
2021-01-07,FVG,2091,717,1374,2091,0,ITH,ITH4,6,Friuli-Venezia Giulia
2021-02-14,LIG,233,122,111,233,0,ITC,ITC3,7,Liguria
2021-04-02,EMR,23399,10557,12842,18919,4480,ITH,ITH5,8,Emilia-Romagna
2021-02-27,BAS,1993,861,1132,1829,164,ITF,ITF5,17,Basilicata
2021-03-05,FVG,3806,1544,2262,2733,1073,ITH,ITH4,6,Friuli-Venezia Giulia
2021-05-25,LIG,14067,6859,7208,10922,3145,ITC,ITC3,7,Liguria
2021-05-29,EMR,37617,16440,21177,17124,20493,ITH,ITH5,8,Emilia-Romagna
2021-05-15,SIC,56482,26387,30095,41237,15245,ITG,ITG1,19,Sicilia
2021-03-19,SIC,16238,8007,8231,10757,5481,ITG,ITG1,19,Sicilia
2021-01-30,VDA,439,202,237,14,425,ITC,ITC2,2,Valle d'Aosta / Vallée d'Aoste
2021-01-31,VEN,4769,1562,3207,392,4377,ITH,ITH3,5,Veneto
2021-05-27,CAM,74100,36488,37612,27002,47098,ITF,ITF3,15,Campania
2021-02-16,CAM,5440,2411,3029,4669,771,ITF,ITF3,15,Campania
2021-03-29,VEN,31490,13726,17764,27658,3832,ITH,ITH3,5,Veneto
2021-02-04,LAZ,6302,2481,3821,987,5315,ITI,ITI4,12,Lazio
2021-04-01,PAB,2786,1407,1379,2642,144,ITH,ITH1,4,Provincia Autonoma Bolzano / Bozen
2021-04-08,PUG,17449,7574,9875,11275,6174,ITF,ITF4,16,Puglia
2020-12-31,PAT,1624,449,1175,1624,0,ITH,ITH2,4,Provincia Autonoma Trento
2021-06-07,BAS,4220,1912,2308,3904,316,ITF,ITF5,17,Basilicata
2021-04-11,BAS,848,330,518,785,63,ITF,ITF5,17,Basilicata
2021-05-13,SAR,11579,5437,6142,8535,3044,ITG,ITG2,20,Sardegna
2021-04-19,FVG,6706,3131,3575,3293,3413,ITH,ITH4,6,Friuli-Venezia Giulia
2021-02-02,SAR,1498,669,829,257,1241,ITG,ITG2,20,Sardegna
2021-01-09,FVG,2513,841,1672,2513,0,ITH,ITH4,6,Friuli-Venezia Giulia
2021-02-27,ABR,2813,1338,1475,2546,267,ITF,ITF1,13,Abruzzo
2021-03-22,MAR,5653,2375,3278,2525,3128,ITI,ITI3,11,Marche
2021-01-07,PIE,5387,1739,3648,5387,0,ITC,ITC1,1,Piemonte
2021-03-12,UMB,2788,1166,1622,2292,496,ITI,ITI2,10,Umbria
2021-06-06,PUG,30348,15286,15062,25378,4970,ITF,ITF4,16,Puglia
2021-02-09,CAL,2158,911,1247,956,1202,ITF,ITF6,18,Calabria
2021-03-05,PIE,15270,5961,9309,11451,3819,ITC,ITC1,1,Piemonte
2021-05-20,TOS,29901,14034,15867,18903,10998,ITI,ITI1,9,Toscana
2021-04-10,PUG,30738,13033,17705,26515,4223,ITF,ITF4,16,Puglia
2021-01-25,VDA,147,65,82,0,147,ITC,ITC2,2,Valle d'Aosta / Vallée d'Aoste
2021-03-17,LOM,26250,10493,15757,15252,10998,ITC,ITC4,3,Lombardia
2021-03-22,LIG,7841,3573,4268,4904,2937,ITC,ITC3,7,Liguria
2021-05-22,CAM,67903,32489,35414,46444,21459,ITF,ITF3,15,Campania
2021-01-31,TOS,3050,1129,1921,106,2944,ITI,ITI1,9,Toscana
2021-05-13,VEN,44122,21771,22351,34230,9892,ITH,ITH3,5,Veneto
2021-05-29,CAL,19222,8931,10291,9395,9827,ITF,ITF6,18,Calabria
2021-02-02,VEN,6508,1878,4630,396,6112,ITH,ITH3,5,Veneto
2021-03-13,MOL,1189,594,595,200,989,ITF,ITF2,14,Molise
2021-01-24,MAR,881,339,542,5,876,ITI,ITI3,11,Marche
2021-02-07,LIG,407,153,254,2,405,ITC,ITC3,7,Liguria
2021-03-07,FVG,2547,932,1615,2546,1,ITH,ITH4,6,Friuli-Venezia Giulia
2021-06-07,ABR,11054,5280,5774,9239,1815,ITF,ITF1,13,Abruzzo
2021-01-15,MOL,538,242,296,538,0,ITF,ITF2,14,Molise
2021-04-11,ABR,5330,2606,2724,4847,483,ITF,ITF1,13,Abruzzo
2021-05-04,MAR,10841,4788,6053,4949,5892,ITI,ITI3,11,Marche
2021-05-18,LIG,13451,6116,7335,10166,3285,ITC,ITC3,7,Liguria
2021-05-30,PAB,4758,2514,2244,752,4006,ITH,ITH1,4,Provincia Autonoma Bolzano / Bozen
2021-03-05,PAT,2244,703,1541,1678,566,ITH,ITH2,4,Provincia Autonoma Trento
2021-03-12,SIC,12829,5546,7283,10833,1996,ITG,ITG1,19,Sicilia
2021-06-09,ABR,11392,6012,5380,9714,1678,ITF,ITF1,13,Abruzzo
2021-05-15,SAR,13781,6424,7357,10348,3433,ITG,ITG2,20,Sardegna
2021-01-07,PAT,1270,310,960,1270,0,ITH,ITH2,4,Provincia Autonoma Trento
2021-05-14,VDA,960,442,518,291,669,ITC,ITC2,2,Valle d'Aosta / Vallée d'Aoste
2020-12-31,FVG,1053,384,669,1053,0,ITH,ITH4,6,Friuli-Venezia Giulia
2021-04-05,TOS,15279,6823,8456,14542,737,ITI,ITI1,9,Toscana
2021-03-21,UMB,675,338,337,675,0,ITI,ITI2,10,Umbria
2021-03-31,VEN,38879,16467,22412,31386,7493,ITH,ITH3,5,Veneto
2021-02-07,TOS,2806,952,1854,886,1920,ITI,ITI1,9,Toscana
2021-03-07,PIE,11977,4658,7319,11099,878,ITC,ITC1,1,Piemonte
2021-04-03,PAB,831,364,467,22,809,ITH,ITH1,4,Provincia Autonoma Bolzano / Bozen
2021-03-17,FVG,3235,1266,1969,745,2490,ITH,ITH4,6,Friuli-Venezia Giulia
2021-03-07,BAS,889,309,580,851,38,ITF,ITF5,17,Basilicata
2021-05-13,FVG,11060,5325,5735,9012,2048,ITH,ITH4,6,Friuli-Venezia Giulia
2021-05-28,LIG,16507,8327,8180,11916,4591,ITC,ITC3,7,Liguria
2020-12-30,PUG,1,0,1,1,0,ITF,ITF4,16,Puglia
2021-01-09,BAS,557,160,397,557,0,ITF,ITF5,17,Basilicata
2021-01-05,LIG,2879,896,1983,2879,0,ITC,ITC3,7,Liguria
2021-06-09,PAB,3737,1847,1890,1277,2460,ITH,ITH1,4,Provincia Autonoma Bolzano / Bozen
2021-02-26,VEN,8296,3271,5025,7039,1257,ITH,ITH3,5,Veneto
2021-01-09,LAZ,6297,2562,3735,6297,0,ITI,ITI4,12,Lazio
2021-03-01,PAB,922,221,701,921,1,ITH,ITH1,4,Provincia Autonoma Bolzano / Bozen
2021-04-24,VEN,24743,10819,13924,15664,9079,ITH,ITH3,5,Veneto
2021-05-07,ABR,12193,5706,6487,7775,4418,ITF,ITF1,13,Abruzzo
2021-02-16,FVG,2516,1135,1381,2400,116,ITH,ITH4,6,Friuli-Venezia Giulia
2021-03-03,LIG,4580,1847,2733,3554,1026,ITC,ITC3,7,Liguria
2021-04-12,SAR,6990,3179,3811,5276,1714,ITG,ITG2,20,Sardegna
2021-01-02,SAR,60,21,39,60,0,ITG,ITG2,20,Sardegna
2021-03-15,PAB,1192,451,741,710,482,ITH,ITH1,4,Provincia Autonoma Bolzano / Bozen
2021-05-13,PIE,35602,17481,18121,20528,15074,ITC,ITC1,1,Piemonte
2021-06-08,SAR,14811,7064,7747,11320,3491,ITG,ITG2,20,Sardegna
2021-04-22,MAR,10796,4931,5865,9218,1578,ITI,ITI3,11,Marche
2021-05-20,PAT,4998,2353,2645,3374,1624,ITH,ITH2,4,Provincia Autonoma Trento
2021-02-02,PIE,10242,3509,6733,816,9426,ITC,ITC1,1,Piemonte
2021-02-28,SAR,368,169,199,142,226,ITG,ITG2,20,Sardegna
2021-02-24,MAR,3486,1515,1971,3408,78,ITI,ITI3,11,Marche
2021-03-24,PAT,2376,940,1436,1556,820,ITH,ITH2,4,Provincia Autonoma Trento
2021-03-22,PUG,10818,5951,4867,5172,5646,ITF,ITF4,16,Puglia
2021-03-31,PIE,19108,8103,11005,10414,8694,ITC,ITC1,1,Piemonte
2021-04-19,LAZ,30090,13674,16416,19412,10678,ITI,ITI4,12,Lazio
2021-04-26,SAR,6822,3265,3557,5947,875,ITG,ITG2,20,Sardegna
2021-04-27,PAB,2226,1013,1213,1150,1076,ITH,ITH1,4,Provincia Autonoma Bolzano / Bozen
2021-01-14,VEN,7063,1924,5139,7063,0,ITH,ITH3,5,Veneto
2021-01-17,PAB,2328,1044,1284,2317,11,ITH,ITH1,4,Provincia Autonoma Bolzano / Bozen
2021-01-24,PUG,1669,749,920,153,1516,ITF,ITF4,16,Puglia
2021-02-21,LAZ,6989,3180,3809,6526,463,ITI,ITI4,12,Lazio
2021-02-25,VDA,201,101,100,194,7,ITC,ITC2,2,Valle d'Aosta / Vallée d'Aoste
2021-05-27,PIE,37206,17319,19887,19142,18064,ITC,ITC1,1,Piemonte
2021-02-09,PAT,917,287,630,442,475,ITH,ITH2,4,Provincia Autonoma Trento
2021-03-12,VEN,18745,8277,10468,12002,6743,ITH,ITH3,5,Veneto
2021-06-01,LOM,93818,46038,47780,76832,16986,ITC,ITC4,3,Lombardia
2021-01-02,LOM,199,72,127,199,0,ITC,ITC4,3,Lombardia
2021-02-16,PIE,3967,1756,2211,3209,758,ITC,ITC1,1,Piemonte
2021-06-08,LOM,102012,51865,50147,88209,13803,ITC,ITC4,3,Lombardia
2021-03-15,PUG,12649,6460,6189,6146,6503,ITF,ITF4,16,Puglia
2021-02-28,LOM,7882,3253,4629,7672,210,ITC,ITC4,3,Lombardia
2021-05-03,CAL,14746,6757,7989,10542,4204,ITF,ITF6,18,Calabria
2021-01-17,PUG,1308,590,718,1239,69,ITF,ITF4,16,Puglia
2021-03-14,CAM,8617,3827,4790,4477,4140,ITF,ITF3,15,Campania
2021-02-15,MOL,144,70,74,141,3,ITF,ITF2,14,Molise
2021-03-17,PAT,2070,792,1278,1200,870,ITH,ITH2,4,Provincia Autonoma Trento
2021-04-26,LOM,87926,40919,47007,68769,19157,ITC,ITC4,3,Lombardia
2021-04-27,PUG,26633,12052,14581,21046,5587,ITF,ITF4,16,Puglia
2021-05-07,BAS,4649,2284,2365,3295,1354,ITF,ITF5,17,Basilicata
2021-05-10,CAM,35416,16374,19042,25498,9918,ITF,ITF3,15,Campania
2021-06-04,MAR,14335,7290,7045,11896,2439,ITI,ITI3,11,Marche
2021-03-21,CAL,4456,1926,2530,2734,1722,ITF,ITF6,18,Calabria
2021-04-08,MAR,7521,3285,4236,7194,327,ITI,ITI3,11,Marche
2021-04-12,SIC,18784,9121,9663,11534,7250,ITG,ITG1,19,Sicilia
2021-05-08,TOS,29150,13115,16035,13695,15455,ITI,ITI1,9,Toscana
2021-03-24,FVG,3965,1709,2256,2485,1480,ITH,ITH4,6,Friuli-Venezia Giulia
2021-03-25,ABR,5897,2760,3137,3281,2616,ITF,ITF1,13,Abruzzo
2021-02-14,SIC,1058,403,655,918,140,ITG,ITG1,19,Sicilia
2021-03-12,TOS,17855,7376,10479,14327,3528,ITI,ITI1,9,Toscana
2021-04-28,EMR,33712,15585,18127,20824,12888,ITH,ITH5,8,Emilia-Romagna
2021-01-27,ABR,1364,515,849,39,1325,ITF,ITF1,13,Abruzzo
2021-05-20,FVG,12706,6345,6361,10118,2588,ITH,ITH4,6,Friuli-Venezia Giulia
2021-06-08,CAM,51449,25032,26417,44475,6974,ITF,ITF3,15,Campania
2021-01-14,TOS,3255,1179,2076,3255,0,ITI,ITI1,9,Toscana
2021-03-07,CAL,3338,1703,1635,3247,91,ITF,ITF6,18,Calabria
2021-06-05,UMB,8146,3741,4405,5496,2650,ITI,ITI2,10,Umbria
2021-01-02,SIC,4835,2516,2319,4835,0,ITG,ITG1,19,Sicilia
2021-04-24,TOS,13435,6166,7269,5990,7445,ITI,ITI1,9,Toscana
2021-01-26,FVG,1977,647,1330,217,1760,ITH,ITH4,6,Friuli-Venezia Giulia
2021-04-26,CAM,34022,16644,17378,28400,5622,ITF,ITF3,15,Campania
2021-05-21,ABR,13017,6332,6685,8039,4978,ITF,ITF1,13,Abruzzo
2021-04-17,VEN,22409,9080,13329,15130,7279,ITH,ITH3,5,Veneto
2021-02-24,LIG,3764,1560,2204,3506,258,ITC,ITC3,7,Liguria
2021-04-20,PAB,1561,784,777,1560,1,ITH,ITH1,4,Provincia Autonoma Bolzano / Bozen
2021-01-07,VEN,8358,2317,6041,8358,0,ITH,ITH3,5,Veneto
2020-12-29,LIG,125,33,92,125,0,ITC,ITC3,7,Liguria
2021-01-10,PAB,2,2,0,2,0,ITH,ITH1,4,Provincia Autonoma Bolzano / Bozen
2021-03-18,ABR,3896,1651,2245,2065,1831,ITF,ITF1,13,Abruzzo
2021-01-12,LIG,2459,885,1574,2459,0,ITC,ITC3,7,Liguria
2021-02-09,FVG,1842,555,1287,1556,286,ITH,ITH4,6,Friuli-Venezia Giulia
2021-06-01,SAR,14318,6654,7664,9729,4589,ITG,ITG2,20,Sardegna
2021-02-21,SAR,1589,710,879,1559,30,ITG,ITG2,20,Sardegna
2021-04-22,LIG,13817,6194,7623,8747,5070,ITC,ITC3,7,Liguria
2021-01-21,VEN,2293,719,1574,21,2272,ITH,ITH3,5,Veneto
2021-02-02,PAT,908,240,668,191,717,ITH,ITH2,4,Provincia Autonoma Trento
2021-03-03,MAR,6645,3046,3599,5761,884,ITI,ITI3,11,Marche
2021-01-06,VDA,65,33,32,65,0,ITC,ITC2,2,Valle d'Aosta / Vallée d'Aoste
2021-04-19,SAR,10181,4617,5564,8762,1419,ITG,ITG2,20,Sardegna
2021-01-05,MAR,1571,589,982,1571,0,ITI,ITI3,11,Marche
2021-05-13,PAT,3406,1579,1827,2305,1101,ITH,ITH2,4,Provincia Autonoma Trento
2021-05-14,BAS,5907,2798,3109,3374,2533,ITF,ITF5,17,Basilicata
2021-01-09,SAR,4026,1417,2609,4026,0,ITG,ITG2,20,Sardegna
2021-02-14,LAZ,5777,2372,3405,5306,471,ITI,ITI4,12,Lazio
2021-03-24,PIE,15506,6342,9164,6379,9127,ITC,ITC1,1,Piemonte
2021-03-05,VEN,13377,5057,8320,9707,3670,ITH,ITH3,5,Veneto
2021-02-18,VDA,349,153,196,261,88,ITC,ITC2,2,Valle d'Aosta / Vallée d'Aoste
2021-02-28,LAZ,10258,4014,6244,9744,514,ITI,ITI4,12,Lazio
2021-03-07,SAR,1657,750,907,1117,540,ITG,ITG2,20,Sardegna
2021-03-08,PAB,1210,534,676,1183,27,ITH,ITH1,4,Provincia Autonoma Bolzano / Bozen
2021-05-20,PIE,38603,17944,20659,13623,24980,ITC,ITC1,1,Piemonte
2021-03-31,PAT,2569,983,1586,1712,857,ITH,ITH2,4,Provincia Autonoma Trento
2021-04-12,LOM,47217,20571,26646,32883,14334,ITC,ITC4,3,Lombardia
2021-01-02,LAZ,6707,2631,4076,6707,0,ITI,ITI4,12,Lazio
2021-02-09,PIE,7392,2316,5076,722,6670,ITC,ITC1,1,Piemonte
2021-05-04,PAB,3448,1843,1605,2411,1037,ITH,ITH1,4,Provincia Autonoma Bolzano / Bozen
2021-05-11,PUG,32451,14347,18104,14048,18403,ITF,ITF4,16,Puglia
2021-03-07,CAM,11973,5404,6569,8130,3843,ITF,ITF3,15,Campania
2021-05-04,PUG,34983,14793,20190,18562,16421,ITF,ITF4,16,Puglia
2021-02-21,LOM,5050,1861,3189,5033,17,ITC,ITC4,3,Lombardia
2021-02-22,MOL,265,129,136,250,15,ITF,ITF2,14,Molise
2021-03-14,CAL,2721,1069,1652,2305,416,ITF,ITF6,18,Calabria
2021-04-07,PIE,23607,9996,13611,18144,5463,ITC,ITC1,1,Piemonte
2021-03-08,PUG,15329,6752,8577,12930,2399,ITF,ITF4,16,Puglia
2021-05-03,CAM,40755,19889,20866,28905,11850,ITF,ITF3,15,Campania
2020-12-27,MOL,50,20,30,50,0,ITF,ITF2,14,Molise
2021-04-19,LOM,60086,27336,32750,50683,9403,ITC,ITC4,3,Lombardia
2021-03-18,BAS,1350,564,786,25,1325,ITF,ITF5,17,Basilicata
2021-04-15,MAR,10377,4674,5703,9812,565,ITI,ITI3,11,Marche
2021-01-26,PAT,542,154,388,27,515,ITH,ITH2,4,Provincia Autonoma Trento
2021-02-17,MAR,1785,662,1123,1668,117,ITI,ITI3,11,Marche
2021-05-06,PAT,5513,2730,2783,4734,779,ITH,ITH2,4,Provincia Autonoma Trento
2021-05-10,CAL,13145,6096,7049,7747,5398,ITF,ITF6,18,Calabria
2021-02-02,FVG,2467,806,1661,217,2250,ITH,ITH4,6,Friuli-Venezia Giulia
2021-03-31,FVG,8111,3576,4535,7265,846,ITH,ITH4,6,Friuli-Venezia Giulia
2021-05-14,ABR,10602,5076,5526,5444,5158,ITF,ITF1,13,Abruzzo
2021-05-01,TOS,23312,10062,13250,14137,9175,ITI,ITI1,9,Toscana
2021-03-05,TOS,17246,7028,10218,12504,4742,ITI,ITI1,9,Toscana
2021-04-26,CAL,10197,5065,5132,7775,2422,ITF,ITF6,18,Calabria
2021-04-01,ABR,5593,2505,3088,3506,2087,ITF,ITF1,13,Abruzzo
2021-02-21,SIC,5168,2501,2667,5062,106,ITG,ITG1,19,Sicilia
2021-01-13,TOS,4062,1398,2664,4062,0,ITI,ITI1,9,Toscana
2021-04-25,VEN,18316,8148,10168,13480,4836,ITH,ITH3,5,Veneto
2021-04-01,PIE,19331,8073,11258,11211,8120,ITC,ITC1,1,Piemonte
2021-06-04,UMB,8868,4384,4484,7692,1176,ITI,ITI2,10,Umbria
2021-06-05,MOL,2858,1450,1408,2717,141,ITF,ITF2,14,Molise
2021-04-23,TOS,25677,11428,14249,9361,16316,ITI,ITI1,9,Toscana
2021-03-14,PUG,3321,1430,1891,2510,811,ITF,ITF4,16,Puglia
2021-05-28,PIE,34976,16586,18390,19020,15956,ITC,ITC1,1,Piemonte
2021-01-06,VEN,8132,2385,5747,8132,0,ITH,ITH3,5,Veneto
2021-01-22,CAL,658,274,384,656,2,ITF,ITF6,18,Calabria
2021-01-16,PUG,2507,1033,1474,2507,0,ITF,ITF4,16,Puglia
2021-06-09,LOM,102027,51424,50603,88250,13777,ITC,ITC4,3,Lombardia
2021-05-02,CAL,12509,5836,6673,10669,1840,ITF,ITF6,18,Calabria
2021-01-08,EMR,10866,3581,7285,10866,0,ITH,ITH5,8,Emilia-Romagna
2021-01-25,PIE,6215,1938,4277,983,5232,ITC,ITC1,1,Piemonte
2021-02-20,SAR,2041,855,1186,1707,334,ITG,ITG2,20,Sardegna
2021-01-02,PAB,91,48,43,91,0,ITH,ITH1,4,Provincia Autonoma Bolzano / Bozen
2021-03-06,EMR,20878,5929,14949,18147,2731,ITH,ITH5,8,Emilia-Romagna
2021-01-06,MAR,2187,795,1392,2187,0,ITI,ITI3,11,Marche
2021-03-06,LIG,3304,1842,1462,2599,705,ITC,ITC3,7,Liguria
2021-03-08,LOM,29713,11169,18544,22644,7069,ITC,ITC4,3,Lombardia
2021-03-29,CAL,5613,2370,3243,3856,1757,ITF,ITF6,18,Calabria
2021-01-31,CAL,1110,555,555,154,956,ITF,ITF6,18,Calabria
2021-05-04,LOM,86791,41066,45725,72408,14383,ITC,ITC4,3,Lombardia
2021-05-06,LAZ,48667,22644,26023,31141,17526,ITI,ITI4,12,Lazio
2021-01-22,LIG,1820,605,1215,1334,486,ITC,ITC3,7,Liguria
2021-01-24,LOM,1199,457,742,536,663,ITC,ITC4,3,Lombardia
2021-02-19,FVG,3252,1290,1962,2825,427,ITH,ITH4,6,Friuli-Venezia Giulia
2021-03-04,MAR,6486,2868,3618,5093,1393,ITI,ITI3,11,Marche
2021-05-02,LIG,3878,1767,2111,506,3372,ITC,ITC3,7,Liguria
2021-03-13,MAR,5766,2656,3110,1809,3957,ITI,ITI3,11,Marche
2021-01-16,VDA,236,80,156,236,0,ITC,ITC2,2,Valle d'Aosta / Vallée d'Aoste
2021-04-29,SAR,11115,5109,6006,6761,4354,ITG,ITG2,20,Sardegna
2021-03-08,CAM,14768,6923,7845,9992,4776,ITF,ITF3,15,Campania
2021-02-11,ABR,816,262,554,773,43,ITF,ITF1,13,Abruzzo
2021-03-14,VDA,392,200,192,392,0,ITC,ITC2,2,Valle d'Aosta / Vallée d'Aoste
2021-03-15,VEN,16731,7382,9349,11521,5210,ITH,ITH3,5,Veneto
2021-05-01,UMB,5374,2640,2734,2146,3228,ITI,ITI2,10,Umbria
2021-05-04,CAM,48469,23342,25127,39572,8897,ITF,ITF3,15,Campania
2021-06-06,PAT,2227,1060,1167,445,1782,ITH,ITH2,4,Provincia Autonoma Trento
2021-03-18,PAB,1302,531,771,226,1076,ITH,ITH1,4,Provincia Autonoma Bolzano / Bozen
2021-03-20,TOS,6680,3070,3610,5544,1136,ITI,ITI1,9,Toscana
2021-05-11,CAL,15127,7315,7812,10350,4777,ITF,ITF6,18,Calabria
2021-05-20,EMR,40210,18350,21860,18857,21353,ITH,ITH5,8,Emilia-Romagna
2021-05-30,PIE,27700,13185,14515,18376,9324,ITC,ITC1,1,Piemonte
2021-01-24,CAM,4122,2119,2003,377,3745,ITF,ITF3,15,Campania
2021-03-05,UMB,4656,1427,3229,4000,656,ITI,ITI2,10,Umbria
2021-05-09,MAR,8769,3985,4784,3638,5131,ITI,ITI3,11,Marche
2021-01-22,TOS,2866,1064,1802,528,2338,ITI,ITI1,9,Toscana
2021-02-19,PIE,5535,2175,3360,5034,501,ITC,ITC1,1,Piemonte
2021-04-26,VDA,715,327,388,545,170,ITC,ITC2,2,Valle d'Aosta / Vallée d'Aoste
2021-05-14,PAB,5132,2318,2814,3096,2036,ITH,ITH1,4,Provincia Autonoma Bolzano / Bozen
2021-05-21,PUG,38566,18320,20246,28626,9940,ITF,ITF4,16,Puglia
2021-03-04,MOL,850,417,433,526,324,ITF,ITF2,14,Molise
2021-03-16,PAB,1290,532,758,124,1166,ITH,ITH1,4,Provincia Autonoma Bolzano / Bozen
2021-05-13,CAM,55425,24821,30604,39430,15995,ITF,ITF3,15,Campania
2021-01-19,SIC,1291,538,753,1077,214,ITG,ITG1,19,Sicilia
2021-05-04,LIG,13612,6082,7530,5385,8227,ITC,ITC3,7,Liguria
2021-01-10,SAR,2183,750,1433,2183,0,ITG,ITG2,20,Sardegna
2021-02-17,PAT,1112,425,687,1021,91,ITH,ITH2,4,Provincia Autonoma Trento
2021-03-03,UMB,4438,1773,2665,3727,711,ITI,ITI2,10,Umbria
2021-06-11,SIC,30505,14390,16115,24861,5644,ITG,ITG1,19,Sicilia
2021-05-24,ABR,12283,5884,6399,8882,3401,ITF,ITF1,13,Abruzzo
2021-02-11,BAS,951,401,550,868,83,ITF,ITF5,17,Basilicata
2021-05-12,PAB,3790,2058,1732,3637,153,ITH,ITH1,4,Provincia Autonoma Bolzano / Bozen
2021-04-29,SIC,31580,14776,16804,22250,9330,ITG,ITG1,19,Sicilia
2021-06-04,PIE,35174,18265,16909,32289,2885,ITC,ITC1,1,Piemonte
2021-02-01,PAB,1452,440,1012,12,1440,ITH,ITH1,4,Provincia Autonoma Bolzano / Bozen
2021-01-17,LAZ,4894,2028,2866,4682,212,ITI,ITI4,12,Lazio
2021-02-24,PIE,11409,4629,6780,10904,505,ITC,ITC1,1,Piemonte
2021-03-03,SIC,14418,6430,7988,11356,3062,ITG,ITG1,19,Sicilia
2021-04-24,FVG,6674,2945,3729,5432,1242,ITH,ITH4,6,Friuli-Venezia Giulia
2021-05-19,PUG,26208,12673,13535,19800,6408,ITF,ITF4,16,Puglia
2021-01-31,CAM,8068,3711,4357,23,8045,ITF,ITF3,15,Campania
2021-01-19,LAZ,4768,1954,2814,4314,454,ITI,ITI4,12,Lazio
2021-03-23,PUG,12111,6576,5535,5640,6471,ITF,ITF4,16,Puglia
2021-05-09,LIG,2826,1245,1581,1116,1710,ITC,ITC3,7,Liguria
2021-06-06,FVG,9410,4593,4817,7881,1529,ITH,ITH4,6,Friuli-Venezia Giulia
2021-05-22,BAS,5488,2723,2765,1937,3551,ITF,ITF5,17,Basilicata
2021-02-26,FVG,3736,2093,1643,3588,148,ITH,ITH4,6,Friuli-Venezia Giulia
2021-03-26,BAS,1954,703,1251,1693,261,ITF,ITF5,17,Basilicata
2021-02-17,FVG,2353,999,1354,1873,480,ITH,ITH4,6,Friuli-Venezia Giulia
2021-02-18,ABR,2288,933,1355,2158,130,ITF,ITF1,13,Abruzzo
2021-03-17,EMR,13721,5693,8028,5875,7846,ITH,ITH5,8,Emilia-Romagna
2021-05-18,VEN,26844,12493,14351,13286,13558,ITH,ITH3,5,Veneto
2021-05-30,PAT,1770,872,898,930,840,ITH,ITH2,4,Provincia Autonoma Trento
2021-01-29,LIG,3079,1064,2015,67,3012,ITC,ITC3,7,Liguria
2021-03-27,TOS,8860,4150,4710,8645,215,ITI,ITI1,9,Toscana
2021-05-13,EMR,35688,16439,19249,27921,7767,ITH,ITH5,8,Emilia-Romagna
2021-05-29,ABR,10317,4430,5887,4544,5773,ITF,ITF1,13,Abruzzo
2021-03-06,MAR,5699,2622,3077,4432,1267,ITI,ITI3,11,Marche
2021-04-03,PAT,1138,471,667,971,167,ITH,ITH2,4,Provincia Autonoma Trento
2021-06-06,UMB,7610,3903,3707,6917,693,ITI,ITI2,10,Umbria
2021-01-09,VDA,443,199,244,443,0,ITC,ITC2,2,Valle d'Aosta / Vallée d'Aoste
2021-04-29,LAZ,38627,17235,21392,25396,13231,ITI,ITI4,12,Lazio
2021-01-20,MOL,18,8,10,18,0,ITF,ITF2,14,Molise
2021-01-24,CAL,44,18,26,39,5,ITF,ITF6,18,Calabria
2021-03-25,PAB,2142,1059,1083,1699,443,ITH,ITH1,4,Provincia Autonoma Bolzano / Bozen
2021-04-14,CAL,8164,3928,4236,6718,1446,ITF,ITF6,18,Calabria
2021-05-22,LAZ,54802,26757,28045,44261,10541,ITI,ITI4,12,Lazio
2021-04-04,BAS,610,225,385,197,413,ITF,ITF5,17,Basilicata
2021-02-16,CAL,1739,734,1005,1461,278,ITF,ITF6,18,Calabria
2021-05-17,UMB,6364,3059,3305,4187,2177,ITI,ITI2,10,Umbria
2021-04-01,PUG,13841,6467,7374,7496,6345,ITF,ITF4,16,Puglia
2021-01-14,UMB,752,201,551,752,0,ITI,ITI2,10,Umbria
2021-03-20,MAR,4134,1739,2395,1048,3086,ITI,ITI3,11,Marche
2021-04-17,PAT,2203,1120,1083,2146,57,ITH,ITH2,4,Provincia Autonoma Trento
2020-12-31,PIE,3909,1334,2575,3909,0,ITC,ITC1,1,Piemonte
2021-01-26,SAR,1336,453,883,27,1309,ITG,ITG2,20,Sardegna
2021-01-27,PAB,84,28,56,1,83,ITH,ITH1,4,Provincia Autonoma Bolzano / Bozen
2021-02-03,PUG,5036,2005,3031,730,4306,ITF,ITF4,16,Puglia
2021-03-31,EMR,25331,11104,14227,19874,5457,ITH,ITH5,8,Emilia-Romagna
2021-01-22,MAR,487,167,320,194,293,ITI,ITI3,11,Marche
2021-02-01,VDA,404,127,277,87,317,ITC,ITC2,2,Valle d'Aosta / Vallée d'Aoste
2021-03-19,UMB,1743,565,1178,1087,656,ITI,ITI2,10,Umbria
2021-04-19,PAT,2625,1235,1390,2603,22,ITH,ITH2,4,Provincia Autonoma Trento
2021-03-30,VDA,402,223,179,382,20,ITC,ITC2,2,Valle d'Aosta / Vallée d'Aoste
2021-03-24,CAM,17820,8271,9549,14863,2957,ITF,ITF3,15,Campania
2021-05-20,LIG,12864,5982,6882,8842,4022,ITC,ITC3,7,Liguria
2021-05-27,CAL,17652,8757,8895,9808,7844,ITF,ITF6,18,Calabria
2021-05-15,LAZ,57084,27261,29823,40630,16454,ITI,ITI4,12,Lazio
2021-05-20,CAM,60954,28308,32646,43236,17718,ITF,ITF3,15,Campania
2021-05-12,VDA,1139,549,590,469,670,ITC,ITC2,2,Valle d'Aosta / Vallée d'Aoste
2021-02-09,CAM,4643,2202,2441,4391,252,ITF,ITF3,15,Campania
2021-03-06,ABR,4177,1358,2819,3607,570,ITF,ITF1,13,Abruzzo
2021-03-19,LAZ,17300,7447,9853,10972,6328,ITI,ITI4,12,Lazio
2021-03-20,MOL,2321,968,1353,1000,1321,ITF,ITF2,14,Molise
2021-03-24,LOM,43219,15600,27619,31342,11877,ITC,ITC4,3,Lombardia
2021-05-18,TOS,28837,14263,14574,20011,8826,ITI,ITI1,9,Toscana
2021-05-29,CAM,67757,32233,35524,43927,23830,ITF,ITF3,15,Campania
2021-02-09,LOM,12205,3331,8874,4033,8172,ITC,ITC4,3,Lombardia
2021-03-26,EMR,23931,10314,13617,17496,6435,ITH,ITH5,8,Emilia-Romagna
2021-05-08,SAR,13085,5968,7117,10796,2289,ITG,ITG2,20,Sardegna
2021-04-13,LIG,13076,5866,7210,11052,2024,ITC,ITC3,7,Liguria
2021-04-15,LOM,49398,21838,27560,35592,13806,ITC,ITC4,3,Lombardia
2021-01-17,SIC,1302,589,713,1245,57,ITG,ITG1,19,Sicilia
2021-04-16,ABR,7537,3488,4049,5620,1917,ITF,ITF1,13,Abruzzo
2021-01-05,LOM,7821,2567,5254,7821,0,ITC,ITC4,3,Lombardia
2021-03-22,LAZ,25165,12225,12940,18482,6683,ITI,ITI4,12,Lazio
2021-03-27,CAM,21605,10323,11282,17740,3865,ITF,ITF3,15,Campania
2021-01-23,BAS,719,303,416,33,686,ITF,ITF5,17,Basilicata
2021-05-13,CAL,15883,7621,8262,11213,4670,ITF,ITF6,18,Calabria
2021-05-03,BAS,4514,2044,2470,3687,827,ITF,ITF5,17,Basilicata
2021-04-24,EMR,28608,13228,15380,14382,14226,ITH,ITH5,8,Emilia-Romagna
2020-12-29,LAZ,488,176,312,488,0,ITI,ITI4,12,Lazio
2021-01-08,MAR,1578,590,988,1578,0,ITI,ITI3,11,Marche
2021-01-11,PAB,1570,513,1057,1570,0,ITH,ITH1,4,Provincia Autonoma Bolzano / Bozen
2021-02-19,CAL,1508,681,827,1247,261,ITF,ITF6,18,Calabria
2021-05-15,VDA,1065,614,451,380,685,ITC,ITC2,2,Valle d'Aosta / Vallée d'Aoste
2021-06-06,SAR,10027,4996,5031,6375,3652,ITG,ITG2,20,Sardegna
2021-01-29,PAT,1353,331,1022,55,1298,ITH,ITH2,4,Provincia Autonoma Trento
2021-02-09,BAS,491,213,278,316,175,ITF,ITF5,17,Basilicata
2021-02-04,VDA,294,86,208,8,286,ITC,ITC2,2,Valle d'Aosta / Vallée d'Aoste
2021-03-27,LOM,32419,12367,20052,23715,8704,ITC,ITC4,3,Lombardia
2021-04-18,MAR,8820,4131,4689,7899,921,ITI,ITI3,11,Marche
2021-05-11,EMR,35754,16785,18969,28490,7264,ITH,ITH5,8,Emilia-Romagna
2021-05-30,CAL,10937,5250,5687,6784,4153,ITF,ITF6,18,Calabria
2021-04-28,VDA,1218,632,586,715,503,ITC,ITC2,2,Valle d'Aosta / Vallée d'Aoste
2021-06-01,CAM,41907,20791,21116,31484,10423,ITF,ITF3,15,Campania
2021-01-31,EMR,7697,2763,4934,241,7456,ITH,ITH5,8,Emilia-Romagna
2021-02-10,TOS,4263,1281,2982,3740,523,ITI,ITI1,9,Toscana
2021-04-03,FVG,3985,1970,2015,2656,1329,ITH,ITH4,6,Friuli-Venezia Giulia
2021-01-03,LOM,854,316,538,854,0,ITC,ITC4,3,Lombardia
2021-04-06,PAB,2250,1118,1132,2147,103,ITH,ITH1,4,Provincia Autonoma Bolzano / Bozen
2021-03-10,CAM,15746,7857,7889,8911,6835,ITF,ITF3,15,Campania
2021-04-22,PAT,3150,1470,1680,3104,46,ITH,ITH2,4,Provincia Autonoma Trento
2021-05-04,TOS,18302,8207,10095,12854,5448,ITI,ITI1,9,Toscana
2021-03-07,LAZ,14132,5464,8668,10539,3593,ITI,ITI4,12,Lazio
2021-06-10,FVG,8976,4787,4189,7974,1002,ITH,ITH4,6,Friuli-Venezia Giulia
2021-02-28,PIE,10816,4060,6756,10576,240,ITC,ITC1,1,Piemonte
2021-05-15,CAM,62579,29013,33566,43898,18681,ITF,ITF3,15,Campania
2021-03-17,PIE,12518,5055,7463,5224,7294,ITC,ITC1,1,Piemonte
2020-12-31,VEN,3220,1042,2178,3220,0,ITH,ITH3,5,Veneto
2021-03-11,ABR,5515,2237,3278,4377,1138,ITF,ITF1,13,Abruzzo
2021-03-24,LAZ,27314,12599,14715,21076,6238,ITI,ITI4,12,Lazio
2021-03-25,MOL,1806,730,1076,1309,497,ITF,ITF2,14,Molise
2021-03-19,FVG,3261,1356,1905,1328,1933,ITH,ITH4,6,Friuli-Venezia Giulia
2021-03-08,MOL,1379,522,857,1239,140,ITF,ITF2,14,Molise
2021-03-05,SIC,15744,6846,8898,11509,4235,ITG,ITG1,19,Sicilia
2021-06-02,ABR,9684,4693,4991,6873,2811,ITF,ITF1,13,Abruzzo
2021-04-07,PAT,2605,1014,1591,1663,942,ITH,ITH2,4,Provincia Autonoma Trento
2021-03-21,EMR,11955,5296,6659,7351,4604,ITH,ITH5,8,Emilia-Romagna
2021-05-13,LIG,13265,6069,7196,9052,4213,ITC,ITC3,7,Liguria
2021-02-16,SIC,4196,2208,1988,3731,465,ITG,ITG1,19,Sicilia
2021-05-29,LAZ,51436,22995,28441,40922,10514,ITI,ITI4,12,Lazio
2021-04-12,VEN,14902,6334,8568,6685,8217,ITH,ITH3,5,Veneto
2021-02-19,LIG,3213,1305,1908,3037,176,ITC,ITC3,7,Liguria
2021-01-02,VEN,5743,1766,3977,5743,0,ITH,ITH3,5,Veneto
2021-04-13,MOL,1630,718,912,1043,587,ITF,ITF2,14,Molise
2021-05-30,LIG,3275,1603,1672,1364,1911,ITC,ITC3,7,Liguria
2021-03-13,ABR,4125,1420,2705,3082,1043,ITF,ITF1,13,Abruzzo
2021-03-28,BAS,2140,742,1398,2123,17,ITF,ITF5,17,Basilicata
2021-05-17,CAL,14890,7450,7440,10178,4712,ITF,ITF6,18,Calabria
2021-06-10,PIE,39213,20524,18689,36804,2409,ITC,ITC1,1,Piemonte
2021-03-26,UMB,4637,1749,2888,4465,172,ITI,ITI2,10,Umbria
2021-03-27,MOL,2743,1273,1470,1310,1433,ITF,ITF2,14,Molise
2021-02-12,TOS,7606,2683,4923,7393,213,ITI,ITI1,9,Toscana
2021-04-08,PAB,2764,1346,1418,2561,203,ITH,ITH1,4,Provincia Autonoma Bolzano / Bozen
2021-06-10,EMR,43062,22103,20959,37991,5071,ITH,ITH5,8,Emilia-Romagna
2021-03-11,BAS,1794,928,866,835,959,ITF,ITF5,17,Basilicata
2021-01-02,UMB,304,111,193,304,0,ITI,ITI2,10,Umbria
2021-03-02,EMR,12669,4272,8397,10580,2089,ITH,ITH5,8,Emilia-Romagna
2021-01-03,PUG,2007,943,1064,2007,0,ITF,ITF4,16,Puglia
2021-04-14,SAR,8250,3902,4348,7013,1237,ITG,ITG2,20,Sardegna
2021-01-10,MAR,1739,700,1039,1739,0,ITI,ITI3,11,Marche
2021-02-21,CAL,613,288,325,536,77,ITF,ITF6,18,Calabria
2021-03-19,EMR,15924,6972,8952,7955,7969,ITH,ITH5,8,Emilia-Romagna
2021-03-19,PIE,11021,4512,6509,4415,6606,ITC,ITC1,1,Piemonte
2021-03-27,PUG,12150,5706,6444,6982,5168,ITF,ITF4,16,Puglia
2021-04-05,PIE,14746,6233,8513,12189,2557,ITC,ITC1,1,Piemonte
2021-05-01,SAR,9908,4762,5146,5451,4457,ITG,ITG2,20,Sardegna
2021-01-19,VEN,1309,472,837,1159,150,ITH,ITH3,5,Veneto
2021-01-21,SAR,126,60,66,94,32,ITG,ITG2,20,Sardegna
2021-02-06,VDA,289,104,185,92,197,ITC,ITC2,2,Valle d'Aosta / Vallée d'Aoste
2021-03-12,CAM,15218,8033,7185,9135,6083,ITF,ITF3,15,Campania
2021-06-01,LIG,16148,8108,8040,10785,5363,ITC,ITC3,7,Liguria
2021-06-03,LOM,96793,49559,47234,86164,10629,ITC,ITC4,3,Lombardia
2021-02-07,SAR,1117,395,722,228,889,ITG,ITG2,20,Sardegna
2021-04-28,CAL,12521,6059,6462,9664,2857,ITF,ITF6,18,Calabria
2021-03-07,UMB,845,180,665,838,7,ITI,ITI2,10,Umbria
2021-01-05,PUG,5106,2251,2855,5106,0,ITF,ITF4,16,Puglia
2020-12-27,PAB,144,65,79,144,0,ITH,ITH1,4,Provincia Autonoma Bolzano / Bozen
2021-02-04,CAL,3556,1695,1861,653,2903,ITF,ITF6,18,Calabria
2021-04-30,VDA,831,355,476,485,346,ITC,ITC2,2,Valle d'Aosta / Vallée d'Aoste
2021-05-10,LAZ,44378,20273,24105,31001,13377,ITI,ITI4,12,Lazio
2021-04-15,PUG,32409,15122,17287,28908,3501,ITF,ITF4,16,Puglia
2021-01-20,VDA,23,8,15,23,0,ITC,ITC2,2,Valle d'Aosta / Vallée d'Aoste
2021-03-12,LOM,35278,12980,22298,25079,10199,ITC,ITC4,3,Lombardia
2021-04-03,MAR,7573,3204,4369,6903,670,ITI,ITI3,11,Marche
2021-04-07,FVG,8050,3837,4213,7269,781,ITH,ITH4,6,Friuli-Venezia Giulia
2021-01-11,MOL,557,194,363,557,0,ITF,ITF2,14,Molise
2021-02-25,PAB,1498,549,949,1497,1,ITH,ITH1,4,Provincia Autonoma Bolzano / Bozen
2021-05-11,LOM,86790,41398,45392,60639,26151,ITC,ITC4,3,Lombardia
2021-03-10,PIE,13635,5170,8465,11341,2294,ITC,ITC1,1,Piemonte
2021-05-25,CAM,46365,22297,24068,23073,23292,ITF,ITF3,15,Campania
2021-06-02,PAB,1444,809,635,987,457,ITH,ITH1,4,Provincia Autonoma Bolzano / Bozen
2021-03-27,PIE,18387,7829,10558,9556,8831,ITC,ITC1,1,Piemonte
2021-04-05,CAL,3414,1605,1809,2558,856,ITF,ITF6,18,Calabria
2021-04-22,SAR,10503,4659,5844,5584,4919,ITG,ITG2,20,Sardegna
2021-01-10,VEN,5032,1671,3361,5032,0,ITH,ITH3,5,Veneto
2021-03-21,ABR,2135,914,1221,844,1291,ITF,ITF1,13,Abruzzo
2021-01-05,LAZ,7374,2802,4572,7374,0,ITI,ITI4,12,Lazio
2021-01-12,SAR,865,408,457,865,0,ITG,ITG2,20,Sardegna
2021-02-05,EMR,9321,2967,6354,1638,7683,ITH,ITH5,8,Emilia-Romagna
2021-05-28,LOM,93420,44809,48611,42951,50469,ITC,ITC4,3,Lombardia
2021-04-15,FVG,6488,2860,3628,5217,1271,ITH,ITH4,6,Friuli-Venezia Giulia
2021-02-17,LOM,11985,3755,8230,10596,1389,ITC,ITC4,3,Lombardia
2021-03-15,SIC,10694,4765,5929,5802,4892,ITG,ITG1,19,Sicilia
2021-06-11,LOM,70174,35400,34774,59200,10974,ITC,ITC4,3,Lombardia
2021-03-08,TOS,7031,3250,3781,2211,4820,ITI,ITI1,9,Toscana
2021-04-29,FVG,6697,2939,3758,4164,2533,ITH,ITH4,6,Friuli-Venezia Giulia
2021-02-20,MAR,4121,1705,2416,4010,111,ITI,ITI3,11,Marche
2021-01-24,LAZ,5694,2229,3465,612,5082,ITI,ITI4,12,Lazio
2021-01-27,PUG,4582,1932,2650,612,3970,ITF,ITF4,16,Puglia
2021-01-05,FVG,1678,551,1127,1678,0,ITH,ITH4,6,Friuli-Venezia Giulia
2021-02-07,LAZ,4944,2025,2919,387,4557,ITI,ITI4,12,Lazio
2021-03-27,PAT,1619,710,909,1363,256,ITH,ITH2,4,Provincia Autonoma Trento
2021-05-07,PUG,49717,22199,27518,26368,23349,ITF,ITF4,16,Puglia
2021-05-30,TOS,28652,13942,14710,21714,6938,ITI,ITI1,9,Toscana
2021-03-18,LIG,4980,2123,2857,2007,2973,ITC,ITC3,7,Liguria
2021-05-18,LAZ,44462,20336,24126,34996,9466,ITI,ITI4,12,Lazio
2021-03-21,BAS,1048,482,566,354,694,ITF,ITF5,17,Basilicata
2021-04-01,LIG,12414,5506,6908,9644,2770,ITC,ITC3,7,Liguria
2021-01-13,PUG,4542,1730,2812,4542,0,ITF,ITF4,16,Puglia
2021-02-08,PAB,2,1,1,1,1,ITH,ITH1,4,Provincia Autonoma Bolzano / Bozen
2021-04-22,CAM,33942,16532,17410,21539,12403,ITF,ITF3,15,Campania
2021-05-23,VEN,34475,16459,18016,11066,23409,ITH,ITH3,5,Veneto
2021-06-04,PAT,5793,2594,3199,1831,3962,ITH,ITH2,4,Provincia Autonoma Trento
2021-06-08,CAL,15878,7496,8382,13904,1974,ITF,ITF6,18,Calabria
2021-01-20,MAR,403,100,303,384,19,ITI,ITI3,11,Marche
2021-05-29,BAS,3059,1534,1525,834,2225,ITF,ITF5,17,Basilicata
2021-01-12,CAM,5215,2564,2651,5215,0,ITF,ITF3,15,Campania
2021-02-12,VEN,4314,1447,2867,3742,572,ITH,ITH3,5,Veneto
2021-03-19,VDA,322,85,237,287,35,ITC,ITC2,2,Valle d'Aosta / Vallée d'Aoste
2021-02-03,MAR,2124,741,1383,119,2005,ITI,ITI3,11,Marche
2021-03-17,CAL,3990,1774,2216,2138,1852,ITF,ITF6,18,Calabria
2021-04-06,PUG,13791,6215,7576,7041,6750,ITF,ITF4,16,Puglia
2021-05-11,SAR,8675,4014,4661,6317,2358,ITG,ITG2,20,Sardegna
2021-01-25,MOL,319,130,189,3,316,ITF,ITF2,14,Molise
2021-01-29,VEN,9020,2788,6232,367,8653,ITH,ITH3,5,Veneto
2021-01-31,SAR,2121,750,1371,48,2073,ITG,ITG2,20,Sardegna
2021-05-14,MAR,13493,6218,7275,6720,6773,ITI,ITI3,11,Marche
2021-02-05,FVG,2609,784,1825,89,2520,ITH,ITH4,6,Friuli-Venezia Giulia
2021-02-24,PAT,1324,525,799,926,398,ITH,ITH2,4,Provincia Autonoma Trento
2021-05-05,MOL,2413,1042,1371,2272,141,ITF,ITF2,14,Molise
2021-05-06,CAM,57262,27898,29364,42820,14442,ITF,ITF3,15,Campania
2021-05-19,PAB,3623,1846,1777,1839,1784,ITH,ITH1,4,Provincia Autonoma Bolzano / Bozen
2021-01-03,PAB,41,16,25,41,0,ITH,ITH1,4,Provincia Autonoma Bolzano / Bozen
2021-04-14,FVG,7215,3118,4097,5503,1712,ITH,ITH4,6,Friuli-Venezia Giulia
2021-01-13,ABR,1255,441,814,1255,0,ITF,ITF1,13,Abruzzo
2021-06-03,PAT,4746,2226,2520,1303,3443,ITH,ITH2,4,Provincia Autonoma Trento
2021-01-19,PIE,6466,2105,4361,6454,12,ITC,ITC1,1,Piemonte
2021-02-14,SAR,539,263,276,537,2,ITG,ITG2,20,Sardegna
2021-06-08,LIG,17783,8885,8898,11195,6588,ITC,ITC3,7,Liguria
2021-04-13,PAB,2391,1130,1261,2384,7,ITH,ITH1,4,Provincia Autonoma Bolzano / Bozen
2021-05-03,LAZ,39156,17672,21484,26577,12579,ITI,ITI4,12,Lazio
2021-05-07,VDA,564,245,319,533,31,ITC,ITC2,2,Valle d'Aosta / Vallée d'Aoste
2021-03-17,LIG,5552,2368,3184,2473,3079,ITC,ITC3,7,Liguria
2021-04-23,VDA,921,443,478,538,383,ITC,ITC2,2,Valle d'Aosta / Vallée d'Aoste
2021-05-04,MOL,2705,1181,1524,2577,128,ITF,ITF2,14,Molise
2021-05-08,VEN,41341,18695,22646,29535,11806,ITH,ITH3,5,Veneto
2021-01-13,VDA,337,110,227,337,0,ITC,ITC2,2,Valle d'Aosta / Vallée d'Aoste
2021-01-10,MOL,270,72,198,270,0,ITF,ITF2,14,Molise
2021-04-05,LOM,27377,11694,15683,19274,8103,ITC,ITC4,3,Lombardia
2021-04-06,VDA,741,381,360,629,112,ITC,ITC2,2,Valle d'Aosta / Vallée d'Aoste
2021-04-20,MOL,2318,1025,1293,1220,1098,ITF,ITF2,14,Molise
2021-06-09,MOL,949,532,417,473,476,ITF,ITF2,14,Molise
2021-01-13,BAS,916,387,529,916,0,ITF,ITF5,17,Basilicata
2020-12-31,TOS,803,202,601,803,0,ITI,ITI1,9,Toscana
2021-04-14,PIE,27710,12562,15148,23185,4525,ITC,ITC1,1,Piemonte
2021-04-23,BAS,4536,2185,2351,3536,1000,ITF,ITF5,17,Basilicata
2021-05-23,MOL,1699,863,836,1694,5,ITF,ITF2,14,Molise
2021-04-10,TOS,11720,5348,6372,10976,744,ITI,ITI1,9,Toscana
2021-04-14,EMR,27033,12835,14198,20928,6105,ITH,ITH5,8,Emilia-Romagna
2021-01-19,PAT,406,77,329,406,0,ITH,ITH2,4,Provincia Autonoma Trento
2021-01-30,BAS,704,227,477,128,576,ITF,ITF5,17,Basilicata
2021-03-01,PUG,15098,5864,9234,13728,1370,ITF,ITF4,16,Puglia
2021-02-13,ABR,852,384,468,438,414,ITF,ITF1,13,Abruzzo
2021-04-19,CAL,7844,3783,4061,6178,1666,ITF,ITF6,18,Calabria
2021-01-21,EMR,2165,729,1436,819,1346,ITH,ITH5,8,Emilia-Romagna
2021-02-11,UMB,842,349,493,837,5,ITI,ITI2,10,Umbria
2021-05-22,SIC,47977,22782,25195,28644,19333,ITG,ITG1,19,Sicilia
2021-05-22,UMB,6993,2784,4209,2640,4353,ITI,ITI2,10,Umbria
2021-02-28,SIC,7165,3063,4102,6535,630,ITG,ITG1,19,Sicilia
2021-02-28,CAM,10411,3206,7205,8511,1900,ITF,ITF3,15,Campania
2021-01-09,CAL,1927,1041,886,1927,0,ITF,ITF6,18,Calabria
2021-06-08,SIC,47445,22285,25160,40938,6507,ITG,ITG1,19,Sicilia
2021-03-03,FVG,3638,1627,2011,2365,1273,ITH,ITH4,6,Friuli-Venezia Giulia
2021-03-11,PUG,15026,6810,8216,11916,3110,ITF,ITF4,16,Puglia
2021-04-03,TOS,15013,6646,8367,13887,1126,ITI,ITI1,9,Toscana
2021-04-27,LIG,14746,6676,8070,7166,7580,ITC,ITC3,7,Liguria
2021-02-23,ABR,2782,1275,1507,2771,11,ITF,ITF1,13,Abruzzo
2021-03-18,MAR,3389,1475,1914,162,3227,ITI,ITI3,11,Marche
2021-04-29,CAL,11945,5811,6134,8389,3556,ITF,ITF6,18,Calabria
2021-01-21,VDA,33,12,21,33,0,ITC,ITC2,2,Valle d'Aosta / Vallée d'Aoste
2021-02-03,LIG,2314,790,1524,55,2259,ITC,ITC3,7,Liguria
2021-06-02,PUG,26896,13159,13737,22092,4804,ITF,ITF4,16,Puglia
2021-02-06,ABR,1612,743,869,602,1010,ITF,ITF1,13,Abruzzo
2021-04-12,CAL,6900,3351,3549,5250,1650,ITF,ITF6,18,Calabria
2021-06-01,UMB,4375,2086,2289,4222,153,ITI,ITI2,10,Umbria
2021-01-04,VDA,142,59,83,142,0,ITC,ITC2,2,Valle d'Aosta / Vallée d'Aoste
2021-05-25,EMR,25008,11176,13832,11705,13303,ITH,ITH5,8,Emilia-Romagna
2021-05-25,PIE,31090,14431,16659,15974,15116,ITC,ITC1,1,Piemonte
2021-01-19,CAL,1114,491,623,1103,11,ITF,ITF6,18,Calabria
2021-03-10,UMB,4051,1963,2088,2795,1256,ITI,ITI2,10,Umbria
2021-06-11,PIE,32085,16777,15308,29778,2307,ITC,ITC1,1,Piemonte
2021-01-27,TOS,4835,1573,3262,206,4629,ITI,ITI1,9,Toscana
2021-02-14,EMR,1402,378,1024,1282,120,ITH,ITH5,8,Emilia-Romagna
2021-03-27,VEN,32093,14033,18060,26287,5806,ITH,ITH3,5,Veneto
2021-05-23,MAR,9208,4282,4926,7537,1671,ITI,ITI3,11,Marche
2021-01-21,CAM,2092,1115,977,676,1416,ITF,ITF3,15,Campania
2021-03-28,VDA,522,212,310,521,1,ITC,ITC2,2,Valle d'Aosta / Vallée d'Aoste
2021-01-16,UMB,221,73,148,221,0,ITI,ITI2,10,Umbria
2021-03-13,PUG,10465,4134,6331,8657,1808,ITF,ITF4,16,Puglia
2021-06-03,VEN,54140,27859,26281,42241,11899,ITH,ITH3,5,Veneto
2021-05-06,MAR,12659,5823,6836,5585,7074,ITI,ITI3,11,Marche
2021-02-15,PAB,72,42,30,26,46,ITH,ITH1,4,Provincia Autonoma Bolzano / Bozen
2021-03-11,VDA,197,76,121,66,131,ITC,ITC2,2,Valle d'Aosta / Vallée d'Aoste
2021-04-29,LIG,15551,6974,8577,6734,8817,ITC,ITC3,7,Liguria
2021-05-01,LOM,95958,43670,52288,66753,29205,ITC,ITC4,3,Lombardia
2021-05-27,FVG,12936,6345,6591,7571,5365,ITH,ITH4,6,Friuli-Venezia Giulia
2021-01-21,LOM,5317,1563,3754,4629,688,ITC,ITC4,3,Lombardia
2021-02-12,MAR,1582,618,964,1430,152,ITI,ITI3,11,Marche
2021-03-26,CAL,7934,3753,4181,4812,3122,ITF,ITF6,18,Calabria
2021-02-02,UMB,944,274,670,32,912,ITI,ITI2,10,Umbria
2021-02-24,PUG,10035,4703,5332,9445,590,ITF,ITF4,16,Puglia
2021-04-12,LIG,12381,5474,6907,10362,2019,ITC,ITC3,7,Liguria
2021-02-08,ABR,1197,396,801,487,710,ITF,ITF1,13,Abruzzo
2021-06-02,VDA,1215,688,527,814,401,ITC,ITC2,2,Valle d'Aosta / Vallée d'Aoste
2021-06-04,PUG,52222,25524,26698,34412,17810,ITF,ITF4,16,Puglia
2021-01-19,LIG,1371,438,933,1281,90,ITC,ITC3,7,Liguria
2021-03-17,TOS,11420,4586,6834,6892,4528,ITI,ITI1,9,Toscana
2021-05-11,PAB,2843,1334,1509,1320,1523,ITH,ITH1,4,Provincia Autonoma Bolzano / Bozen
2021-05-18,PUG,28672,13339,15333,15958,12714,ITF,ITF4,16,Puglia
2021-05-19,ABR,10693,5109,5584,7654,3039,ITF,ITF1,13,Abruzzo
2021-02-07,LOM,7308,2822,4486,338,6970,ITC,ITC4,3,Lombardia
2021-04-14,CAM,27639,13332,14307,19070,8569,ITF,ITF3,15,Campania
2021-02-05,LIG,2674,987,1687,304,2370,ITC,ITC3,7,Liguria
2021-05-01,CAM,46337,22661,23676,30234,16103,ITF,ITF3,15,Campania
2021-06-08,TOS,32429,16608,15821,32001,428,ITI,ITI1,9,Toscana
2021-02-26,TOS,10079,3833,6246,8873,1206,ITI,ITI1,9,Toscana
2021-05-27,EMR,42317,18870,23447,14049,28268,ITH,ITH5,8,Emilia-Romagna
2021-02-10,MAR,1439,452,987,1080,359,ITI,ITI3,11,Marche
2021-01-14,LAZ,5482,2144,3338,5482,0,ITI,ITI4,12,Lazio
2021-02-16,EMR,5772,2446,3326,5241,531,ITH,ITH5,8,Emilia-Romagna
2021-04-26,SIC,21689,10276,11413,13657,8032,ITG,ITG1,19,Sicilia
2021-06-06,TOS,28279,13641,14638,22924,5355,ITI,ITI1,9,Toscana
2021-03-31,SAR,10383,4272,6111,7936,2447,ITG,ITG2,20,Sardegna
2021-01-19,LOM,8051,2329,5722,7583,468,ITC,ITC4,3,Lombardia
2021-02-02,SIC,5272,2473,2799,629,4643,ITG,ITG1,19,Sicilia
2021-02-08,BAS,557,193,364,151,406,ITF,ITF5,17,Basilicata
2021-01-29,PAB,1497,510,987,24,1473,ITH,ITH1,4,Provincia Autonoma Bolzano / Bozen
2021-04-07,LAZ,26241,12322,13919,18935,7306,ITI,ITI4,12,Lazio
2021-04-12,CAM,23301,10918,12383,20265,3036,ITF,ITF3,15,Campania
2021-05-25,PAT,4748,2261,2487,1861,2887,ITH,ITH2,4,Provincia Autonoma Trento
2021-05-08,PAT,3157,1724,1433,2738,419,ITH,ITH2,4,Provincia Autonoma Trento
2021-05-19,BAS,2870,1498,1372,1194,1676,ITF,ITF5,17,Basilicata
2021-01-02,CAM,3672,1962,1710,3672,0,ITF,ITF3,15,Campania
2021-03-09,VDA,206,96,110,174,32,ITC,ITC2,2,Valle d'Aosta / Vallée d'Aoste
2021-04-22,PAB,2923,1500,1423,1981,942,ITH,ITH1,4,Provincia Autonoma Bolzano / Bozen
2021-04-26,UMB,5376,2329,3047,3124,2252,ITI,ITI2,10,Umbria
2021-02-25,BAS,1787,736,1051,1741,46,ITF,ITF5,17,Basilicata
2021-02-20,VDA,251,210,41,241,10,ITC,ITC2,2,Valle d'Aosta / Vallée d'Aoste
2020-12-28,LAZ,959,412,547,959,0,ITI,ITI4,12,Lazio
2021-02-14,PAT,246,186,60,11,235,ITH,ITH2,4,Provincia Autonoma Trento
2021-04-09,UMB,6793,3162,3631,6574,219,ITI,ITI2,10,Umbria
2021-05-09,PAB,4235,2405,1830,3082,1153,ITH,ITH1,4,Provincia Autonoma Bolzano / Bozen
2021-04-29,PUG,26044,12066,13978,19388,6656,ITF,ITF4,16,Puglia
2021-04-30,ABR,12399,5807,6592,6702,5697,ITF,ITF1,13,Abruzzo
2021-01-16,LAZ,5647,2282,3365,5647,0,ITI,ITI4,12,Lazio
2021-04-19,PIE,22538,10767,11771,18174,4364,ITC,ITC1,1,Piemonte
2021-01-14,SIC,5023,2381,2642,5023,0,ITG,ITG1,19,Sicilia
2021-04-13,ABR,5879,2752,3127,4679,1200,ITF,ITF1,13,Abruzzo
2021-04-26,LAZ,29217,13448,15769,20015,9202,ITI,ITI4,12,Lazio
2021-01-09,PIE,6184,2185,3999,6184,0,ITC,ITC1,1,Piemonte
2021-02-02,LAZ,5910,2213,3697,638,5272,ITI,ITI4,12,Lazio
2021-01-20,ABR,447,156,291,445,2,ITF,ITF1,13,Abruzzo
2021-02-19,VEN,7322,3140,4182,7118,204,ITH,ITH3,5,Veneto
2021-03-26,CAM,20109,9561,10548,16294,3815,ITF,ITF3,15,Campania
2021-02-03,MOL,731,249,482,338,393,ITF,ITF2,14,Molise
2021-01-28,FVG,2239,794,1445,354,1885,ITH,ITH4,6,Friuli-Venezia Giulia
2021-01-26,PIE,6332,1880,4452,735,5597,ITC,ITC1,1,Piemonte
2021-06-11,MAR,9252,4647,4605,7395,1857,ITI,ITI3,11,Marche
2021-02-06,BAS,902,367,535,146,756,ITF,ITF5,17,Basilicata
2021-04-07,BAS,1221,551,670,1183,38,ITF,ITF5,17,Basilicata
2021-01-29,LOM,13441,4117,9324,651,12790,ITC,ITC4,3,Lombardia
2021-04-17,LAZ,32320,14182,18138,20364,11956,ITI,ITI4,12,Lazio
2021-05-18,PAT,4247,2009,2238,3405,842,ITH,ITH2,4,Provincia Autonoma Trento
2021-03-29,EMR,21558,9747,11811,16907,4651,ITH,ITH5,8,Emilia-Romagna
2021-03-29,PIE,15161,6385,8776,8549,6612,ITC,ITC1,1,Piemonte
2021-01-11,ABR,1551,557,994,1551,0,ITF,ITF1,13,Abruzzo
2021-05-06,UMB,9461,4313,5148,6151,3310,ITI,ITI2,10,Umbria
2021-06-10,VDA,1002,558,444,960,42,ITC,ITC2,2,Valle d'Aosta / Vallée d'Aoste
2021-03-25,TOS,24144,10613,13531,15794,8350,ITI,ITI1,9,Toscana
2021-01-29,CAM,10052,4812,5240,47,10005,ITF,ITF3,15,Campania
2021-03-02,VDA,339,166,173,336,3,ITC,ITC2,2,Valle d'Aosta / Vallée d'Aoste
2021-04-21,ABR,6387,3100,3287,4713,1674,ITF,ITF1,13,Abruzzo
2021-01-28,CAL,2237,1110,1127,83,2154,ITF,ITF6,18,Calabria
2021-04-25,BAS,2986,1458,1528,2933,53,ITF,ITF5,17,Basilicata
2021-05-09,PUG,30577,12526,18051,14994,15583,ITF,ITF4,16,Puglia
2021-01-28,SAR,2971,1045,1926,69,2902,ITG,ITG2,20,Sardegna
2021-04-12,PIE,22944,10363,12581,19954,2990,ITC,ITC1,1,Piemonte
2021-04-12,TOS,2612,1183,1429,1958,654,ITI,ITI1,9,Toscana
2021-02-21,EMR,4450,1708,2742,4010,440,ITH,ITH5,8,Emilia-Romagna
2021-03-05,LOM,28899,11918,16981,20497,8402,ITC,ITC4,3,Lombardia
2021-03-27,MAR,7380,3074,4306,5022,2358,ITI,ITI3,11,Marche
2021-05-08,CAL,18286,8329,9957,10481,7805,ITF,ITF6,18,Calabria
2021-01-02,PIE,3545,1134,2411,3545,0,ITC,ITC1,1,Piemonte
2021-03-19,CAM,11241,5072,6169,7369,3872,ITF,ITF3,15,Campania
2021-02-10,MOL,151,79,72,131,20,ITF,ITF2,14,Molise
2021-03-12,PAT,2509,937,1572,1703,806,ITH,ITH2,4,Provincia Autonoma Trento
2021-04-10,MAR,10917,4621,6296,10604,313,ITI,ITI3,11,Marche
2021-05-22,CAL,22139,10543,11596,14316,7823,ITF,ITF6,18,Calabria
2021-01-03,MAR,907,354,553,907,0,ITI,ITI3,11,Marche
2021-04-22,PUG,22926,10477,12449,18056,4870,ITF,ITF4,16,Puglia
2021-05-12,BAS,4723,2325,2398,2840,1883,ITF,ITF5,17,Basilicata
2021-05-21,MOL,2095,1050,1045,1773,322,ITF,ITF2,14,Molise
2021-03-19,LOM,32404,12908,19496,19216,13188,ITC,ITC4,3,Lombardia
2021-05-13,TOS,34993,15429,19564,13830,21163,ITI,ITI1,9,Toscana
2021-01-27,MOL,674,251,423,8,666,ITF,ITF2,14,Molise
2021-03-31,SIC,14412,6689,7723,9484,4928,ITG,ITG1,19,Sicilia
2021-05-15,FVG,12608,6079,6529,7924,4684,ITH,ITH4,6,Friuli-Venezia Giulia
2021-04-03,LIG,5404,2497,2907,4461,943,ITC,ITC3,7,Liguria
2021-04-21,CAL,11569,5809,5760,8630,2939,ITF,ITF6,18,Calabria
2021-05-01,FVG,7188,3244,3944,6145,1043,ITH,ITH4,6,Friuli-Venezia Giulia
2021-06-10,UMB,7415,3713,3702,6656,759,ITI,ITI2,10,Umbria
2021-01-07,SIC,8892,4117,4775,8892,0,ITG,ITG1,19,Sicilia
2021-04-06,ABR,7681,3581,4100,5362,2319,ITF,ITF1,13,Abruzzo
2021-04-29,TOS,39337,17713,21624,19245,20092,ITI,ITI1,9,Toscana
2021-06-10,CAM,73762,35865,37897,66382,7380,ITF,ITF3,15,Campania
2021-01-21,FVG,896,345,551,1,895,ITH,ITH4,6,Friuli-Venezia Giulia
2021-03-12,LAZ,25089,12036,13053,18772,6317,ITI,ITI4,12,Lazio
2021-06-04,PAB,6479,3259,3220,4928,1551,ITH,ITH1,4,Provincia Autonoma Bolzano / Bozen
2021-02-24,PAB,1367,406,961,1355,12,ITH,ITH1,4,Provincia Autonoma Bolzano / Bozen
2021-06-08,VEN,42960,22239,20721,37022,5938,ITH,ITH3,5,Veneto
2021-01-02,PAT,502,143,359,502,0,ITH,ITH2,4,Provincia Autonoma Trento
2021-05-25,VEN,27652,13352,14300,11680,15972,ITH,ITH3,5,Veneto
2021-05-27,SAR,18504,9957,8547,12420,6084,ITG,ITG2,20,Sardegna
2021-02-14,VEN,125,56,69,112,13,ITH,ITH3,5,Veneto
2021-02-21,FVG,801,281,520,423,378,ITH,ITH4,6,Friuli-Venezia Giulia
2021-02-16,SAR,700,289,411,673,27,ITG,ITG2,20,Sardegna
2021-03-24,TOS,20009,8300,11709,10552,9457,ITI,ITI1,9,Toscana
2021-05-01,PIE,28532,12996,15536,16734,11798,ITC,ITC1,1,Piemonte
2021-02-12,PUG,4212,1672,2540,3120,1092,ITF,ITF4,16,Puglia
2021-03-08,MAR,6264,2743,3521,5262,1002,ITI,ITI3,11,Marche
2021-01-11,VDA,325,112,213,325,0,ITC,ITC2,2,Valle d'Aosta / Vallée d'Aoste
2021-01-21,PIE,6923,2318,4605,3427,3496,ITC,ITC1,1,Piemonte
2021-01-24,LIG,756,237,519,113,643,ITC,ITC3,7,Liguria
2021-03-05,SAR,5378,2759,2619,3024,2354,ITG,ITG2,20,Sardegna
2021-02-09,LAZ,8798,3768,5030,4580,4218,ITI,ITI4,12,Lazio
2021-03-27,PAB,3050,1553,1497,1543,1507,ITH,ITH1,4,Provincia Autonoma Bolzano / Bozen
2021-03-29,PAT,2467,960,1507,1732,735,ITH,ITH2,4,Provincia Autonoma Trento
2021-04-02,CAL,8253,3761,4492,4383,3870,ITF,ITF6,18,Calabria
2021-02-28,VEN,4136,1389,2747,3299,837,ITH,ITH3,5,Veneto
2021-02-23,LAZ,11087,4780,6307,10325,762,ITI,ITI4,12,Lazio
2021-03-13,PAB,2885,1459,1426,2784,101,ITH,ITH1,4,Provincia Autonoma Bolzano / Bozen
2021-04-12,PAT,3093,1409,1684,2597,496,ITH,ITH2,4,Provincia Autonoma Trento
2021-05-15,PIE,33690,15712,17978,20037,13653,ITC,ITC1,1,Piemonte
2021-01-29,PUG,6199,2662,3537,437,5762,ITF,ITF4,16,Puglia
2021-04-06,BAS,1267,461,806,1082,185,ITF,ITF5,17,Basilicata
2021-06-01,PIE,29141,14617,14524,24778,4363,ITC,ITC1,1,Piemonte
2021-03-17,VEN,14643,5991,8652,7849,6794,ITH,ITH3,5,Veneto
2021-05-27,LOM,94788,45496,49292,41372,53416,ITC,ITC4,3,Lombardia
2021-01-08,MOL,429,141,288,429,0,ITF,ITF2,14,Molise
2021-02-21,PIE,5090,2083,3007,4988,102,ITC,ITC1,1,Piemonte
2021-02-21,TOS,5105,2089,3016,4935,170,ITI,ITI1,9,Toscana
2021-03-19,SAR,7271,3051,4220,5056,2215,ITG,ITG2,20,Sardegna
2021-02-05,MAR,2154,653,1501,439,1715,ITI,ITI3,11,Marche
2021-03-19,CAL,4187,1948,2239,1900,2287,ITF,ITF6,18,Calabria
2021-03-20,PUG,8557,4013,4544,3963,4594,ITF,ITF4,16,Puglia
2021-03-03,PUG,16741,6773,9968,14828,1913,ITF,ITF4,16,Puglia
2021-04-04,VDA,572,253,319,571,1,ITC,ITC2,2,Valle d'Aosta / Vallée d'Aoste
2021-05-08,CAM,56412,27129,29283,40585,15827,ITF,ITF3,15,Campania
2021-06-01,TOS,26853,13342,13511,23055,3798,ITI,ITI1,9,Toscana
2021-01-02,EMR,2374,915,1459,2374,0,ITH,ITH5,8,Emilia-Romagna
2021-04-24,LOM,75718,33561,42157,54618,21100,ITC,ITC4,3,Lombardia
2021-05-16,MAR,10898,4957,5941,6670,4228,ITI,ITI3,11,Marche
2021-01-28,CAM,8832,4121,4711,134,8698,ITF,ITF3,15,Campania
2021-02-05,PAB,3195,1181,2014,8,3187,ITH,ITH1,4,Provincia Autonoma Bolzano / Bozen
2021-03-23,BAS,1588,611,977,1416,172,ITF,ITF5,17,Basilicata
2021-06-11,PUG,23429,11742,11687,17271,6158,ITF,ITF4,16,Puglia
2021-01-14,LOM,26798,7779,19019,26798,0,ITC,ITC4,3,Lombardia
2021-01-21,PAT,352,95,257,228,124,ITH,ITH2,4,Provincia Autonoma Trento
2021-04-01,MOL,1469,667,802,743,726,ITF,ITF2,14,Molise
2021-05-30,MAR,9737,4690,5047,6748,2989,ITI,ITI3,11,Marche
2021-06-05,EMR,43845,22200,21645,37067,6778,ITH,ITH5,8,Emilia-Romagna
2021-05-01,PAT,4841,2465,2376,4806,35,ITH,ITH2,4,Provincia Autonoma Trento
2021-05-08,LOM,87548,40665,46883,65661,21887,ITC,ITC4,3,Lombardia
2021-02-09,SIC,4351,1802,2549,3316,1035,ITG,ITG1,19,Sicilia
2021-03-26,FVG,6164,2756,3408,4150,2014,ITH,ITH4,6,Friuli-Venezia Giulia
2021-05-09,ABR,9151,4087,5064,4283,4868,ITF,ITF1,13,Abruzzo
2021-02-12,LIG,1927,689,1238,895,1032,ITC,ITC3,7,Liguria
2021-03-12,FVG,4410,1983,2427,3029,1381,ITH,ITH4,6,Friuli-Venezia Giulia
2021-04-21,UMB,5312,2309,3003,3086,2226,ITI,ITI2,10,Umbria
2021-02-15,ABR,1794,831,963,1752,42,ITF,ITF1,13,Abruzzo
2021-03-10,TOS,18712,7725,10987,14694,4018,ITI,ITI1,9,Toscana
2021-06-10,CAL,15336,7053,8283,12537,2799,ITF,ITF6,18,Calabria
2021-04-21,CAM,30226,14723,15503,18000,12226,ITF,ITF3,15,Campania
2021-05-26,ABR,13400,5948,7452,8396,5004,ITF,ITF1,13,Abruzzo
2021-05-17,EMR,32367,15385,16982,22889,9478,ITH,ITH5,8,Emilia-Romagna
2021-01-02,FVG,1216,470,746,1216,0,ITH,ITH4,6,Friuli-Venezia Giulia
2021-01-21,LAZ,5602,2349,3253,549,5053,ITI,ITI4,12,Lazio
2021-04-15,PAB,4399,2307,2092,4136,263,ITH,ITH1,4,Provincia Autonoma Bolzano / Bozen
2021-01-12,VEN,5230,1516,3714,5230,0,ITH,ITH3,5,Veneto
2021-02-21,PAT,155,92,63,43,112,ITH,ITH2,4,Provincia Autonoma Trento
2021-03-02,UMB,3642,1346,2296,3638,4,ITI,ITI2,10,Umbria
2021-04-19,VEN,21532,8916,12616,5124,16408,ITH,ITH3,5,Veneto
2021-05-20,SIC,43569,20886,22683,27633,15936,ITG,ITG1,19,Sicilia
2021-04-05,VEN,19140,8367,10773,13700,5440,ITH,ITH3,5,Veneto
2021-02-02,TOS,3743,1475,2268,196,3547,ITI,ITI1,9,Toscana
2021-03-12,PIE,13949,5183,8766,11014,2935,ITC,ITC1,1,Piemonte
2021-04-07,SAR,13600,6108,7492,7952,5648,ITG,ITG2,20,Sardegna
2021-04-12,FVG,7255,3181,4074,6124,1131,ITH,ITH4,6,Friuli-Venezia Giulia
2021-01-26,VEN,6917,2091,4826,152,6765,ITH,ITH3,5,Veneto
2021-04-24,SAR,10366,4851,5515,8030,2336,ITG,ITG2,20,Sardegna
2021-04-27,MAR,9399,4309,5090,5413,3986,ITI,ITI3,11,Marche
2021-05-15,PAT,1567,815,752,679,888,ITH,ITH2,4,Provincia Autonoma Trento
2021-03-31,LAZ,28430,14017,14413,21331,7099,ITI,ITI4,12,Lazio
2021-01-14,SAR,1105,426,679,1105,0,ITG,ITG2,20,Sardegna
2021-02-01,BAS,242,91,151,46,196,ITF,ITF5,17,Basilicata
2021-03-15,LIG,7278,3132,4146,4577,2701,ITC,ITC3,7,Liguria
2021-04-03,PUG,10544,4635,5909,6991,3553,ITF,ITF4,16,Puglia
2021-03-26,PIE,17748,6981,10767,8841,8907,ITC,ITC1,1,Piemonte
2021-05-02,PAB,2457,1288,1169,1536,921,ITH,ITH1,4,Provincia Autonoma Bolzano / Bozen
2021-06-01,PAT,3978,1860,2118,1140,2838,ITH,ITH2,4,Provincia Autonoma Trento
2021-02-13,VDA,216,196,20,215,1,ITC,ITC2,2,Valle d'Aosta / Vallée d'Aoste
2021-01-22,PAB,248,143,105,124,124,ITH,ITH1,4,Provincia Autonoma Bolzano / Bozen
2021-04-07,LOM,50571,20934,29637,34766,15805,ITC,ITC4,3,Lombardia
2021-05-06,VEN,46848,21981,24867,38374,8474,ITH,ITH3,5,Veneto
2021-01-07,LAZ,7747,2902,4845,7747,0,ITI,ITI4,12,Lazio
2021-01-17,MAR,1609,688,921,1550,59,ITI,ITI3,11,Marche
2021-05-26,BAS,4490,2261,2229,1707,2783,ITF,ITF5,17,Basilicata
2021-05-15,CAL,27113,12983,14130,20340,6773,ITF,ITF6,18,Calabria
2021-03-29,LOM,40063,15564,24499,25233,14830,ITC,ITC4,3,Lombardia
2020-12-31,SIC,881,470,411,881,0,ITG,ITG1,19,Sicilia
2021-01-26,TOS,5393,1792,3601,220,5173,ITI,ITI1,9,Toscana
2021-03-30,ABR,5197,2322,2875,3373,1824,ITF,ITF1,13,Abruzzo
2021-03-10,LIG,5917,2879,3038,4011,1906,ITC,ITC3,7,Liguria
2021-05-06,TOS,31308,13613,17695,14174,17134,ITI,ITI1,9,Toscana
2021-06-03,CAM,72478,35129,37349,61867,10611,ITF,ITF3,15,Campania
2021-01-06,ABR,1831,664,1167,1831,0,ITF,ITF1,13,Abruzzo
2021-02-23,CAM,11003,3388,7615,10477,526,ITF,ITF3,15,Campania
2021-04-19,TOS,9090,4504,4586,8062,1028,ITI,ITI1,9,Toscana
2021-05-01,VEN,38840,18234,20606,29895,8945,ITH,ITH3,5,Veneto
2021-05-03,SAR,8184,3819,4365,6588,1596,ITG,ITG2,20,Sardegna
2021-02-02,CAL,2316,1131,1185,177,2139,ITF,ITF6,18,Calabria
2021-05-30,MOL,1827,908,919,1543,284,ITF,ITF2,14,Molise
2021-03-07,SIC,9262,3455,5807,8179,1083,ITG,ITG1,19,Sicilia
2021-04-07,EMR,26157,11934,14223,20145,6012,ITH,ITH5,8,Emilia-Romagna
2021-04-17,TOS,20531,9206,11325,18409,2122,ITI,ITI1,9,Toscana
2021-05-20,SAR,15998,7630,8368,11309,4689,ITG,ITG2,20,Sardegna
2021-01-12,PAT,505,158,347,505,0,ITH,ITH2,4,Provincia Autonoma Trento
2021-01-16,CAL,2395,1120,1275,2395,0,ITF,ITF6,18,Calabria
2021-06-11,PAB,4427,2248,2179,1216,3211,ITH,ITH1,4,Provincia Autonoma Bolzano / Bozen
2021-02-09,SAR,2287,837,1450,1290,997,ITG,ITG2,20,Sardegna
2021-01-14,EMR,8129,2593,5536,8129,0,ITH,ITH5,8,Emilia-Romagna
2021-03-24,SIC,20867,9802,11065,15205,5662,ITG,ITG1,19,Sicilia
2021-02-26,SAR,2801,1109,1692,2495,306,ITG,ITG2,20,Sardegna
2021-03-20,PAB,1757,848,909,1132,625,ITH,ITH1,4,Provincia Autonoma Bolzano / Bozen
2021-05-27,LAZ,60212,29050,31162,44675,15537,ITI,ITI4,12,Lazio
2021-05-29,UMB,7833,3596,4237,6273,1560,ITI,ITI2,10,Umbria
2021-03-30,BAS,2740,1157,1583,2395,345,ITF,ITF5,17,Basilicata
2021-01-18,VDA,213,74,139,213,0,ITC,ITC2,2,Valle d'Aosta / Vallée d'Aoste
2021-02-21,CAM,5836,2241,3595,5611,225,ITF,ITF3,15,Campania
2021-03-19,PAT,2423,915,1508,1571,852,ITH,ITH2,4,Provincia Autonoma Trento
2021-01-06,BAS,294,129,165,294,0,ITF,ITF5,17,Basilicata
2021-01-24,TOS,3349,1073,2276,201,3148,ITI,ITI1,9,Toscana
2021-03-05,LAZ,20326,9357,10969,15593,4733,ITI,ITI4,12,Lazio
2021-02-16,LAZ,8357,4034,4323,7752,605,ITI,ITI4,12,Lazio
2021-04-05,PAT,35,17,18,33,2,ITH,ITH2,4,Provincia Autonoma Trento
2021-04-16,BAS,3319,1632,1687,2421,898,ITF,ITF5,17,Basilicata
2021-05-29,SIC,47086,21397,25689,23895,23191,ITG,ITG1,19,Sicilia
2021-01-07,TOS,6018,1751,4267,6018,0,ITI,ITI1,9,Toscana
2021-04-11,VDA,479,208,271,479,0,ITC,ITC2,2,Valle d'Aosta / Vallée d'Aoste
2021-03-03,LAZ,17834,7849,9985,13540,4294,ITI,ITI4,12,Lazio
2021-06-06,PIE,32714,17007,15707,30296,2418,ITC,ITC1,1,Piemonte
2021-03-22,VEN,18216,8246,9970,13173,5043,ITH,ITH3,5,Veneto
2021-04-30,MOL,2937,1556,1381,830,2107,ITF,ITF2,14,Molise
2021-05-11,CAM,39841,19232,20609,30461,9380,ITF,ITF3,15,Campania
2021-01-20,LIG,1550,555,995,1538,12,ITC,ITC3,7,Liguria
2021-03-13,VEN,17273,7345,9928,14142,3131,ITH,ITH3,5,Veneto
2021-03-25,PUG,11884,6180,5704,5643,6241,ITF,ITF4,16,Puglia
2021-02-24,UMB,1520,565,955,1505,15,ITI,ITI2,10,Umbria
2021-02-25,MOL,541,239,302,473,68,ITF,ITF2,14,Molise
2021-03-15,EMR,13610,6383,7227,7111,6499,ITH,ITH5,8,Emilia-Romagna
2021-05-22,ABR,13073,6352,6721,8171,4902,ITF,ITF1,13,Abruzzo
2021-04-27,SAR,7611,3548,4063,5569,2042,ITG,ITG2,20,Sardegna
2021-01-15,VEN,5874,1819,4055,5874,0,ITH,ITH3,5,Veneto
2021-03-09,PAB,1194,543,651,1192,2,ITH,ITH1,4,Provincia Autonoma Bolzano / Bozen
2021-03-26,ABR,5404,2360,3044,3328,2076,ITF,ITF1,13,Abruzzo
2021-01-17,SAR,860,277,583,859,1,ITG,ITG2,20,Sardegna
2021-02-17,PIE,4793,2156,2637,3803,990,ITC,ITC1,1,Piemonte
2021-02-24,SIC,9308,4760,4548,8748,560,ITG,ITG1,19,Sicilia
2021-03-15,SAR,2881,1405,1476,2508,373,ITG,ITG2,20,Sardegna
2021-05-30,FVG,11051,4985,6066,7467,3584,ITH,ITH4,6,Friuli-Venezia Giulia
2021-03-01,LOM,18773,8227,10546,17068,1705,ITC,ITC4,3,Lombardia
2021-02-08,PUG,3992,1610,2382,1597,2395,ITF,ITF4,16,Puglia
2021-05-31,ABR,11353,5150,6203,6982,4371,ITF,ITF1,13,Abruzzo
2021-01-21,SIC,1415,695,720,501,914,ITG,ITG1,19,Sicilia
2021-04-20,ABR,5589,2689,2900,4179,1410,ITF,ITF1,13,Abruzzo
2021-04-24,PAT,3511,1682,1829,3497,14,ITH,ITH2,4,Provincia Autonoma Trento
2021-01-26,LAZ,7958,3125,4833,724,7234,ITI,ITI4,12,Lazio
2021-02-26,PAT,1218,435,783,923,295,ITH,ITH2,4,Provincia Autonoma Trento
2021-05-01,SIC,24430,11306,13124,19276,5154,ITG,ITG1,19,Sicilia
2021-02-14,TOS,9000,2569,6431,8890,110,ITI,ITI1,9,Toscana
2021-03-26,SAR,8760,3786,4974,7233,1527,ITG,ITG2,20,Sardegna
2021-06-08,PIE,36987,19158,17829,34241,2746,ITC,ITC1,1,Piemonte
2021-05-20,VEN,44636,21179,23457,20363,24273,ITH,ITH3,5,Veneto
2021-05-22,SAR,24878,12028,12850,19782,5096,ITG,ITG2,20,Sardegna
2021-05-23,PAB,4337,2303,2034,4329,8,ITH,ITH1,4,Provincia Autonoma Bolzano / Bozen
2021-05-25,TOS,34116,16452,17664,19527,14589,ITI,ITI1,9,Toscana
2021-01-14,PAT,700,203,497,700,0,ITH,ITH2,4,Provincia Autonoma Trento
2021-02-09,VEN,5247,1889,3358,3446,1801,ITH,ITH3,5,Veneto
2021-05-10,UMB,5983,2800,3183,3831,2152,ITI,ITI2,10,Umbria
2021-03-29,TOS,9883,5032,4851,9559,324,ITI,ITI1,9,Toscana
2021-04-26,PIE,19770,8737,11033,15370,4400,ITC,ITC1,1,Piemonte
2021-02-13,BAS,799,313,486,738,61,ITF,ITF5,17,Basilicata
2020-12-28,CAL,6,2,4,6,0,ITF,ITF6,18,Calabria
2021-02-03,PAB,1503,478,1025,5,1498,ITH,ITH1,4,Provincia Autonoma Bolzano / Bozen
2021-04-02,LAZ,29144,13870,15274,21812,7332,ITI,ITI4,12,Lazio
2021-06-03,CAL,14156,6627,7529,9583,4573,ITF,ITF6,18,Calabria
2021-05-15,LOM,80837,38768,42069,47515,33322,ITC,ITC4,3,Lombardia
2021-05-24,BAS,4836,2347,2489,1106,3730,ITF,ITF5,17,Basilicata
2021-01-19,SAR,747,270,477,692,55,ITG,ITG2,20,Sardegna
2021-04-07,CAL,6546,2957,3589,3715,2831,ITF,ITF6,18,Calabria
2021-01-29,MAR,1991,730,1261,167,1824,ITI,ITI3,11,Marche
2021-02-08,VDA,223,83,140,25,198,ITC,ITC2,2,Valle d'Aosta / Vallée d'Aoste
2021-02-10,PUG,3644,1436,2208,2134,1510,ITF,ITF4,16,Puglia
2021-03-17,SAR,6556,2849,3707,4949,1607,ITG,ITG2,20,Sardegna
2021-02-09,EMR,4156,1249,2907,2309,1847,ITH,ITH5,8,Emilia-Romagna
2021-02-23,CAL,1590,753,837,1475,115,ITF,ITF6,18,Calabria
2021-04-25,ABR,9066,4621,4445,8256,810,ITF,ITF1,13,Abruzzo
2021-05-18,MAR,11059,5257,5802,7655,3404,ITI,ITI3,11,Marche
2021-02-28,PAT,242,121,121,242,0,ITH,ITH2,4,Provincia Autonoma Trento
2021-03-23,VDA,379,150,229,245,134,ITC,ITC2,2,Valle d'Aosta / Vallée d'Aoste
2021-05-08,UMB,8102,3730,4372,4906,3196,ITI,ITI2,10,Umbria
2021-05-19,VDA,993,498,495,418,575,ITC,ITC2,2,Valle d'Aosta / Vallée d'Aoste
2021-06-08,PAT,5908,2862,3046,1868,4040,ITH,ITH2,4,Provincia Autonoma Trento
2021-01-28,LAZ,8279,3165,5114,782,7497,ITI,ITI4,12,Lazio
2021-02-02,CAM,5724,2805,2919,444,5280,ITF,ITF3,15,Campania
2021-02-10,PAB,1635,604,1031,26,1609,ITH,ITH1,4,Provincia Autonoma Bolzano / Bozen
2021-05-10,SIC,28245,13577,14668,16156,12089,ITG,ITG1,19,Sicilia
2021-03-31,CAM,23468,11656,11812,20029,3439,ITF,ITF3,15,Campania
2021-05-08,LAZ,45198,20619,24579,29823,15375,ITI,ITI4,12,Lazio
2021-01-28,UMB,1247,394,853,19,1228,ITI,ITI2,10,Umbria
2021-01-29,MOL,421,136,285,6,415,ITF,ITF2,14,Molise
2021-04-26,PAT,2651,1249,1402,2557,94,ITH,ITH2,4,Provincia Autonoma Trento
2021-05-09,MOL,2051,932,1119,1955,96,ITF,ITF2,14,Molise
2021-05-13,LOM,86995,41708,45287,58261,28734,ITC,ITC4,3,Lombardia
2021-05-23,PUG,17864,8351,9513,14058,3806,ITF,ITF4,16,Puglia
2021-02-02,LOM,19865,6591,13274,497,19368,ITC,ITC4,3,Lombardia
2021-03-26,SIC,17821,8295,9526,12392,5429,ITG,ITG1,19,Sicilia
2021-06-02,BAS,5959,2804,3155,4416,1543,ITF,ITF5,17,Basilicata
2021-03-31,LOM,42093,17099,24994,26870,15223,ITC,ITC4,3,Lombardia
2021-05-15,EMR,33194,14972,18222,22818,10376,ITH,ITH5,8,Emilia-Romagna
2021-05-03,FVG,7209,3286,3923,3430,3779,ITH,ITH4,6,Friuli-Venezia Giulia
2021-02-04,EMR,9939,3207,6732,1250,8689,ITH,ITH5,8,Emilia-Romagna
2021-05-22,EMR,32912,14104,18808,16896,16016,ITH,ITH5,8,Emilia-Romagna
2021-05-03,UMB,5091,2271,2820,2204,2887,ITI,ITI2,10,Umbria
2021-01-14,FVG,2584,789,1795,2584,0,ITH,ITH4,6,Friuli-Venezia Giulia
2021-04-05,LIG,3976,1751,2225,2327,1649,ITC,ITC3,7,Liguria
2021-04-18,BAS,3719,1846,1873,2352,1367,ITF,ITF5,17,Basilicata
2021-04-09,EMR,25737,11680,14057,20040,5697,ITH,ITH5,8,Emilia-Romagna
2021-01-28,SIC,9024,4269,4755,396,8628,ITG,ITG1,19,Sicilia
2021-05-11,MOL,3206,1414,1792,2956,250,ITF,ITF2,14,Molise
2021-01-23,UMB,280,100,180,2,278,ITI,ITI2,10,Umbria
2021-05-08,SIC,35564,17001,18563,25312,10252,ITG,ITG1,19,Sicilia
2021-05-27,VEN,46557,23018,23539,23433,23124,ITH,ITH3,5,Veneto
2021-02-17,PUG,4275,1746,2529,3672,603,ITF,ITF4,16,Puglia
2021-05-03,PIE,26659,12166,14493,12514,14145,ITC,ITC1,1,Piemonte
2021-04-07,CAM,24952,11969,12983,20226,4726,ITF,ITF3,15,Campania
2021-04-27,MOL,1593,767,826,465,1128,ITF,ITF2,14,Molise
2021-05-27,PAT,4263,1979,2284,1246,3017,ITH,ITH2,4,Provincia Autonoma Trento
2021-03-24,LIG,9158,4020,5138,5872,3286,ITC,ITC3,7,Liguria
2021-05-10,EMR,33832,16121,17711,26590,7242,ITH,ITH5,8,Emilia-Romagna
2021-05-08,FVG,10262,4638,5624,5484,4778,ITH,ITH4,6,Friuli-Venezia Giulia
2020-12-31,LIG,989,354,635,989,0,ITC,ITC3,7,Liguria
2021-04-30,BAS,5284,2373,2911,4121,1163,ITF,ITF5,17,Basilicata
2021-02-21,VEN,4634,1209,3425,4629,5,ITH,ITH3,5,Veneto
2021-04-28,UMB,5348,2317,3031,2965,2383,ITI,ITI2,10,Umbria
2021-03-06,PAB,3973,2081,1892,3762,211,ITH,ITH1,4,Provincia Autonoma Bolzano / Bozen
2021-04-10,LIG,7882,3556,4326,6968,914,ITC,ITC3,7,Liguria
2021-02-04,UMB,733,226,507,25,708,ITI,ITI2,10,Umbria
2021-05-15,VEN,36143,17473,18670,26170,9973,ITH,ITH3,5,Veneto
2021-01-17,LIG,862,300,562,862,0,ITC,ITC3,7,Liguria
2021-05-02,ABR,10424,5088,5336,5214,5210,ITF,ITF1,13,Abruzzo
2021-05-25,MAR,11647,5745,5902,8717,2930,ITI,ITI3,11,Marche
2021-05-28,PAB,5717,2928,2789,3788,1929,ITH,ITH1,4,Provincia Autonoma Bolzano / Bozen
2021-01-20,BAS,84,22,62,84,0,ITF,ITF5,17,Basilicata
2021-05-15,UMB,4984,1875,3109,1819,3165,ITI,ITI2,10,Umbria
2021-05-16,MOL,1247,571,676,1065,182,ITF,ITF2,14,Molise
2021-02-17,PAB,156,51,105,139,17,ITH,ITH1,4,Provincia Autonoma Bolzano / Bozen
2021-04-21,EMR,23952,10961,12991,14207,9745,ITH,ITH5,8,Emilia-Romagna
2021-06-01,VEN,26876,13531,13345,16392,10484,ITH,ITH3,5,Veneto
2021-02-22,PUG,9629,4537,5092,9298,331,ITF,ITF4,16,Puglia
2021-05-08,PIE,34192,16222,17970,18557,15635,ITC,ITC1,1,Piemonte
2021-06-03,SAR,16343,7607,8736,10698,5645,ITG,ITG2,20,Sardegna
2021-01-02,CAL,166,94,72,166,0,ITF,ITF6,18,Calabria
2021-01-28,PIE,5591,1809,3782,384,5207,ITC,ITC1,1,Piemonte
2021-05-08,EMR,32327,15088,17239,20907,11420,ITH,ITH5,8,Emilia-Romagna
2021-05-20,LOM,94391,45650,48741,31830,62561,ITC,ITC4,3,Lombardia
2021-03-01,MAR,3724,1487,2237,3476,248,ITI,ITI3,11,Marche
2021-05-10,FVG,7913,3515,4398,6374,1539,ITH,ITH4,6,Friuli-Venezia Giulia
2021-01-28,EMR,10252,3339,6913,349,9903,ITH,ITH5,8,Emilia-Romagna
2021-03-10,VEN,19121,8803,10318,13440,5681,ITH,ITH3,5,Veneto
2021-02-05,PUG,5635,2273,3362,1333,4302,ITF,ITF4,16,Puglia
2021-03-12,SAR,6410,3036,3374,5102,1308,ITG,ITG2,20,Sardegna
2021-02-14,PIE,1476,498,978,876,600,ITC,ITC1,1,Piemonte
2021-05-16,PUG,24413,11010,13403,12609,11804,ITF,ITF4,16,Puglia
2021-03-18,VDA,136,43,93,99,37,ITC,ITC2,2,Valle d'Aosta / Vallée d'Aoste
2021-06-03,FVG,11835,6448,5387,9875,1960,ITH,ITH4,6,Friuli-Venezia Giulia
2021-03-04,ABR,5936,2360,3576,5014,922,ITF,ITF1,13,Abruzzo
2021-04-05,SAR,2036,784,1252,2035,1,ITG,ITG2,20,Sardegna
2021-01-31,LOM,9732,3760,5972,29,9703,ITC,ITC4,3,Lombardia
2021-02-14,CAM,3928,1923,2005,3894,34,ITF,ITF3,15,Campania
2021-02-22,PAB,526,143,383,514,12,ITH,ITH1,4,Provincia Autonoma Bolzano / Bozen
2021-03-14,LAZ,17110,6622,10488,11956,5154,ITI,ITI4,12,Lazio
2021-05-06,LIG,14486,6421,8065,6187,8299,ITC,ITC3,7,Liguria
2021-03-19,VEN,13789,5668,8121,7695,6094,ITH,ITH3,5,Veneto
2021-05-25,LOM,90964,43553,47411,44619,46345,ITC,ITC4,3,Lombardia
2021-03-04,VDA,291,139,152,42,249,ITC,ITC2,2,Valle d'Aosta / Vallée d'Aoste
2021-02-14,LOM,3578,1545,2033,2943,635,ITC,ITC4,3,Lombardia
2021-05-26,VDA,1209,587,622,576,633,ITC,ITC2,2,Valle d'Aosta / Vallée d'Aoste
2021-03-01,MOL,661,274,387,447,214,ITF,ITF2,14,Molise
2021-04-29,MAR,13247,6062,7185,7150,6097,ITI,ITI3,11,Marche
2021-01-26,LIG,2491,807,1684,20,2471,ITC,ITC3,7,Liguria
2021-01-12,LOM,20211,6695,13516,20211,0,ITC,ITC4,3,Lombardia
2021-01-26,CAM,7340,3726,3614,351,6989,ITF,ITF3,15,Campania
2021-03-10,PAT,2402,929,1473,1481,921,ITH,ITH2,4,Provincia Autonoma Trento
2021-01-19,FVG,6,2,4,6,0,ITH,ITH4,6,Friuli-Venezia Giulia
2021-03-04,BAS,1880,892,988,1085,795,ITF,ITF5,17,Basilicata
2021-04-03,MOL,1770,850,920,1735,35,ITF,ITF2,14,Molise
2021-01-09,SIC,7120,3350,3770,7120,0,ITG,ITG1,19,Sicilia
2021-02-19,TOS,8291,2952,5339,7781,510,ITI,ITI1,9,Toscana
2021-06-03,EMR,37784,18395,19389,30322,7462,ITH,ITH5,8,Emilia-Romagna
2021-06-03,PIE,33875,17342,16533,29661,4214,ITC,ITC1,1,Piemonte
2021-01-10,PUG,2348,1061,1287,2348,0,ITF,ITF4,16,Puglia
2021-02-23,EMR,8215,3219,4996,7829,386,ITH,ITH5,8,Emilia-Romagna
2021-04-20,PUG,21105,9796,11309,17642,3463,ITF,ITF4,16,Puglia
2021-05-03,SIC,23324,10798,12526,13538,9786,ITG,ITG1,19,Sicilia
2021-03-12,EMR,18644,7979,10665,11927,6717,ITH,ITH5,8,Emilia-Romagna
2020-12-27,PUG,509,252,257,509,0,ITF,ITF4,16,Puglia
2021-04-02,UMB,4308,1746,2562,3551,757,ITI,ITI2,10,Umbria
2021-04-19,CAM,30736,14820,15916,19168,11568,ITF,ITF3,15,Campania
2021-05-28,ABR,13998,6305,7693,7647,6351,ITF,ITF1,13,Abruzzo
2021-01-09,UMB,1745,499,1246,1745,0,ITI,ITI2,10,Umbria
2021-04-19,SIC,18242,8639,9603,12663,5579,ITG,ITG1,19,Sicilia
2021-01-09,CAM,10567,5024,5543,10567,0,ITF,ITF3,15,Campania
2021-02-28,CAL,2328,1055,1273,2175,153,ITF,ITF6,18,Calabria
2021-04-19,UMB,5015,2216,2799,2966,2049,ITI,ITI2,10,Umbria
2021-03-26,LAZ,31071,14776,16295,24221,6850,ITI,ITI4,12,Lazio
2021-05-21,PAB,6918,3801,3117,5074,1844,ITH,ITH1,4,Provincia Autonoma Bolzano / Bozen
2021-05-28,PUG,44127,21225,22902,28319,15808,ITF,ITF4,16,Puglia
2021-02-07,VEN,2315,862,1453,714,1601,ITH,ITH3,5,Veneto
2021-02-02,EMR,9485,3053,6432,527,8958,ITH,ITH5,8,Emilia-Romagna
2021-02-20,BAS,1162,531,631,1044,118,ITF,ITF5,17,Basilicata
2021-02-19,PAT,929,359,570,870,59,ITH,ITH2,4,Provincia Autonoma Trento
2021-05-31,BAS,4228,2009,2219,1721,2507,ITF,ITF5,17,Basilicata
2021-01-26,SIC,9225,4556,4669,259,8966,ITG,ITG1,19,Sicilia
2021-02-26,PIE,12293,4933,7360,11556,737,ITC,ITC1,1,Piemonte
2021-03-24,SAR,7408,3107,4301,6049,1359,ITG,ITG2,20,Sardegna
2021-01-08,ABR,1525,507,1018,1525,0,ITF,ITF1,13,Abruzzo
2021-06-08,FVG,9832,5142,4690,9487,345,ITH,ITH4,6,Friuli-Venezia Giulia
2021-01-21,UMB,610,202,408,341,269,ITI,ITI2,10,Umbria
2021-03-10,LOM,33231,12709,20522,25372,7859,ITC,ITC4,3,Lombardia
2021-04-24,PIE,27454,12420,15034,21812,5642,ITC,ITC1,1,Piemonte
2021-05-27,TOS,29003,13815,15188,13834,15169,ITI,ITI1,9,Toscana
2021-02-28,FVG,2685,1002,1683,2292,393,ITH,ITH4,6,Friuli-Venezia Giulia
2021-04-18,ABR,5812,2727,3085,4869,943,ITF,ITF1,13,Abruzzo
2021-05-11,MAR,10622,4832,5790,5678,4944,ITI,ITI3,11,Marche
2021-01-14,PIE,9766,3152,6614,9766,0,ITC,ITC1,1,Piemonte
2021-03-16,VDA,182,37,145,118,64,ITC,ITC2,2,Valle d'Aosta / Vallée d'Aoste
2021-03-31,TOS,32795,13344,19451,20635,12160,ITI,ITI1,9,Toscana
2021-05-06,LOM,89759,42169,47590,73317,16442,ITC,ITC4,3,Lombardia
2021-01-26,LOM,8336,2704,5632,349,7987,ITC,ITC4,3,Lombardia
2021-03-31,CAL,8809,4001,4808,4850,3959,ITF,ITF6,18,Calabria
2021-02-18,BAS,1070,401,669,855,215,ITF,ITF5,17,Basilicata
2021-04-09,CAL,7935,3715,4220,5009,2926,ITF,ITF6,18,Calabria
2021-04-02,CAM,21807,10481,11326,19485,2322,ITF,ITF3,15,Campania
2021-05-11,LIG,14129,6585,7544,7526,6603,ITC,ITC3,7,Liguria
2021-05-30,PUG,20859,9987,10872,15853,5006,ITF,ITF4,16,Puglia
2021-01-22,MOL,126,35,91,126,0,ITF,ITF2,14,Molise
2021-03-22,TOS,5960,3374,2586,5516,444,ITI,ITI1,9,Toscana
2021-03-24,VEN,22080,9559,12521,15272,6808,ITH,ITH3,5,Veneto
2021-05-16,PAB,2024,931,1093,1330,694,ITH,ITH1,4,Provincia Autonoma Bolzano / Bozen
2021-05-02,MOL,1892,932,960,588,1304,ITF,ITF2,14,Molise
2021-02-20,ABR,4776,1842,2934,4700,76,ITF,ITF1,13,Abruzzo
2021-03-15,MAR,4402,2027,2375,1312,3090,ITI,ITI3,11,Marche
2021-03-29,LIG,10645,4703,5942,7515,3130,ITC,ITC3,7,Liguria
2021-04-26,FVG,5457,2449,3008,3808,1649,ITH,ITH4,6,Friuli-Venezia Giulia
2021-03-06,MOL,1728,807,921,1569,159,ITF,ITF2,14,Molise
2021-06-05,CAL,20322,9521,10801,17362,2960,ITF,ITF6,18,Calabria
2021-01-31,LIG,624,270,354,9,615,ITC,ITC3,7,Liguria
2021-02-12,BAS,775,332,443,744,31,ITF,ITF5,17,Basilicata
2021-03-14,MOL,596,240,356,17,579,ITF,ITF2,14,Molise
2020-12-27,CAL,312,170,142,312,0,ITF,ITF6,18,Calabria
2021-03-18,EMR,13675,5807,7868,5675,8000,ITH,ITH5,8,Emilia-Romagna
2021-05-14,EMR,37194,17143,20051,27609,9585,ITH,ITH5,8,Emilia-Romagna
2021-02-03,EMR,9356,2996,6360,984,8372,ITH,ITH5,8,Emilia-Romagna
2021-04-10,BAS,1033,378,655,950,83,ITF,ITF5,17,Basilicata
2021-04-01,EMR,23927,10768,13159,19380,4547,ITH,ITH5,8,Emilia-Romagna
2021-03-13,UMB,1731,524,1207,1486,245,ITI,ITI2,10,Umbria
2021-01-15,UMB,701,215,486,701,0,ITI,ITI2,10,Umbria
2021-02-01,CAM,3985,1813,2172,110,3875,ITF,ITF3,15,Campania
2021-02-26,ABR,3914,1670,2244,2946,968,ITF,ITF1,13,Abruzzo
2021-02-17,EMR,6537,2763,3774,5765,772,ITH,ITH5,8,Emilia-Romagna
2021-04-06,CAL,7464,3375,4089,4175,3289,ITF,ITF6,18,Calabria
2021-01-29,UMB,1232,348,884,79,1153,ITI,ITI2,10,Umbria
2021-03-30,CAM,22171,10699,11472,19213,2958,ITF,ITF3,15,Campania
2021-05-09,SIC,28074,13134,14940,19804,8270,ITG,ITG1,19,Sicilia
2021-02-08,CAL,1849,734,1115,663,1186,ITF,ITF6,18,Calabria
2021-05-09,UMB,5765,2757,3008,5374,391,ITI,ITI2,10,Umbria
2021-02-16,VDA,325,53,272,320,5,ITC,ITC2,2,Valle d'Aosta / Vallée d'Aoste
2021-05-04,FVG,9517,4291,5226,6163,3354,ITH,ITH4,6,Friuli-Venezia Giulia
2021-06-01,EMR,27100,13071,14029,17223,9877,ITH,ITH5,8,Emilia-Romagna
2021-02-15,MAR,967,412,555,954,13,ITI,ITI3,11,Marche
2021-03-15,PAT,1411,545,866,947,464,ITH,ITH2,4,Provincia Autonoma Trento
2021-01-24,FVG,305,119,186,1,304,ITH,ITH4,6,Friuli-Venezia Giulia
2021-06-11,TOS,14497,7629,6868,13235,1262,ITI,ITI1,9,Toscana
2021-01-17,PAT,251,195,56,251,0,ITH,ITH2,4,Provincia Autonoma Trento
2021-04-28,BAS,4704,2158,2546,4263,441,ITF,ITF5,17,Basilicata
2021-05-26,MAR,11803,5916,5887,8620,3183,ITI,ITI3,11,Marche
2021-02-12,LAZ,6845,2847,3998,6431,414,ITI,ITI4,12,Lazio
2021-04-15,TOS,24402,10197,14205,15865,8537,ITI,ITI1,9,Toscana
2021-02-17,TOS,8175,3169,5006,7423,752,ITI,ITI1,9,Toscana
2021-03-08,FVG,4175,1691,2484,2090,2085,ITH,ITH4,6,Friuli-Venezia Giulia
2021-04-25,PUG,11239,5210,6029,10082,1157,ITF,ITF4,16,Puglia
2021-05-11,PAT,3697,1749,1948,2849,848,ITH,ITH2,4,Provincia Autonoma Trento
2021-02-27,PUG,14220,4816,9404,12995,1225,ITF,ITF4,16,Puglia
2021-04-06,LIG,13213,5888,7325,10973,2240,ITC,ITC3,7,Liguria
2021-04-24,CAL,18992,9476,9516,15583,3409,ITF,ITF6,18,Calabria
2021-04-17,CAM,36177,17510,18667,24670,11507,ITF,ITF3,15,Campania
2021-01-01,PUG,148,61,87,148,0,ITF,ITF4,16,Puglia
2021-02-08,LIG,1977,741,1236,306,1671,ITC,ITC3,7,Liguria
2021-02-26,CAL,3065,1634,1431,2612,453,ITF,ITF6,18,Calabria
2021-05-31,PAB,2987,1464,1523,2120,867,ITH,ITH1,4,Provincia Autonoma Bolzano / Bozen
2021-06-07,PUG,43288,21151,22137,30344,12944,ITF,ITF4,16,Puglia
2021-02-17,VEN,6022,2772,3250,5928,94,ITH,ITH3,5,Veneto
2021-03-28,MOL,1626,747,879,524,1102,ITF,ITF2,14,Molise
2021-03-22,FVG,3876,1637,2239,1922,1954,ITH,ITH4,6,Friuli-Venezia Giulia
2021-04-11,PUG,16451,7244,9207,14795,1656,ITF,ITF4,16,Puglia
2021-01-30,MOL,461,158,303,12,449,ITF,ITF2,14,Molise
2021-03-02,BAS,795,383,412,660,135,ITF,ITF5,17,Basilicata
2021-03-30,MAR,7419,3044,4375,4604,2815,ITI,ITI3,11,Marche
2021-04-27,PAT,3908,1877,2031,3840,68,ITH,ITH2,4,Provincia Autonoma Trento
2020-12-27,LIG,135,56,79,135,0,ITC,ITC3,7,Liguria
2021-02-05,SAR,1897,749,1148,433,1464,ITG,ITG2,20,Sardegna
2021-02-01,MAR,1362,479,883,98,1264,ITI,ITI3,11,Marche
2021-04-01,VEN,25287,11137,14150,18879,6408,ITH,ITH3,5,Veneto
2021-06-10,BAS,4353,2104,2249,3901,452,ITF,ITF5,17,Basilicata
2021-02-05,SIC,6732,2976,3756,2125,4607,ITG,ITG1,19,Sicilia
2021-03-08,PIE,13950,5296,8654,11236,2714,ITC,ITC1,1,Piemonte
2021-04-03,SAR,4663,1802,2861,2696,1967,ITG,ITG2,20,Sardegna
2021-01-18,ABR,123,49,74,46,77,ITF,ITF1,13,Abruzzo
2021-05-04,PIE,28539,13121,15418,16405,12134,ITC,ITC1,1,Piemonte
2021-05-30,SAR,9725,4836,4889,7369,2356,ITG,ITG2,20,Sardegna
2021-04-28,ABR,9509,4584,4925,7485,2024,ITF,ITF1,13,Abruzzo
2021-01-24,PIE,3153,959,2194,434,2719,ITC,ITC1,1,Piemonte
2021-02-19,SAR,1499,473,1026,1443,56,ITG,ITG2,20,Sardegna
2021-06-06,CAL,13372,6431,6941,11679,1693,ITF,ITF6,18,Calabria
2021-01-01,PAB,6,5,1,6,0,ITH,ITH1,4,Provincia Autonoma Bolzano / Bozen
2021-04-15,VEN,20848,8609,12239,10039,10809,ITH,ITH3,5,Veneto
2021-05-12,ABR,9613,4585,5028,6046,3567,ITF,ITF1,13,Abruzzo
2021-05-30,CAM,52122,25426,26696,38834,13288,ITF,ITF3,15,Campania
2021-06-07,PAB,2900,1506,1394,2581,319,ITH,ITH1,4,Provincia Autonoma Bolzano / Bozen
2021-03-22,PIE,11512,4882,6630,3906,7606,ITC,ITC1,1,Piemonte
2021-04-03,SIC,16388,7802,8586,13552,2836,ITG,ITG1,19,Sicilia
2021-01-05,VEN,7329,2182,5147,7329,0,ITH,ITH3,5,Veneto
2021-02-19,CAM,9570,3559,6011,8920,650,ITF,ITF3,15,Campania
2021-02-27,PAB,2458,759,1699,2448,10,ITH,ITH1,4,Provincia Autonoma Bolzano / Bozen
2021-03-16,ABR,3484,1452,2032,1830,1654,ITF,ITF1,13,Abruzzo
2020-12-31,LAZ,5293,2121,3172,5293,0,ITI,ITI4,12,Lazio
2021-04-03,LOM,36234,14859,21375,26147,10087,ITC,ITC4,3,Lombardia
2021-05-28,TOS,30201,14043,16158,17694,12507,ITI,ITI1,9,Toscana
2021-04-10,LAZ,23835,10338,13497,16653,7182,ITI,ITI4,12,Lazio
2021-05-30,LOM,74365,35586,38779,34412,39953,ITC,ITC4,3,Lombardia
2021-05-04,PAT,4477,2424,2053,4386,91,ITH,ITH2,4,Provincia Autonoma Trento
2021-01-17,FVG,1716,523,1193,1716,0,ITH,ITH4,6,Friuli-Venezia Giulia
2021-02-05,LAZ,7279,2961,4318,1184,6095,ITI,ITI4,12,Lazio
2021-04-07,VDA,910,474,436,681,229,ITC,ITC2,2,Valle d'Aosta / Vallée d'Aoste
2021-04-12,EMR,19242,9005,10237,14796,4446,ITH,ITH5,8,Emilia-Romagna
2021-04-22,TOS,35723,15302,20421,18283,17440,ITI,ITI1,9,Toscana
2021-03-08,PAT,1411,434,977,1057,354,ITH,ITH2,4,Provincia Autonoma Trento
2021-04-06,MAR,8879,3693,5186,8066,813,ITI,ITI3,11,Marche
2021-02-24,TOS,10371,4467,5904,10170,201,ITI,ITI1,9,Toscana
2021-03-15,FVG,4129,1975,2154,1808,2321,ITH,ITH4,6,Friuli-Venezia Giulia
2021-06-08,EMR,44290,22667,21623,36938,7352,ITH,ITH5,8,Emilia-Romagna
2021-03-22,PAT,2306,973,1333,1431,875,ITH,ITH2,4,Provincia Autonoma Trento
2021-06-04,TOS,28118,13297,14821,20321,7797,ITI,ITI1,9,Toscana
2021-01-24,PAT,547,276,271,224,323,ITH,ITH2,4,Provincia Autonoma Trento
2021-05-20,UMB,9834,4585,5249,6195,3639,ITI,ITI2,10,Umbria
2021-02-09,VDA,251,84,167,68,183,ITC,ITC2,2,Valle d'Aosta / Vallée d'Aoste
2021-03-06,PUG,16139,6120,10019,14051,2088,ITF,ITF4,16,Puglia
2021-04-03,LAZ,24739,11138,13601,18040,6699,ITI,ITI4,12,Lazio
2021-04-08,TOS,29678,12553,17125,23291,6387,ITI,ITI1,9,Toscana
2020-12-31,CAM,1490,811,679,1490,0,ITF,ITF3,15,Campania
2021-02-10,VEN,4751,1588,3163,3697,1054,ITH,ITH3,5,Veneto
2021-03-23,MAR,5789,2529,3260,2262,3527,ITI,ITI3,11,Marche
2021-06-06,CAM,62317,30977,31340,61671,646,ITF,ITF3,15,Campania
2021-01-07,CAL,2187,1067,1120,2187,0,ITF,ITF6,18,Calabria
2021-01-08,PUG,5616,2355,3261,5616,0,ITF,ITF4,16,Puglia
2021-02-13,PAB,318,79,239,312,6,ITH,ITH1,4,Provincia Autonoma Bolzano / Bozen
2021-02-06,MOL,429,179,250,29,400,ITF,ITF2,14,Molise
2021-02-26,CAM,13337,4229,9108,12002,1335,ITF,ITF3,15,Campania
2021-04-08,VEN,32319,14346,17973,24441,7878,ITH,ITH3,5,Veneto
2021-04-11,PAB,2720,1291,1429,2543,177,ITH,ITH1,4,Provincia Autonoma Bolzano / Bozen
2021-04-17,CAL,10855,5086,5769,9048,1807,ITF,ITF6,18,Calabria
2021-04-18,PUG,22545,10778,11767,21482,1063,ITF,ITF4,16,Puglia
2021-02-08,MAR,833,258,575,371,462,ITI,ITI3,11,Marche
2021-04-24,CAM,36333,17519,18814,25086,11247,ITF,ITF3,15,Campania
2021-02-20,PUG,2971,1080,1891,2714,257,ITF,ITF4,16,Puglia
2021-03-27,SAR,5745,2203,3542,5323,422,ITG,ITG2,20,Sardegna
2021-05-01,CAL,16623,7933,8690,12430,4193,ITF,ITF6,18,Calabria
2021-05-11,FVG,9001,4320,4681,7202,1799,ITH,ITH4,6,Friuli-Venezia Giulia
2021-04-21,BAS,3922,1835,2087,2272,1650,ITF,ITF5,17,Basilicata
2021-05-19,MAR,11469,5272,6197,8561,2908,ITI,ITI3,11,Marche
2021-01-31,FVG,2715,836,1879,385,2330,ITH,ITH4,6,Friuli-Venezia Giulia
2021-02-15,LIG,2262,839,1423,1865,397,ITC,ITC3,7,Liguria
2021-03-05,CAL,6231,3614,2617,5658,573,ITF,ITF6,18,Calabria
2021-05-23,SAR,9965,4805,5160,7721,2244,ITG,ITG2,20,Sardegna
2021-05-24,PAB,1444,762,682,1110,334,ITH,ITH1,4,Provincia Autonoma Bolzano / Bozen
2021-05-05,ABR,11654,5585,6069,6447,5207,ITF,ITF1,13,Abruzzo
2021-02-12,SAR,2237,933,1304,2178,59,ITG,ITG2,20,Sardegna
2021-03-27,SIC,15587,7351,8236,10735,4852,ITG,ITG1,19,Sicilia
2021-04-27,PIE,22582,10208,12374,17444,5138,ITC,ITC1,1,Piemonte
2021-03-09,ABR,5167,1795,3372,4229,938,ITF,ITF1,13,Abruzzo
2021-01-03,LIG,734,230,504,734,0,ITC,ITC3,7,Liguria
2021-01-17,PIE,3518,1168,2350,2870,648,ITC,ITC1,1,Piemonte
2021-01-29,SIC,9124,4229,4895,425,8699,ITG,ITG1,19,Sicilia
2021-04-10,SAR,10490,4748,5742,8555,1935,ITG,ITG2,20,Sardegna
2021-02-20,PAB,1802,540,1262,1784,18,ITH,ITH1,4,Provincia Autonoma Bolzano / Bozen
2021-06-04,VEN,49422,25804,23618,41309,8113,ITH,ITH3,5,Veneto
2021-02-12,SIC,4586,1811,2775,4320,266,ITG,ITG1,19,Sicilia
2021-03-15,PIE,10661,4164,6497,5041,5620,ITC,ITC1,1,Piemonte
2021-02-24,VEN,8614,3678,4936,8128,486,ITH,ITH3,5,Veneto
2021-04-10,CAM,28343,13489,14854,23430,4913,ITF,ITF3,15,Campania
2021-04-18,PAB,3110,1607,1503,2100,1010,ITH,ITH1,4,Provincia Autonoma Bolzano / Bozen
2021-05-11,PIE,32089,15492,16597,18841,13248,ITC,ITC1,1,Piemonte
2021-05-23,SIC,34100,16596,17504,20072,14028,ITG,ITG1,19,Sicilia
2021-01-31,PIE,4113,1753,2360,112,4001,ITC,ITC1,1,Piemonte
2021-05-23,LOM,60740,28919,31821,26793,33947,ITC,ITC4,3,Lombardia
2021-02-12,LOM,13938,4358,9580,9021,4917,ITC,ITC4,3,Lombardia
2021-02-19,LAZ,10045,5080,4965,9214,831,ITI,ITI4,12,Lazio
2021-04-10,LOM,52679,21819,30860,40726,11953,ITC,ITC4,3,Lombardia
2021-06-06,LOM,89778,46167,43611,80602,9176,ITC,ITC4,3,Lombardia
2021-01-07,LOM,11754,3634,8120,11754,0,ITC,ITC4,3,Lombardia
2021-03-03,TOS,18228,6537,11691,14622,3606,ITI,ITI1,9,Toscana
2021-06-04,MOL,2872,1397,1475,2432,440,ITF,ITF2,14,Molise
2021-01-18,BAS,463,157,306,364,99,ITF,ITF5,17,Basilicata
2021-01-05,TOS,5249,1755,3494,5249,0,ITI,ITI1,9,Toscana
2021-04-08,MOL,1766,903,863,1564,202,ITF,ITF2,14,Molise
2021-06-10,SIC,51254,24245,27009,44103,7151,ITG,ITG1,19,Sicilia
2021-01-15,PUG,4552,1866,2686,4552,0,ITF,ITF4,16,Puglia
2021-04-19,EMR,20897,9796,11101,14624,6273,ITH,ITH5,8,Emilia-Romagna
2021-01-31,PAT,75,15,60,1,74,ITH,ITH2,4,Provincia Autonoma Trento
2021-03-31,UMB,3903,1733,2170,2216,1687,ITI,ITI2,10,Umbria
2021-01-09,EMR,9985,3451,6534,9985,0,ITH,ITH5,8,Emilia-Romagna
2021-03-16,BAS,1904,801,1103,229,1675,ITF,ITF5,17,Basilicata
2021-03-07,EMR,7840,2957,4883,6321,1519,ITH,ITH5,8,Emilia-Romagna
2021-02-16,UMB,1308,655,653,1299,9,ITI,ITI2,10,Umbria
2021-05-27,SIC,48028,22345,25683,25020,23008,ITG,ITG1,19,Sicilia
2021-05-03,EMR,28690,13552,15138,17813,10877,ITH,ITH5,8,Emilia-Romagna
2021-01-07,CAM,8911,4167,4744,8911,0,ITF,ITF3,15,Campania
2021-05-27,UMB,10030,4922,5108,8649,1381,ITI,ITI2,10,Umbria
2021-01-19,TOS,1104,531,573,1104,0,ITI,ITI1,9,Toscana
2021-03-12,CAL,5156,2469,2687,4089,1067,ITF,ITF6,18,Calabria
2021-01-04,UMB,810,398,412,810,0,ITI,ITI2,10,Umbria
2021-03-05,CAM,17136,6978,10158,10473,6663,ITF,ITF3,15,Campania
2021-04-14,SIC,20114,9725,10389,11419,8695,ITG,ITG1,19,Sicilia
2021-01-14,CAL,2636,1249,1387,2636,0,ITF,ITF6,18,Calabria
2021-04-14,UMB,8151,3673,4478,6172,1979,ITI,ITI2,10,Umbria
2021-05-29,FVG,11992,5836,6156,7015,4977,ITH,ITH4,6,Friuli-Venezia Giulia
2021-01-15,PAB,3282,1228,2054,3282,0,ITH,ITH1,4,Provincia Autonoma Bolzano / Bozen
2021-04-21,LAZ,33035,15007,18028,20656,12379,ITI,ITI4,12,Lazio
2021-01-07,LIG,3229,1095,2134,3229,0,ITC,ITC3,7,Liguria
2021-04-17,LIG,7385,3218,4167,6635,750,ITC,ITC3,7,Liguria
2021-01-07,SAR,3112,1077,2035,3112,0,ITG,ITG2,20,Sardegna
2021-04-18,VDA,522,254,268,518,4,ITC,ITC2,2,Valle d'Aosta / Vallée d'Aoste
2021-04-17,MAR,11701,5316,6385,10628,1073,ITI,ITI3,11,Marche
2021-05-01,LIG,7141,3256,3885,1342,5799,ITC,ITC3,7,Liguria
2021-02-07,PIE,3088,974,2114,445,2643,ITC,ITC1,1,Piemonte
2021-03-05,LIG,4869,2150,2719,3737,1132,ITC,ITC3,7,Liguria
2021-06-10,SAR,18016,8647,9369,11902,6114,ITG,ITG2,20,Sardegna
2021-02-19,LOM,14162,5386,8776,13483,679,ITC,ITC4,3,Lombardia
2021-04-22,MOL,1844,863,981,1065,779,ITF,ITF2,14,Molise
2021-05-31,VDA,879,395,484,500,379,ITC,ITC2,2,Valle d'Aosta / Vallée d'Aoste
2021-04-17,LOM,48393,21257,27136,37625,10768,ITC,ITC4,3,Lombardia
2021-04-26,VEN,20709,9452,11257,15571,5138,ITH,ITH3,5,Veneto
2021-06-03,LAZ,55884,28219,27665,38494,17390,ITI,ITI4,12,Lazio
2020-12-27,MAR,202,98,104,202,0,ITI,ITI3,11,Marche
2021-05-05,BAS,4334,2048,2286,3444,890,ITF,ITF5,17,Basilicata
2021-02-17,MOL,72,32,40,57,15,ITF,ITF2,14,Molise
2021-02-26,LOM,18355,7545,10810,16509,1846,ITC,ITC4,3,Lombardia
2021-03-09,BAS,1399,712,687,794,605,ITF,ITF5,17,Basilicata
2021-04-21,SIC,22419,10750,11669,16310,6109,ITG,ITG1,19,Sicilia
2021-01-21,CAL,960,445,515,930,30,ITF,ITF6,18,Calabria
2021-01-22,PUG,1409,578,831,991,418,ITF,ITF4,16,Puglia
2021-05-28,MOL,2522,1309,1213,1980,542,ITF,ITF2,14,Molise
2021-02-28,EMR,6823,2527,4296,4977,1846,ITH,ITH5,8,Emilia-Romagna
2021-01-25,BAS,1023,429,594,74,949,ITF,ITF5,17,Basilicata
2021-04-26,EMR,27883,12928,14955,18575,9308,ITH,ITH5,8,Emilia-Romagna
2021-04-07,SIC,15420,7608,7812,8310,7110,ITG,ITG1,19,Sicilia
2021-06-03,UMB,9020,4457,4563,8750,270,ITI,ITI2,10,Umbria
2021-01-16,EMR,5628,1718,3910,5628,0,ITH,ITH5,8,Emilia-Romagna
2021-04-07,UMB,5568,2289,3279,3562,2006,ITI,ITI2,10,Umbria
2021-02-01,ABR,1632,573,1059,271,1361,ITF,ITF1,13,Abruzzo
2021-03-14,EMR,8794,3835,4959,4997,3797,ITH,ITH5,8,Emilia-Romagna
2021-01-11,BAS,183,66,117,183,0,ITF,ITF5,17,Basilicata
2021-01-14,CAM,7074,2978,4096,7074,0,ITF,ITF3,15,Campania
2021-02-23,UMB,1693,658,1035,1651,42,ITI,ITI2,10,Umbria
2021-06-03,SIC,45694,20923,24771,34201,11493,ITG,ITG1,19,Sicilia
2021-01-12,TOS,3581,1398,2183,3581,0,ITI,ITI1,9,Toscana
2021-01-08,PAB,1521,479,1042,1521,0,ITH,ITH1,4,Provincia Autonoma Bolzano / Bozen
2021-06-06,LIG,3798,2030,1768,2946,852,ITC,ITC3,7,Liguria
2021-06-10,LAZ,71478,34110,37368,37439,34039,ITI,ITI4,12,Lazio
2021-03-23,ABR,4927,2275,2652,2361,2566,ITF,ITF1,13,Abruzzo
2021-04-24,LIG,8169,3785,4384,5018,3151,ITC,ITC3,7,Liguria
2021-05-22,FVG,11517,5169,6348,7288,4229,ITH,ITH4,6,Friuli-Venezia Giulia
2020-12-31,SAR,32,16,16,32,0,ITG,ITG2,20,Sardegna
2021-04-25,VDA,849,408,441,710,139,ITC,ITC2,2,Valle d'Aosta / Vallée d'Aoste
2021-01-25,ABR,1605,633,972,17,1588,ITF,ITF1,13,Abruzzo
2021-02-26,LIG,3764,1523,2241,3436,328,ITC,ITC3,7,Liguria
2021-06-07,VDA,710,347,363,649,61,ITC,ITC2,2,Valle d'Aosta / Vallée d'Aoste
2021-06-06,MAR,12300,6074,6226,10811,1489,ITI,ITI3,11,Marche
2021-02-27,VDA,231,85,146,124,107,ITC,ITC2,2,Valle d'Aosta / Vallée d'Aoste
2021-04-14,LAZ,29275,13262,16013,19154,10121,ITI,ITI4,12,Lazio
2021-06-11,MOL,2632,1234,1398,1578,1054,ITF,ITF2,14,Molise
2021-05-22,PIE,33377,15079,18298,17245,16132,ITC,ITC1,1,Piemonte
2020-12-31,LOM,713,301,412,713,0,ITC,ITC4,3,Lombardia
2021-04-15,MOL,1924,793,1131,1080,844,ITF,ITF2,14,Molise
